index,ProductSymbol,DateGen,ExpDate,Strike,Call,Put,TotalOI
0,ROKU  ,2023-02-09,2023-02-10,25.0,0,360,360
1,ROKU  ,2023-02-09,2023-02-10,29.0,1,28,29
2,ROKU  ,2023-02-09,2023-02-10,30.0,1,603,604
3,ROKU  ,2023-02-09,2023-02-10,31.0,1,79,80
4,ROKU  ,2023-02-09,2023-02-10,32.0,0,1219,1219
5,ROKU  ,2023-02-09,2023-02-10,33.0,1,762,763
6,ROKU  ,2023-02-09,2023-02-10,34.0,7,54,61
7,ROKU  ,2023-02-09,2023-02-10,35.0,4,118,122
8,ROKU  ,2023-02-09,2023-02-10,36.0,1,56,57
9,ROKU  ,2023-02-09,2023-02-10,37.0,1,176,177
10,ROKU  ,2023-02-09,2023-02-10,38.0,1,554,555
11,ROKU  ,2023-02-09,2023-02-10,38.5,2,240,242
12,ROKU  ,2023-02-09,2023-02-10,39.0,0,284,284
13,ROKU  ,2023-02-09,2023-02-10,39.5,12,0,12
14,ROKU  ,2023-02-09,2023-02-10,40.0,2018,2189,4207
15,ROKU  ,2023-02-09,2023-02-10,40.5,6,3,9
16,ROKU  ,2023-02-09,2023-02-10,41.0,19,145,164
17,ROKU  ,2023-02-09,2023-02-10,41.5,0,8,8
18,ROKU  ,2023-02-09,2023-02-10,42.0,12,309,321
19,ROKU  ,2023-02-09,2023-02-10,42.5,1,9,10
20,ROKU  ,2023-02-09,2023-02-10,43.0,44,156,200
21,ROKU  ,2023-02-09,2023-02-10,43.5,4,12,16
22,ROKU  ,2023-02-09,2023-02-10,44.0,106,917,1023
23,ROKU  ,2023-02-09,2023-02-10,44.5,23,1,24
24,ROKU  ,2023-02-09,2023-02-10,45.0,104,430,534
25,ROKU  ,2023-02-09,2023-02-10,45.5,18,45,63
26,ROKU  ,2023-02-09,2023-02-10,46.0,496,249,745
27,ROKU  ,2023-02-09,2023-02-10,46.5,16,547,563
28,ROKU  ,2023-02-09,2023-02-10,47.0,82,1018,1100
29,ROKU  ,2023-02-09,2023-02-10,47.5,18,577,595
30,ROKU  ,2023-02-09,2023-02-10,48.0,103,530,633
31,ROKU  ,2023-02-09,2023-02-10,48.5,15,231,246
32,ROKU  ,2023-02-09,2023-02-10,49.0,108,200,308
33,ROKU  ,2023-02-09,2023-02-10,49.5,57,94,151
34,ROKU  ,2023-02-09,2023-02-10,50.0,204,659,863
35,ROKU  ,2023-02-09,2023-02-10,51.0,168,1388,1556
36,ROKU  ,2023-02-09,2023-02-10,52.0,428,454,882
37,ROKU  ,2023-02-09,2023-02-10,53.0,376,678,1054
38,ROKU  ,2023-02-09,2023-02-10,54.0,475,911,1386
39,ROKU  ,2023-02-09,2023-02-10,55.0,465,747,1212
40,ROKU  ,2023-02-09,2023-02-10,56.0,301,1482,1783
41,ROKU  ,2023-02-09,2023-02-10,57.0,842,989,1831
42,ROKU  ,2023-02-09,2023-02-10,58.0,665,1081,1746
43,ROKU  ,2023-02-09,2023-02-10,59.0,651,1379,2030
44,ROKU  ,2023-02-09,2023-02-10,60.0,1527,895,2422
45,ROKU  ,2023-02-09,2023-02-10,61.0,1235,600,1835
46,ROKU  ,2023-02-09,2023-02-10,62.0,1092,408,1500
47,ROKU  ,2023-02-09,2023-02-10,63.0,1489,718,2207
48,ROKU  ,2023-02-09,2023-02-10,64.0,850,514,1364
49,ROKU  ,2023-02-09,2023-02-10,65.0,4133,373,4506
50,ROKU  ,2023-02-09,2023-02-10,66.0,2308,821,3129
51,ROKU  ,2023-02-09,2023-02-10,67.0,1046,134,1180
52,ROKU  ,2023-02-09,2023-02-10,68.0,584,164,748
53,ROKU  ,2023-02-09,2023-02-10,69.0,855,33,888
54,ROKU  ,2023-02-09,2023-02-10,70.0,2425,88,2513
55,ROKU  ,2023-02-09,2023-02-10,71.0,548,37,585
56,ROKU  ,2023-02-09,2023-02-10,72.0,3567,12,3579
57,ROKU  ,2023-02-09,2023-02-10,73.0,296,9,305
58,ROKU  ,2023-02-09,2023-02-10,74.0,86,0,86
59,ROKU  ,2023-02-09,2023-02-10,75.0,1336,5,1341
60,ROKU  ,2023-02-09,2023-02-10,76.0,134,3,137
61,ROKU  ,2023-02-09,2023-02-10,77.0,70,0,70
62,ROKU  ,2023-02-09,2023-02-10,78.0,225,0,225
63,ROKU  ,2023-02-09,2023-02-10,79.0,110,1,111
64,ROKU  ,2023-02-09,2023-02-10,80.0,647,0,647
65,ROKU  ,2023-02-09,2023-02-10,81.0,36,0,36
66,ROKU  ,2023-02-09,2023-02-10,82.0,42,0,42
67,ROKU  ,2023-02-09,2023-02-10,83.0,47,0,47
68,ROKU  ,2023-02-09,2023-02-10,84.0,174,0,174
69,ROKU  ,2023-02-09,2023-02-10,85.0,90,0,90
70,ROKU  ,2023-02-09,2023-02-10,86.0,242,0,242
71,ROKU  ,2023-02-09,2023-02-10,87.0,109,0,109
72,ROKU  ,2023-02-09,2023-02-10,90.0,22,0,22
73,ROKU  ,2023-02-09,2023-02-10,95.0,23,0,23
74,ROKU  ,2023-02-09,2023-02-10,100.0,0,0,0
75,ROKU  ,2023-02-09,2023-02-17,20.0,1,365,366
76,ROKU  ,2023-02-09,2023-02-17,22.5,20,428,448
77,ROKU  ,2023-02-09,2023-02-17,25.0,17,2715,2732
78,ROKU  ,2023-02-09,2023-02-17,30.0,94,5211,5305
79,ROKU  ,2023-02-09,2023-02-17,35.0,75,5664,5739
80,ROKU  ,2023-02-09,2023-02-17,40.0,757,3053,3810
81,ROKU  ,2023-02-09,2023-02-17,42.0,17,313,330
82,ROKU  ,2023-02-09,2023-02-17,43.0,5,165,170
83,ROKU  ,2023-02-09,2023-02-17,44.0,12,175,187
84,ROKU  ,2023-02-09,2023-02-17,45.0,1293,4333,5626
85,ROKU  ,2023-02-09,2023-02-17,45.5,41,182,223
86,ROKU  ,2023-02-09,2023-02-17,46.0,58,110,168
87,ROKU  ,2023-02-09,2023-02-17,46.5,32,149,181
88,ROKU  ,2023-02-09,2023-02-17,47.0,72,674,746
89,ROKU  ,2023-02-09,2023-02-17,47.5,41,527,568
90,ROKU  ,2023-02-09,2023-02-17,48.0,28,981,1009
91,ROKU  ,2023-02-09,2023-02-17,48.5,16,196,212
92,ROKU  ,2023-02-09,2023-02-17,49.0,162,452,614
93,ROKU  ,2023-02-09,2023-02-17,49.5,147,361,508
94,ROKU  ,2023-02-09,2023-02-17,50.0,2194,3571,5765
95,ROKU  ,2023-02-09,2023-02-17,51.0,256,365,621
96,ROKU  ,2023-02-09,2023-02-17,52.0,99,936,1035
97,ROKU  ,2023-02-09,2023-02-17,53.0,121,395,516
98,ROKU  ,2023-02-09,2023-02-17,54.0,302,726,1028
99,ROKU  ,2023-02-09,2023-02-17,55.0,2489,1940,4429
100,ROKU  ,2023-02-09,2023-02-17,56.0,349,424,773
101,ROKU  ,2023-02-09,2023-02-17,57.0,757,202,959
102,ROKU  ,2023-02-09,2023-02-17,58.0,365,438,803
103,ROKU  ,2023-02-09,2023-02-17,59.0,521,228,749
104,ROKU  ,2023-02-09,2023-02-17,60.0,2831,1103,3934
105,ROKU  ,2023-02-09,2023-02-17,61.0,430,196,626
106,ROKU  ,2023-02-09,2023-02-17,62.0,315,201,516
107,ROKU  ,2023-02-09,2023-02-17,63.0,541,144,685
108,ROKU  ,2023-02-09,2023-02-17,64.0,168,276,444
109,ROKU  ,2023-02-09,2023-02-17,65.0,4960,1103,6063
110,ROKU  ,2023-02-09,2023-02-17,66.0,449,175,624
111,ROKU  ,2023-02-09,2023-02-17,67.0,857,522,1379
112,ROKU  ,2023-02-09,2023-02-17,68.0,324,275,599
113,ROKU  ,2023-02-09,2023-02-17,69.0,285,227,512
114,ROKU  ,2023-02-09,2023-02-17,70.0,1739,263,2002
115,ROKU  ,2023-02-09,2023-02-17,71.0,165,73,238
116,ROKU  ,2023-02-09,2023-02-17,72.0,152,59,211
117,ROKU  ,2023-02-09,2023-02-17,73.0,125,74,199
118,ROKU  ,2023-02-09,2023-02-17,74.0,515,102,617
119,ROKU  ,2023-02-09,2023-02-17,75.0,1597,163,1760
120,ROKU  ,2023-02-09,2023-02-17,76.0,222,17,239
121,ROKU  ,2023-02-09,2023-02-17,77.0,151,46,197
122,ROKU  ,2023-02-09,2023-02-17,78.0,177,37,214
123,ROKU  ,2023-02-09,2023-02-17,79.0,83,26,109
124,ROKU  ,2023-02-09,2023-02-17,80.0,735,19,754
125,ROKU  ,2023-02-09,2023-02-17,81.0,123,37,160
126,ROKU  ,2023-02-09,2023-02-17,82.0,67,27,94
127,ROKU  ,2023-02-09,2023-02-17,83.0,100,19,119
128,ROKU  ,2023-02-09,2023-02-17,84.0,69,9,78
129,ROKU  ,2023-02-09,2023-02-17,85.0,3516,61,3577
130,ROKU  ,2023-02-09,2023-02-17,86.0,21,21,42
131,ROKU  ,2023-02-09,2023-02-17,87.0,187,34,221
132,ROKU  ,2023-02-09,2023-02-17,90.0,3279,23,3302
133,ROKU  ,2023-02-09,2023-02-17,95.0,78,4,82
134,ROKU  ,2023-02-09,2023-02-17,100.0,498,0,498
135,ROKU  ,2023-02-09,2023-02-24,25.0,4,2503,2507
136,ROKU  ,2023-02-09,2023-02-24,30.0,1,178,179
137,ROKU  ,2023-02-09,2023-02-24,32.0,0,79,79
138,ROKU  ,2023-02-09,2023-02-24,33.0,0,32,32
139,ROKU  ,2023-02-09,2023-02-24,34.0,10,246,256
140,ROKU  ,2023-02-09,2023-02-24,35.0,5,480,485
141,ROKU  ,2023-02-09,2023-02-24,36.0,1,199,200
142,ROKU  ,2023-02-09,2023-02-24,37.0,0,63,63
143,ROKU  ,2023-02-09,2023-02-24,38.0,0,100,100
144,ROKU  ,2023-02-09,2023-02-24,39.0,0,186,186
145,ROKU  ,2023-02-09,2023-02-24,40.0,20,265,285
146,ROKU  ,2023-02-09,2023-02-24,41.0,18,85,103
147,ROKU  ,2023-02-09,2023-02-24,42.0,154,56,210
148,ROKU  ,2023-02-09,2023-02-24,43.0,11,119,130
149,ROKU  ,2023-02-09,2023-02-24,44.0,40,119,159
150,ROKU  ,2023-02-09,2023-02-24,45.0,100,192,292
151,ROKU  ,2023-02-09,2023-02-24,46.0,71,79,150
152,ROKU  ,2023-02-09,2023-02-24,47.0,27,50,77
153,ROKU  ,2023-02-09,2023-02-24,48.0,447,72,519
154,ROKU  ,2023-02-09,2023-02-24,49.0,22,70,92
155,ROKU  ,2023-02-09,2023-02-24,50.0,126,220,346
156,ROKU  ,2023-02-09,2023-02-24,51.0,193,133,326
157,ROKU  ,2023-02-09,2023-02-24,52.0,416,166,582
158,ROKU  ,2023-02-09,2023-02-24,53.0,123,65,188
159,ROKU  ,2023-02-09,2023-02-24,54.0,87,119,206
160,ROKU  ,2023-02-09,2023-02-24,55.0,278,207,485
161,ROKU  ,2023-02-09,2023-02-24,56.0,71,87,158
162,ROKU  ,2023-02-09,2023-02-24,57.0,55,45,100
163,ROKU  ,2023-02-09,2023-02-24,58.0,100,54,154
164,ROKU  ,2023-02-09,2023-02-24,59.0,23,91,114
165,ROKU  ,2023-02-09,2023-02-24,60.0,767,100,867
166,ROKU  ,2023-02-09,2023-02-24,61.0,65,49,114
167,ROKU  ,2023-02-09,2023-02-24,62.0,168,60,228
168,ROKU  ,2023-02-09,2023-02-24,63.0,40,66,106
169,ROKU  ,2023-02-09,2023-02-24,64.0,214,116,330
170,ROKU  ,2023-02-09,2023-02-24,65.0,359,152,511
171,ROKU  ,2023-02-09,2023-02-24,66.0,120,62,182
172,ROKU  ,2023-02-09,2023-02-24,67.0,95,69,164
173,ROKU  ,2023-02-09,2023-02-24,68.0,80,60,140
174,ROKU  ,2023-02-09,2023-02-24,69.0,63,19,82
175,ROKU  ,2023-02-09,2023-02-24,70.0,503,14,517
176,ROKU  ,2023-02-09,2023-02-24,71.0,42,19,61
177,ROKU  ,2023-02-09,2023-02-24,72.0,39,5,44
178,ROKU  ,2023-02-09,2023-02-24,73.0,76,11,87
179,ROKU  ,2023-02-09,2023-02-24,74.0,31,11,42
180,ROKU  ,2023-02-09,2023-02-24,75.0,155,4,159
181,ROKU  ,2023-02-09,2023-02-24,76.0,35,15,50
182,ROKU  ,2023-02-09,2023-02-24,77.0,52,5,57
183,ROKU  ,2023-02-09,2023-02-24,78.0,24,5,29
184,ROKU  ,2023-02-09,2023-02-24,79.0,53,2,55
185,ROKU  ,2023-02-09,2023-02-24,80.0,89,5,94
186,ROKU  ,2023-02-09,2023-02-24,81.0,66,0,66
187,ROKU  ,2023-02-09,2023-02-24,82.0,21,22,43
188,ROKU  ,2023-02-09,2023-02-24,83.0,16,0,16
189,ROKU  ,2023-02-09,2023-02-24,84.0,9,1,10
190,ROKU  ,2023-02-09,2023-02-24,85.0,73,4,77
191,ROKU  ,2023-02-09,2023-02-24,86.0,91,1,92
192,ROKU  ,2023-02-09,2023-02-24,87.0,174,0,174
193,ROKU  ,2023-02-09,2023-02-24,90.0,140,6,146
194,ROKU  ,2023-02-09,2023-02-24,95.0,91,4,95
195,ROKU  ,2023-02-09,2023-02-24,100.0,101,0,101
196,ROKU  ,2023-02-09,2023-03-03,25.0,0,743,743
197,ROKU  ,2023-02-09,2023-03-03,30.0,0,113,113
198,ROKU  ,2023-02-09,2023-03-03,35.0,0,181,181
199,ROKU  ,2023-02-09,2023-03-03,38.0,1,256,257
200,ROKU  ,2023-02-09,2023-03-03,39.0,0,36,36
201,ROKU  ,2023-02-09,2023-03-03,40.0,3,112,115
202,ROKU  ,2023-02-09,2023-03-03,41.0,0,17,17
203,ROKU  ,2023-02-09,2023-03-03,42.0,0,10,10
204,ROKU  ,2023-02-09,2023-03-03,43.0,0,77,77
205,ROKU  ,2023-02-09,2023-03-03,44.0,0,74,74
206,ROKU  ,2023-02-09,2023-03-03,45.0,2,215,217
207,ROKU  ,2023-02-09,2023-03-03,46.0,2,94,96
208,ROKU  ,2023-02-09,2023-03-03,47.0,17,124,141
209,ROKU  ,2023-02-09,2023-03-03,48.0,31,76,107
210,ROKU  ,2023-02-09,2023-03-03,49.0,28,62,90
211,ROKU  ,2023-02-09,2023-03-03,50.0,36,84,120
212,ROKU  ,2023-02-09,2023-03-03,51.0,25,54,79
213,ROKU  ,2023-02-09,2023-03-03,52.0,52,37,89
214,ROKU  ,2023-02-09,2023-03-03,53.0,22,27,49
215,ROKU  ,2023-02-09,2023-03-03,54.0,39,115,154
216,ROKU  ,2023-02-09,2023-03-03,55.0,67,89,156
217,ROKU  ,2023-02-09,2023-03-03,56.0,70,63,133
218,ROKU  ,2023-02-09,2023-03-03,57.0,51,125,176
219,ROKU  ,2023-02-09,2023-03-03,58.0,65,16,81
220,ROKU  ,2023-02-09,2023-03-03,59.0,20,8,28
221,ROKU  ,2023-02-09,2023-03-03,60.0,63,48,111
222,ROKU  ,2023-02-09,2023-03-03,61.0,64,12,76
223,ROKU  ,2023-02-09,2023-03-03,62.0,62,31,93
224,ROKU  ,2023-02-09,2023-03-03,63.0,45,11,56
225,ROKU  ,2023-02-09,2023-03-03,64.0,53,55,108
226,ROKU  ,2023-02-09,2023-03-03,65.0,278,48,326
227,ROKU  ,2023-02-09,2023-03-03,66.0,71,4,75
228,ROKU  ,2023-02-09,2023-03-03,67.0,39,3,42
229,ROKU  ,2023-02-09,2023-03-03,68.0,25,2,27
230,ROKU  ,2023-02-09,2023-03-03,69.0,11,4,15
231,ROKU  ,2023-02-09,2023-03-03,70.0,145,20,165
232,ROKU  ,2023-02-09,2023-03-03,71.0,1,4,5
233,ROKU  ,2023-02-09,2023-03-03,72.0,5,6,11
234,ROKU  ,2023-02-09,2023-03-03,73.0,2,3,5
235,ROKU  ,2023-02-09,2023-03-03,74.0,9,0,9
236,ROKU  ,2023-02-09,2023-03-03,75.0,58,17,75
237,ROKU  ,2023-02-09,2023-03-03,76.0,2,1,3
238,ROKU  ,2023-02-09,2023-03-03,77.0,15,4,19
239,ROKU  ,2023-02-09,2023-03-03,78.0,11,0,11
240,ROKU  ,2023-02-09,2023-03-03,80.0,32,0,32
241,ROKU  ,2023-02-09,2023-03-03,85.0,77,5,82
242,ROKU  ,2023-02-09,2023-03-03,90.0,61,0,61
243,ROKU  ,2023-02-09,2023-03-03,95.0,56,0,56
244,ROKU  ,2023-02-09,2023-03-03,100.0,232,0,232
245,ROKU  ,2023-02-09,2023-03-10,30.0,0,4,4
246,ROKU  ,2023-02-09,2023-03-10,35.0,0,6,6
247,ROKU  ,2023-02-09,2023-03-10,40.0,3,12,15
248,ROKU  ,2023-02-09,2023-03-10,41.0,0,18,18
249,ROKU  ,2023-02-09,2023-03-10,42.0,3,37,40
250,ROKU  ,2023-02-09,2023-03-10,43.0,1,17,18
251,ROKU  ,2023-02-09,2023-03-10,44.0,0,308,308
252,ROKU  ,2023-02-09,2023-03-10,45.0,2,113,115
253,ROKU  ,2023-02-09,2023-03-10,46.0,0,290,290
254,ROKU  ,2023-02-09,2023-03-10,47.0,1,73,74
255,ROKU  ,2023-02-09,2023-03-10,48.0,0,31,31
256,ROKU  ,2023-02-09,2023-03-10,49.0,0,18,18
257,ROKU  ,2023-02-09,2023-03-10,50.0,10,63,73
258,ROKU  ,2023-02-09,2023-03-10,51.0,4,8,12
259,ROKU  ,2023-02-09,2023-03-10,52.0,24,85,109
260,ROKU  ,2023-02-09,2023-03-10,53.0,17,18,35
261,ROKU  ,2023-02-09,2023-03-10,54.0,74,12,86
262,ROKU  ,2023-02-09,2023-03-10,55.0,45,28,73
263,ROKU  ,2023-02-09,2023-03-10,56.0,39,19,58
264,ROKU  ,2023-02-09,2023-03-10,57.0,34,18,52
265,ROKU  ,2023-02-09,2023-03-10,58.0,51,7,58
266,ROKU  ,2023-02-09,2023-03-10,59.0,11,24,35
267,ROKU  ,2023-02-09,2023-03-10,60.0,40,38,78
268,ROKU  ,2023-02-09,2023-03-10,61.0,14,21,35
269,ROKU  ,2023-02-09,2023-03-10,62.0,30,40,70
270,ROKU  ,2023-02-09,2023-03-10,63.0,81,28,109
271,ROKU  ,2023-02-09,2023-03-10,64.0,26,40,66
272,ROKU  ,2023-02-09,2023-03-10,65.0,73,45,118
273,ROKU  ,2023-02-09,2023-03-10,66.0,9,2,11
274,ROKU  ,2023-02-09,2023-03-10,67.0,18,1,19
275,ROKU  ,2023-02-09,2023-03-10,68.0,23,3,26
276,ROKU  ,2023-02-09,2023-03-10,69.0,25,1,26
277,ROKU  ,2023-02-09,2023-03-10,70.0,143,26,169
278,ROKU  ,2023-02-09,2023-03-10,71.0,2,0,2
279,ROKU  ,2023-02-09,2023-03-10,72.0,3,1,4
280,ROKU  ,2023-02-09,2023-03-10,73.0,8,0,8
281,ROKU  ,2023-02-09,2023-03-10,74.0,1,0,1
282,ROKU  ,2023-02-09,2023-03-10,75.0,41,0,41
283,ROKU  ,2023-02-09,2023-03-10,76.0,3,0,3
284,ROKU  ,2023-02-09,2023-03-10,77.0,2,0,2
285,ROKU  ,2023-02-09,2023-03-10,78.0,2,0,2
286,ROKU  ,2023-02-09,2023-03-10,80.0,36,0,36
287,ROKU  ,2023-02-09,2023-03-10,85.0,27,0,27
288,ROKU  ,2023-02-09,2023-03-10,90.0,2,0,2
289,ROKU  ,2023-02-09,2023-03-10,95.0,0,0,0
290,ROKU  ,2023-02-09,2023-03-10,100.0,2,0,2
291,ROKU  ,2023-02-09,2023-03-17,20.0,8,218,226
292,ROKU  ,2023-02-09,2023-03-17,22.5,22,519,541
293,ROKU  ,2023-02-09,2023-03-17,25.0,20,2670,2690
294,ROKU  ,2023-02-09,2023-03-17,30.0,12,7630,7642
295,ROKU  ,2023-02-09,2023-03-17,35.0,192,8011,8203
296,ROKU  ,2023-02-09,2023-03-17,40.0,314,2966,3280
297,ROKU  ,2023-02-09,2023-03-17,45.0,463,3064,3527
298,ROKU  ,2023-02-09,2023-03-17,50.0,1183,2890,4073
299,ROKU  ,2023-02-09,2023-03-17,55.0,1881,1247,3128
300,ROKU  ,2023-02-09,2023-03-17,60.0,1526,1514,3040
301,ROKU  ,2023-02-09,2023-03-17,65.0,2275,435,2710
302,ROKU  ,2023-02-09,2023-03-17,70.0,1567,345,1912
303,ROKU  ,2023-02-09,2023-03-17,75.0,1325,130,1455
304,ROKU  ,2023-02-09,2023-03-17,80.0,840,6,846
305,ROKU  ,2023-02-09,2023-03-17,85.0,2280,5,2285
306,ROKU  ,2023-02-09,2023-03-17,90.0,1095,8,1103
307,ROKU  ,2023-02-09,2023-03-17,95.0,800,3,803
308,ROKU  ,2023-02-09,2023-03-17,100.0,2796,0,2796
309,ROKU  ,2023-02-09,2023-03-17,105.0,1040,1,1041
310,ROKU  ,2023-02-09,2023-03-17,110.0,2032,2,2034
311,ROKU  ,2023-02-09,2023-03-24,35.0,0,2,2
312,ROKU  ,2023-02-09,2023-03-24,40.0,0,121,121
313,ROKU  ,2023-02-09,2023-03-24,45.0,5,36,41
314,ROKU  ,2023-02-09,2023-03-24,46.0,6,12,18
315,ROKU  ,2023-02-09,2023-03-24,47.0,0,33,33
316,ROKU  ,2023-02-09,2023-03-24,48.0,0,9,9
317,ROKU  ,2023-02-09,2023-03-24,49.0,0,4,4
318,ROKU  ,2023-02-09,2023-03-24,50.0,10,45,55
319,ROKU  ,2023-02-09,2023-03-24,51.0,10,4,14
320,ROKU  ,2023-02-09,2023-03-24,52.0,5,6,11
321,ROKU  ,2023-02-09,2023-03-24,53.0,1,5,6
322,ROKU  ,2023-02-09,2023-03-24,54.0,0,6,6
323,ROKU  ,2023-02-09,2023-03-24,55.0,31,45,76
324,ROKU  ,2023-02-09,2023-03-24,56.0,2,6,8
325,ROKU  ,2023-02-09,2023-03-24,57.0,3,4,7
326,ROKU  ,2023-02-09,2023-03-24,58.0,0,2,2
327,ROKU  ,2023-02-09,2023-03-24,59.0,3,20,23
328,ROKU  ,2023-02-09,2023-03-24,60.0,45,19,64
329,ROKU  ,2023-02-09,2023-03-24,61.0,16,4,20
330,ROKU  ,2023-02-09,2023-03-24,62.0,7,26,33
331,ROKU  ,2023-02-09,2023-03-24,63.0,11,1,12
332,ROKU  ,2023-02-09,2023-03-24,64.0,24,0,24
333,ROKU  ,2023-02-09,2023-03-24,65.0,30,5,35
334,ROKU  ,2023-02-09,2023-03-24,66.0,10,1,11
335,ROKU  ,2023-02-09,2023-03-24,67.0,4,2,6
336,ROKU  ,2023-02-09,2023-03-24,68.0,13,0,13
337,ROKU  ,2023-02-09,2023-03-24,69.0,19,0,19
338,ROKU  ,2023-02-09,2023-03-24,70.0,10,2,12
339,ROKU  ,2023-02-09,2023-03-24,71.0,3,0,3
340,ROKU  ,2023-02-09,2023-03-24,72.0,17,0,17
341,ROKU  ,2023-02-09,2023-03-24,73.0,11,0,11
342,ROKU  ,2023-02-09,2023-03-24,74.0,7,0,7
343,ROKU  ,2023-02-09,2023-03-24,75.0,9,0,9
344,ROKU  ,2023-02-09,2023-03-24,76.0,5,0,5
345,ROKU  ,2023-02-09,2023-03-24,77.0,1,0,1
346,ROKU  ,2023-02-09,2023-03-24,78.0,1,0,1
347,ROKU  ,2023-02-09,2023-03-24,80.0,2,0,2
348,ROKU  ,2023-02-09,2023-03-24,85.0,6,0,6
349,ROKU  ,2023-02-09,2023-03-24,90.0,1,0,1
350,ROKU  ,2023-02-09,2023-03-24,95.0,42,0,42
351,ROKU  ,2023-02-09,2023-03-24,100.0,13,0,13
352,ROKU  ,2023-02-09,2023-04-21,20.0,0,126,126
353,ROKU  ,2023-02-09,2023-04-21,22.5,2,388,390
354,ROKU  ,2023-02-09,2023-04-21,25.0,18,1136,1154
355,ROKU  ,2023-02-09,2023-04-21,30.0,18,2434,2452
356,ROKU  ,2023-02-09,2023-04-21,35.0,28,699,727
357,ROKU  ,2023-02-09,2023-04-21,40.0,150,1247,1397
358,ROKU  ,2023-02-09,2023-04-21,45.0,366,1442,1808
359,ROKU  ,2023-02-09,2023-04-21,50.0,487,2029,2516
360,ROKU  ,2023-02-09,2023-04-21,55.0,463,1091,1554
361,ROKU  ,2023-02-09,2023-04-21,60.0,1317,673,1990
362,ROKU  ,2023-02-09,2023-04-21,65.0,1096,636,1732
363,ROKU  ,2023-02-09,2023-04-21,70.0,1092,343,1435
364,ROKU  ,2023-02-09,2023-04-21,75.0,1000,615,1615
365,ROKU  ,2023-02-09,2023-04-21,80.0,787,36,823
366,ROKU  ,2023-02-09,2023-04-21,85.0,602,9,611
367,ROKU  ,2023-02-09,2023-04-21,90.0,242,15,257
368,ROKU  ,2023-02-09,2023-04-21,95.0,226,2,228
369,ROKU  ,2023-02-09,2023-04-21,100.0,1460,1,1461
370,ROKU  ,2023-02-09,2023-04-21,105.0,267,0,267
371,ROKU  ,2023-02-09,2023-04-21,110.0,260,0,260
372,ROKU  ,2023-02-09,2023-04-21,115.0,316,0,316
373,ROKU  ,2023-02-09,2023-04-21,120.0,392,0,392
374,ROKU  ,2023-02-09,2023-04-21,125.0,486,0,486
375,ROKU  ,2023-02-09,2023-06-16,20.0,26,256,282
376,ROKU  ,2023-02-09,2023-06-16,22.5,1,2155,2156
377,ROKU  ,2023-02-09,2023-06-16,25.0,1,1691,1692
378,ROKU  ,2023-02-09,2023-06-16,30.0,12,3251,3263
379,ROKU  ,2023-02-09,2023-06-16,35.0,110,2149,2259
380,ROKU  ,2023-02-09,2023-06-16,40.0,213,3648,3861
381,ROKU  ,2023-02-09,2023-06-16,45.0,435,8407,8842
382,ROKU  ,2023-02-09,2023-06-16,50.0,605,9234,9839
383,ROKU  ,2023-02-09,2023-06-16,55.0,1675,1908,3583
384,ROKU  ,2023-02-09,2023-06-16,60.0,2298,879,3177
385,ROKU  ,2023-02-09,2023-06-16,65.0,1173,733,1906
386,ROKU  ,2023-02-09,2023-06-16,70.0,1695,660,2355
387,ROKU  ,2023-02-09,2023-06-16,75.0,829,1006,1835
388,ROKU  ,2023-02-09,2023-06-16,80.0,1346,457,1803
389,ROKU  ,2023-02-09,2023-06-16,85.0,739,1194,1933
390,ROKU  ,2023-02-09,2023-06-16,90.0,1312,185,1497
391,ROKU  ,2023-02-09,2023-06-16,95.0,536,38,574
392,ROKU  ,2023-02-09,2023-06-16,100.0,1502,19,1521
393,ROKU  ,2023-02-09,2023-06-16,105.0,545,66,611
394,ROKU  ,2023-02-09,2023-06-16,110.0,1226,22,1248
395,ROKU  ,2023-02-09,2023-06-16,115.0,726,4,730
396,ROKU  ,2023-02-09,2023-06-16,120.0,930,0,930
397,ROKU  ,2023-02-09,2023-06-16,125.0,1001,1,1002
398,ROKU  ,2023-02-09,2023-06-16,130.0,636,0,636
399,ROKU  ,2023-02-09,2023-06-16,135.0,824,0,824
400,ROKU  ,2023-02-09,2023-06-16,140.0,1608,0,1608
401,ROKU  ,2023-02-09,2023-07-21,20.0,6,139,145
402,ROKU  ,2023-02-09,2023-07-21,22.5,0,124,124
403,ROKU  ,2023-02-09,2023-07-21,25.0,1,202,203
404,ROKU  ,2023-02-09,2023-07-21,30.0,249,1649,1898
405,ROKU  ,2023-02-09,2023-07-21,35.0,15,1598,1613
406,ROKU  ,2023-02-09,2023-07-21,40.0,132,1666,1798
407,ROKU  ,2023-02-09,2023-07-21,45.0,93,791,884
408,ROKU  ,2023-02-09,2023-07-21,50.0,337,654,991
409,ROKU  ,2023-02-09,2023-07-21,55.0,157,1332,1489
410,ROKU  ,2023-02-09,2023-07-21,60.0,150,536,686
411,ROKU  ,2023-02-09,2023-07-21,65.0,526,366,892
412,ROKU  ,2023-02-09,2023-07-21,70.0,506,71,577
413,ROKU  ,2023-02-09,2023-07-21,75.0,411,420,831
414,ROKU  ,2023-02-09,2023-07-21,80.0,785,799,1584
415,ROKU  ,2023-02-09,2023-07-21,85.0,1314,385,1699
416,ROKU  ,2023-02-09,2023-07-21,90.0,295,97,392
417,ROKU  ,2023-02-09,2023-07-21,95.0,180,10,190
418,ROKU  ,2023-02-09,2023-07-21,100.0,98,69,167
419,ROKU  ,2023-02-09,2023-09-15,20.0,3,6,9
420,ROKU  ,2023-02-09,2023-09-15,22.5,0,70,70
421,ROKU  ,2023-02-09,2023-09-15,25.0,0,297,297
422,ROKU  ,2023-02-09,2023-09-15,30.0,15,79,94
423,ROKU  ,2023-02-09,2023-09-15,35.0,35,584,619
424,ROKU  ,2023-02-09,2023-09-15,40.0,1808,1285,3093
425,ROKU  ,2023-02-09,2023-09-15,45.0,18,1011,1029
426,ROKU  ,2023-02-09,2023-09-15,50.0,25,618,643
427,ROKU  ,2023-02-09,2023-09-15,55.0,234,195,429
428,ROKU  ,2023-02-09,2023-09-15,60.0,3896,156,4052
429,ROKU  ,2023-02-09,2023-09-15,65.0,883,255,1138
430,ROKU  ,2023-02-09,2023-09-15,70.0,136,68,204
431,ROKU  ,2023-02-09,2023-09-15,75.0,221,62,283
432,ROKU  ,2023-02-09,2023-09-15,80.0,397,7,404
433,ROKU  ,2023-02-09,2023-09-15,85.0,69,27,96
434,ROKU  ,2023-02-09,2023-09-15,90.0,440,10,450
435,ROKU  ,2023-02-09,2023-09-15,95.0,28,0,28
436,ROKU  ,2023-02-09,2023-09-15,100.0,79,70,149
437,ROKU  ,2023-02-09,2024-01-19,20.0,12,84,96
438,ROKU  ,2023-02-09,2024-01-19,22.5,1,97,98
439,ROKU  ,2023-02-09,2024-01-19,25.0,27,905,932
440,ROKU  ,2023-02-09,2024-01-19,30.0,110,2049,2159
441,ROKU  ,2023-02-09,2024-01-19,35.0,119,1141,1260
442,ROKU  ,2023-02-09,2024-01-19,40.0,833,1625,2458
443,ROKU  ,2023-02-09,2024-01-19,45.0,387,2210,2597
444,ROKU  ,2023-02-09,2024-01-19,50.0,322,615,937
445,ROKU  ,2023-02-09,2024-01-19,55.0,201,234,435
446,ROKU  ,2023-02-09,2024-01-19,60.0,640,2145,2785
447,ROKU  ,2023-02-09,2024-01-19,65.0,566,940,1506
448,ROKU  ,2023-02-09,2024-01-19,70.0,606,277,883
449,ROKU  ,2023-02-09,2024-01-19,75.0,289,565,854
450,ROKU  ,2023-02-09,2024-01-19,80.0,387,1007,1394
451,ROKU  ,2023-02-09,2024-01-19,85.0,509,683,1192
452,ROKU  ,2023-02-09,2024-01-19,90.0,2056,786,2842
453,ROKU  ,2023-02-09,2024-01-19,95.0,781,341,1122
454,ROKU  ,2023-02-09,2024-01-19,100.0,1177,347,1524
455,ROKU  ,2023-02-09,2024-01-19,105.0,262,364,626
456,ROKU  ,2023-02-09,2024-01-19,110.0,620,65,685
457,ROKU  ,2023-02-09,2024-01-19,115.0,762,285,1047
458,ROKU  ,2023-02-09,2024-01-19,120.0,2129,7,2136
459,ROKU  ,2023-02-09,2024-01-19,125.0,287,6,293
460,ROKU  ,2023-02-09,2024-01-19,130.0,595,56,651
461,ROKU  ,2023-02-09,2024-01-19,135.0,223,6,229
462,ROKU  ,2023-02-09,2024-01-19,140.0,385,1,386
463,ROKU  ,2023-02-09,2024-01-19,145.0,321,0,321
464,ROKU  ,2023-02-09,2024-01-19,150.0,1645,14,1659
465,ROKU  ,2023-02-09,2024-01-19,155.0,395,2,397
466,ROKU  ,2023-02-09,2024-01-19,160.0,265,8,273
467,ROKU  ,2023-02-09,2024-01-19,165.0,124,0,124
468,ROKU  ,2023-02-09,2024-01-19,170.0,393,0,393
469,ROKU  ,2023-02-09,2024-01-19,175.0,372,0,372
470,ROKU  ,2023-02-09,2024-01-19,180.0,501,1,502
471,ROKU  ,2023-02-09,2024-01-19,185.0,198,8,206
472,ROKU  ,2023-02-09,2024-01-19,190.0,1427,5,1432
473,ROKU  ,2023-02-09,2024-01-19,195.0,188,2,190
474,ROKU  ,2023-02-09,2024-01-19,200.0,1656,0,1656
475,ROKU  ,2023-02-09,2024-01-19,205.0,135,0,135
476,ROKU  ,2023-02-09,2024-01-19,210.0,501,0,501
477,ROKU  ,2023-02-09,2024-01-19,220.0,846,0,846
478,ROKU  ,2023-02-09,2024-01-19,230.0,230,0,230
479,ROKU  ,2023-02-09,2024-01-19,240.0,156,0,156
480,ROKU  ,2023-02-09,2024-01-19,250.0,648,0,648
481,ROKU  ,2023-02-09,2024-01-19,260.0,190,0,190
482,ROKU  ,2023-02-09,2024-01-19,270.0,123,0,123
483,ROKU  ,2023-02-09,2024-01-19,280.0,159,0,159
484,ROKU  ,2023-02-09,2024-01-19,290.0,320,0,320
485,ROKU  ,2023-02-09,2024-01-19,300.0,2207,0,2207
486,ROKU  ,2023-02-09,2024-01-19,310.0,352,0,352
487,ROKU  ,2023-02-09,2024-01-19,320.0,335,0,335
488,ROKU  ,2023-02-09,2024-01-19,330.0,281,0,281
489,ROKU  ,2023-02-09,2024-01-19,340.0,180,0,180
490,ROKU  ,2023-02-09,2024-01-19,350.0,219,0,219
491,ROKU  ,2023-02-09,2024-01-19,360.0,538,0,538
492,ROKU  ,2023-02-09,2024-01-19,370.0,107,0,107
493,ROKU  ,2023-02-09,2024-01-19,380.0,143,0,143
494,ROKU  ,2023-02-09,2024-01-19,390.0,428,0,428
495,ROKU  ,2023-02-09,2024-01-19,400.0,1015,0,1015
496,ROKU  ,2023-02-09,2024-01-19,410.0,124,0,124
497,ROKU  ,2023-02-09,2024-01-19,420.0,283,0,283
498,ROKU  ,2023-02-09,2024-01-19,430.0,457,0,457
499,ROKU  ,2023-02-09,2024-01-19,440.0,142,0,142
500,ROKU  ,2023-02-09,2024-01-19,450.0,294,0,294
501,ROKU  ,2023-02-09,2024-01-19,460.0,31,0,31
502,ROKU  ,2023-02-09,2024-01-19,470.0,179,0,179
503,ROKU  ,2023-02-09,2024-01-19,480.0,45,0,45
504,ROKU  ,2023-02-09,2024-01-19,490.0,29,0,29
505,ROKU  ,2023-02-09,2024-01-19,500.0,367,0,367
506,ROKU  ,2023-02-09,2024-01-19,510.0,143,0,143
507,ROKU  ,2023-02-09,2024-01-19,520.0,2790,0,2790
508,ROKU  ,2023-02-09,2024-06-21,20.0,0,15,15
509,ROKU  ,2023-02-09,2024-06-21,22.5,1,4,5
510,ROKU  ,2023-02-09,2024-06-21,25.0,1,2,3
511,ROKU  ,2023-02-09,2024-06-21,30.0,2,38,40
512,ROKU  ,2023-02-09,2024-06-21,35.0,10,412,422
513,ROKU  ,2023-02-09,2024-06-21,40.0,25,45,70
514,ROKU  ,2023-02-09,2024-06-21,45.0,8,409,417
515,ROKU  ,2023-02-09,2024-06-21,50.0,28,96,124
516,ROKU  ,2023-02-09,2024-06-21,55.0,21,19,40
517,ROKU  ,2023-02-09,2024-06-21,60.0,24,54,78
518,ROKU  ,2023-02-09,2024-06-21,65.0,32,17,49
519,ROKU  ,2023-02-09,2024-06-21,70.0,34,3,37
520,ROKU  ,2023-02-09,2024-06-21,75.0,14,9,23
521,ROKU  ,2023-02-09,2024-06-21,80.0,35,70,105
522,ROKU  ,2023-02-09,2024-06-21,85.0,11,18,29
523,ROKU  ,2023-02-09,2024-06-21,90.0,42,37,79
524,ROKU  ,2023-02-09,2024-06-21,95.0,0,0,0
525,ROKU  ,2023-02-09,2024-06-21,100.0,2,0,2
526,ROKU  ,2023-02-09,2025-01-17,20.0,37,44,81
527,ROKU  ,2023-02-09,2025-01-17,22.5,11,43,54
528,ROKU  ,2023-02-09,2025-01-17,25.0,24,77,101
529,ROKU  ,2023-02-09,2025-01-17,30.0,50,135,185
530,ROKU  ,2023-02-09,2025-01-17,35.0,51,271,322
531,ROKU  ,2023-02-09,2025-01-17,40.0,135,238,373
532,ROKU  ,2023-02-09,2025-01-17,45.0,55,306,361
533,ROKU  ,2023-02-09,2025-01-17,50.0,142,565,707
534,ROKU  ,2023-02-09,2025-01-17,55.0,218,303,521
535,ROKU  ,2023-02-09,2025-01-17,60.0,1879,211,2090
536,ROKU  ,2023-02-09,2025-01-17,65.0,908,50,958
537,ROKU  ,2023-02-09,2025-01-17,70.0,163,33,196
538,ROKU  ,2023-02-09,2025-01-17,75.0,176,1040,1216
539,ROKU  ,2023-02-09,2025-01-17,80.0,113,45,158
540,ROKU  ,2023-02-09,2025-01-17,85.0,47,131,178
541,ROKU  ,2023-02-09,2025-01-17,90.0,60,23,83
542,ROKU  ,2023-02-09,2025-01-17,95.0,67,3,70
543,ROKU  ,2023-02-09,2025-01-17,100.0,227,41,268
544,ROKU  ,2023-02-09,2025-01-17,105.0,471,14,485
545,ROKU  ,2023-02-09,2025-01-17,110.0,888,89,977
