index,ProductSymbol,DateGen,ExpDate,Strike,Call,Put,TotalOI
0,ROKU  ,2023-02-08,2023-02-10,25.0,0,360,360
1,ROKU  ,2023-02-08,2023-02-10,29.0,1,28,29
2,ROKU  ,2023-02-08,2023-02-10,30.0,1,603,604
3,ROKU  ,2023-02-08,2023-02-10,31.0,1,79,80
4,ROKU  ,2023-02-08,2023-02-10,32.0,0,1219,1219
5,ROKU  ,2023-02-08,2023-02-10,33.0,1,762,763
6,ROKU  ,2023-02-08,2023-02-10,34.0,7,54,61
7,ROKU  ,2023-02-08,2023-02-10,35.0,4,118,122
8,ROKU  ,2023-02-08,2023-02-10,36.0,0,56,56
9,ROKU  ,2023-02-08,2023-02-10,37.0,1,176,177
10,ROKU  ,2023-02-08,2023-02-10,38.0,1,554,555
11,ROKU  ,2023-02-08,2023-02-10,38.5,2,240,242
12,ROKU  ,2023-02-08,2023-02-10,39.0,0,284,284
13,ROKU  ,2023-02-08,2023-02-10,39.5,12,0,12
14,ROKU  ,2023-02-08,2023-02-10,40.0,2018,2189,4207
15,ROKU  ,2023-02-08,2023-02-10,40.5,6,3,9
16,ROKU  ,2023-02-08,2023-02-10,41.0,19,145,164
17,ROKU  ,2023-02-08,2023-02-10,41.5,0,8,8
18,ROKU  ,2023-02-08,2023-02-10,42.0,15,309,324
19,ROKU  ,2023-02-08,2023-02-10,42.5,1,9,10
20,ROKU  ,2023-02-08,2023-02-10,43.0,44,156,200
21,ROKU  ,2023-02-08,2023-02-10,43.5,4,12,16
22,ROKU  ,2023-02-08,2023-02-10,44.0,106,917,1023
23,ROKU  ,2023-02-08,2023-02-10,44.5,24,1,25
24,ROKU  ,2023-02-08,2023-02-10,45.0,104,216,320
25,ROKU  ,2023-02-08,2023-02-10,45.5,18,45,63
26,ROKU  ,2023-02-08,2023-02-10,46.0,497,197,694
27,ROKU  ,2023-02-08,2023-02-10,46.5,16,547,563
28,ROKU  ,2023-02-08,2023-02-10,47.0,83,1040,1123
29,ROKU  ,2023-02-08,2023-02-10,47.5,18,578,596
30,ROKU  ,2023-02-08,2023-02-10,48.0,105,211,316
31,ROKU  ,2023-02-08,2023-02-10,48.5,19,231,250
32,ROKU  ,2023-02-08,2023-02-10,49.0,108,210,318
33,ROKU  ,2023-02-08,2023-02-10,49.5,57,94,151
34,ROKU  ,2023-02-08,2023-02-10,50.0,209,665,874
35,ROKU  ,2023-02-08,2023-02-10,51.0,169,257,426
36,ROKU  ,2023-02-08,2023-02-10,52.0,435,448,883
37,ROKU  ,2023-02-08,2023-02-10,53.0,390,581,971
38,ROKU  ,2023-02-08,2023-02-10,54.0,475,848,1323
39,ROKU  ,2023-02-08,2023-02-10,55.0,467,632,1099
40,ROKU  ,2023-02-08,2023-02-10,56.0,302,1431,1733
41,ROKU  ,2023-02-08,2023-02-10,57.0,843,928,1771
42,ROKU  ,2023-02-08,2023-02-10,58.0,643,955,1598
43,ROKU  ,2023-02-08,2023-02-10,59.0,510,1002,1512
44,ROKU  ,2023-02-08,2023-02-10,60.0,942,1031,1973
45,ROKU  ,2023-02-08,2023-02-10,61.0,510,719,1229
46,ROKU  ,2023-02-08,2023-02-10,62.0,813,389,1202
47,ROKU  ,2023-02-08,2023-02-10,63.0,1428,742,2170
48,ROKU  ,2023-02-08,2023-02-10,64.0,752,491,1243
49,ROKU  ,2023-02-08,2023-02-10,65.0,3518,315,3833
50,ROKU  ,2023-02-08,2023-02-10,66.0,2334,813,3147
51,ROKU  ,2023-02-08,2023-02-10,67.0,1039,141,1180
52,ROKU  ,2023-02-08,2023-02-10,68.0,598,164,762
53,ROKU  ,2023-02-08,2023-02-10,69.0,1030,37,1067
54,ROKU  ,2023-02-08,2023-02-10,70.0,2326,94,2420
55,ROKU  ,2023-02-08,2023-02-10,71.0,551,42,593
56,ROKU  ,2023-02-08,2023-02-10,72.0,3516,13,3529
57,ROKU  ,2023-02-08,2023-02-10,73.0,282,13,295
58,ROKU  ,2023-02-08,2023-02-10,74.0,87,0,87
59,ROKU  ,2023-02-08,2023-02-10,75.0,1337,13,1350
60,ROKU  ,2023-02-08,2023-02-10,76.0,137,3,140
61,ROKU  ,2023-02-08,2023-02-10,77.0,70,0,70
62,ROKU  ,2023-02-08,2023-02-10,78.0,225,5,230
63,ROKU  ,2023-02-08,2023-02-10,79.0,110,1,111
64,ROKU  ,2023-02-08,2023-02-10,80.0,647,0,647
65,ROKU  ,2023-02-08,2023-02-10,81.0,36,0,36
66,ROKU  ,2023-02-08,2023-02-10,82.0,42,0,42
67,ROKU  ,2023-02-08,2023-02-10,83.0,47,0,47
68,ROKU  ,2023-02-08,2023-02-10,84.0,174,0,174
69,ROKU  ,2023-02-08,2023-02-10,85.0,90,0,90
70,ROKU  ,2023-02-08,2023-02-10,86.0,242,0,242
71,ROKU  ,2023-02-08,2023-02-10,87.0,109,0,109
72,ROKU  ,2023-02-08,2023-02-10,90.0,22,0,22
73,ROKU  ,2023-02-08,2023-02-10,95.0,23,0,23
74,ROKU  ,2023-02-08,2023-02-10,100.0,0,0,0
75,ROKU  ,2023-02-08,2023-02-17,20.0,1,365,366
76,ROKU  ,2023-02-08,2023-02-17,22.5,20,428,448
77,ROKU  ,2023-02-08,2023-02-17,25.0,17,2715,2732
78,ROKU  ,2023-02-08,2023-02-17,30.0,94,5229,5323
79,ROKU  ,2023-02-08,2023-02-17,35.0,75,5134,5209
80,ROKU  ,2023-02-08,2023-02-17,40.0,768,3041,3809
81,ROKU  ,2023-02-08,2023-02-17,42.0,17,119,136
82,ROKU  ,2023-02-08,2023-02-17,43.0,6,161,167
83,ROKU  ,2023-02-08,2023-02-17,44.0,12,103,115
84,ROKU  ,2023-02-08,2023-02-17,45.0,1295,4325,5620
85,ROKU  ,2023-02-08,2023-02-17,45.5,41,178,219
86,ROKU  ,2023-02-08,2023-02-17,46.0,58,87,145
87,ROKU  ,2023-02-08,2023-02-17,46.5,32,120,152
88,ROKU  ,2023-02-08,2023-02-17,47.0,72,669,741
89,ROKU  ,2023-02-08,2023-02-17,47.5,41,280,321
90,ROKU  ,2023-02-08,2023-02-17,48.0,28,962,990
91,ROKU  ,2023-02-08,2023-02-17,48.5,16,137,153
92,ROKU  ,2023-02-08,2023-02-17,49.0,162,91,253
93,ROKU  ,2023-02-08,2023-02-17,49.5,144,81,225
94,ROKU  ,2023-02-08,2023-02-17,50.0,2170,3472,5642
95,ROKU  ,2023-02-08,2023-02-17,51.0,258,108,366
96,ROKU  ,2023-02-08,2023-02-17,52.0,100,911,1011
97,ROKU  ,2023-02-08,2023-02-17,53.0,137,344,481
98,ROKU  ,2023-02-08,2023-02-17,54.0,300,736,1036
99,ROKU  ,2023-02-08,2023-02-17,55.0,2499,1954,4453
100,ROKU  ,2023-02-08,2023-02-17,56.0,351,394,745
101,ROKU  ,2023-02-08,2023-02-17,57.0,755,234,989
102,ROKU  ,2023-02-08,2023-02-17,58.0,363,441,804
103,ROKU  ,2023-02-08,2023-02-17,59.0,510,224,734
104,ROKU  ,2023-02-08,2023-02-17,60.0,2447,1081,3528
105,ROKU  ,2023-02-08,2023-02-17,61.0,378,188,566
106,ROKU  ,2023-02-08,2023-02-17,62.0,295,197,492
107,ROKU  ,2023-02-08,2023-02-17,63.0,464,146,610
108,ROKU  ,2023-02-08,2023-02-17,64.0,152,224,376
109,ROKU  ,2023-02-08,2023-02-17,65.0,4964,1112,6076
110,ROKU  ,2023-02-08,2023-02-17,66.0,443,173,616
111,ROKU  ,2023-02-08,2023-02-17,67.0,813,522,1335
112,ROKU  ,2023-02-08,2023-02-17,68.0,136,262,398
113,ROKU  ,2023-02-08,2023-02-17,69.0,279,227,506
114,ROKU  ,2023-02-08,2023-02-17,70.0,1671,263,1934
115,ROKU  ,2023-02-08,2023-02-17,71.0,151,66,217
116,ROKU  ,2023-02-08,2023-02-17,72.0,138,50,188
117,ROKU  ,2023-02-08,2023-02-17,73.0,127,52,179
118,ROKU  ,2023-02-08,2023-02-17,74.0,322,77,399
119,ROKU  ,2023-02-08,2023-02-17,75.0,1586,78,1664
120,ROKU  ,2023-02-08,2023-02-17,76.0,175,17,192
121,ROKU  ,2023-02-08,2023-02-17,77.0,145,46,191
122,ROKU  ,2023-02-08,2023-02-17,78.0,166,37,203
123,ROKU  ,2023-02-08,2023-02-17,79.0,65,26,91
124,ROKU  ,2023-02-08,2023-02-17,80.0,795,19,814
125,ROKU  ,2023-02-08,2023-02-17,81.0,88,36,124
126,ROKU  ,2023-02-08,2023-02-17,82.0,65,25,90
127,ROKU  ,2023-02-08,2023-02-17,83.0,101,18,119
128,ROKU  ,2023-02-08,2023-02-17,84.0,64,7,71
129,ROKU  ,2023-02-08,2023-02-17,85.0,3514,61,3575
130,ROKU  ,2023-02-08,2023-02-17,86.0,19,21,40
131,ROKU  ,2023-02-08,2023-02-17,87.0,183,34,217
132,ROKU  ,2023-02-08,2023-02-17,90.0,3274,23,3297
133,ROKU  ,2023-02-08,2023-02-17,95.0,35,4,39
134,ROKU  ,2023-02-08,2023-02-17,100.0,337,0,337
135,ROKU  ,2023-02-08,2023-02-24,25.0,4,2503,2507
136,ROKU  ,2023-02-08,2023-02-24,30.0,1,177,178
137,ROKU  ,2023-02-08,2023-02-24,32.0,0,79,79
138,ROKU  ,2023-02-08,2023-02-24,33.0,0,32,32
139,ROKU  ,2023-02-08,2023-02-24,34.0,10,246,256
140,ROKU  ,2023-02-08,2023-02-24,35.0,5,480,485
141,ROKU  ,2023-02-08,2023-02-24,36.0,1,199,200
142,ROKU  ,2023-02-08,2023-02-24,37.0,0,62,62
143,ROKU  ,2023-02-08,2023-02-24,38.0,0,102,102
144,ROKU  ,2023-02-08,2023-02-24,39.0,0,186,186
145,ROKU  ,2023-02-08,2023-02-24,40.0,20,269,289
146,ROKU  ,2023-02-08,2023-02-24,41.0,18,83,101
147,ROKU  ,2023-02-08,2023-02-24,42.0,154,55,209
148,ROKU  ,2023-02-08,2023-02-24,43.0,12,119,131
149,ROKU  ,2023-02-08,2023-02-24,44.0,40,117,157
150,ROKU  ,2023-02-08,2023-02-24,45.0,100,195,295
151,ROKU  ,2023-02-08,2023-02-24,46.0,71,79,150
152,ROKU  ,2023-02-08,2023-02-24,47.0,27,48,75
153,ROKU  ,2023-02-08,2023-02-24,48.0,447,69,516
154,ROKU  ,2023-02-08,2023-02-24,49.0,22,70,92
155,ROKU  ,2023-02-08,2023-02-24,50.0,124,204,328
156,ROKU  ,2023-02-08,2023-02-24,51.0,193,133,326
157,ROKU  ,2023-02-08,2023-02-24,52.0,417,164,581
158,ROKU  ,2023-02-08,2023-02-24,53.0,123,54,177
159,ROKU  ,2023-02-08,2023-02-24,54.0,86,123,209
160,ROKU  ,2023-02-08,2023-02-24,55.0,270,190,460
161,ROKU  ,2023-02-08,2023-02-24,56.0,71,93,164
162,ROKU  ,2023-02-08,2023-02-24,57.0,50,44,94
163,ROKU  ,2023-02-08,2023-02-24,58.0,100,57,157
164,ROKU  ,2023-02-08,2023-02-24,59.0,23,87,110
165,ROKU  ,2023-02-08,2023-02-24,60.0,762,83,845
166,ROKU  ,2023-02-08,2023-02-24,61.0,61,49,110
167,ROKU  ,2023-02-08,2023-02-24,62.0,154,60,214
168,ROKU  ,2023-02-08,2023-02-24,63.0,40,43,83
169,ROKU  ,2023-02-08,2023-02-24,64.0,214,112,326
170,ROKU  ,2023-02-08,2023-02-24,65.0,349,153,502
171,ROKU  ,2023-02-08,2023-02-24,66.0,105,62,167
172,ROKU  ,2023-02-08,2023-02-24,67.0,88,94,182
173,ROKU  ,2023-02-08,2023-02-24,68.0,70,61,131
174,ROKU  ,2023-02-08,2023-02-24,69.0,40,19,59
175,ROKU  ,2023-02-08,2023-02-24,70.0,527,14,541
176,ROKU  ,2023-02-08,2023-02-24,71.0,42,19,61
177,ROKU  ,2023-02-08,2023-02-24,72.0,37,5,42
178,ROKU  ,2023-02-08,2023-02-24,73.0,76,9,85
179,ROKU  ,2023-02-08,2023-02-24,74.0,30,9,39
180,ROKU  ,2023-02-08,2023-02-24,75.0,122,4,126
181,ROKU  ,2023-02-08,2023-02-24,76.0,35,11,46
182,ROKU  ,2023-02-08,2023-02-24,77.0,52,5,57
183,ROKU  ,2023-02-08,2023-02-24,78.0,24,5,29
184,ROKU  ,2023-02-08,2023-02-24,79.0,53,2,55
185,ROKU  ,2023-02-08,2023-02-24,80.0,88,5,93
186,ROKU  ,2023-02-08,2023-02-24,81.0,65,0,65
187,ROKU  ,2023-02-08,2023-02-24,82.0,21,12,33
188,ROKU  ,2023-02-08,2023-02-24,83.0,16,0,16
189,ROKU  ,2023-02-08,2023-02-24,84.0,9,1,10
190,ROKU  ,2023-02-08,2023-02-24,85.0,73,4,77
191,ROKU  ,2023-02-08,2023-02-24,86.0,91,1,92
192,ROKU  ,2023-02-08,2023-02-24,87.0,174,0,174
193,ROKU  ,2023-02-08,2023-02-24,90.0,75,6,81
194,ROKU  ,2023-02-08,2023-02-24,95.0,91,4,95
195,ROKU  ,2023-02-08,2023-02-24,100.0,76,0,76
196,ROKU  ,2023-02-08,2023-03-03,25.0,0,743,743
197,ROKU  ,2023-02-08,2023-03-03,30.0,0,113,113
198,ROKU  ,2023-02-08,2023-03-03,35.0,0,159,159
199,ROKU  ,2023-02-08,2023-03-03,38.0,1,224,225
200,ROKU  ,2023-02-08,2023-03-03,39.0,0,36,36
201,ROKU  ,2023-02-08,2023-03-03,40.0,3,102,105
202,ROKU  ,2023-02-08,2023-03-03,41.0,0,17,17
203,ROKU  ,2023-02-08,2023-03-03,42.0,0,10,10
204,ROKU  ,2023-02-08,2023-03-03,43.0,0,75,75
205,ROKU  ,2023-02-08,2023-03-03,44.0,0,74,74
206,ROKU  ,2023-02-08,2023-03-03,45.0,2,197,199
207,ROKU  ,2023-02-08,2023-03-03,46.0,2,77,79
208,ROKU  ,2023-02-08,2023-03-03,47.0,17,124,141
209,ROKU  ,2023-02-08,2023-03-03,48.0,28,78,106
210,ROKU  ,2023-02-08,2023-03-03,49.0,28,63,91
211,ROKU  ,2023-02-08,2023-03-03,50.0,29,82,111
212,ROKU  ,2023-02-08,2023-03-03,51.0,25,52,77
213,ROKU  ,2023-02-08,2023-03-03,52.0,52,35,87
214,ROKU  ,2023-02-08,2023-03-03,53.0,22,23,45
215,ROKU  ,2023-02-08,2023-03-03,54.0,36,109,145
216,ROKU  ,2023-02-08,2023-03-03,55.0,67,93,160
217,ROKU  ,2023-02-08,2023-03-03,56.0,70,46,116
218,ROKU  ,2023-02-08,2023-03-03,57.0,51,124,175
219,ROKU  ,2023-02-08,2023-03-03,58.0,63,13,76
220,ROKU  ,2023-02-08,2023-03-03,59.0,14,6,20
221,ROKU  ,2023-02-08,2023-03-03,60.0,67,45,112
222,ROKU  ,2023-02-08,2023-03-03,61.0,65,12,77
223,ROKU  ,2023-02-08,2023-03-03,62.0,67,31,98
224,ROKU  ,2023-02-08,2023-03-03,63.0,42,11,53
225,ROKU  ,2023-02-08,2023-03-03,64.0,56,55,111
226,ROKU  ,2023-02-08,2023-03-03,65.0,265,50,315
227,ROKU  ,2023-02-08,2023-03-03,66.0,71,1,72
228,ROKU  ,2023-02-08,2023-03-03,67.0,40,2,42
229,ROKU  ,2023-02-08,2023-03-03,68.0,25,2,27
230,ROKU  ,2023-02-08,2023-03-03,69.0,11,4,15
231,ROKU  ,2023-02-08,2023-03-03,70.0,145,19,164
232,ROKU  ,2023-02-08,2023-03-03,71.0,1,3,4
233,ROKU  ,2023-02-08,2023-03-03,72.0,6,4,10
234,ROKU  ,2023-02-08,2023-03-03,73.0,1,1,2
235,ROKU  ,2023-02-08,2023-03-03,74.0,8,0,8
236,ROKU  ,2023-02-08,2023-03-03,75.0,59,0,59
237,ROKU  ,2023-02-08,2023-03-03,76.0,2,1,3
238,ROKU  ,2023-02-08,2023-03-03,77.0,15,4,19
239,ROKU  ,2023-02-08,2023-03-03,78.0,11,0,11
240,ROKU  ,2023-02-08,2023-03-03,80.0,32,0,32
241,ROKU  ,2023-02-08,2023-03-03,85.0,62,5,67
242,ROKU  ,2023-02-08,2023-03-03,90.0,41,0,41
243,ROKU  ,2023-02-08,2023-03-03,95.0,56,0,56
244,ROKU  ,2023-02-08,2023-03-03,100.0,229,0,229
245,ROKU  ,2023-02-08,2023-03-10,30.0,0,3,3
246,ROKU  ,2023-02-08,2023-03-10,35.0,0,6,6
247,ROKU  ,2023-02-08,2023-03-10,40.0,3,12,15
248,ROKU  ,2023-02-08,2023-03-10,41.0,0,18,18
249,ROKU  ,2023-02-08,2023-03-10,42.0,3,36,39
250,ROKU  ,2023-02-08,2023-03-10,43.0,1,13,14
251,ROKU  ,2023-02-08,2023-03-10,44.0,0,307,307
252,ROKU  ,2023-02-08,2023-03-10,45.0,2,111,113
253,ROKU  ,2023-02-08,2023-03-10,46.0,0,290,290
254,ROKU  ,2023-02-08,2023-03-10,47.0,1,73,74
255,ROKU  ,2023-02-08,2023-03-10,48.0,0,31,31
256,ROKU  ,2023-02-08,2023-03-10,49.0,0,17,17
257,ROKU  ,2023-02-08,2023-03-10,50.0,10,52,62
258,ROKU  ,2023-02-08,2023-03-10,51.0,4,6,10
259,ROKU  ,2023-02-08,2023-03-10,52.0,24,93,117
260,ROKU  ,2023-02-08,2023-03-10,53.0,17,18,35
261,ROKU  ,2023-02-08,2023-03-10,54.0,74,12,86
262,ROKU  ,2023-02-08,2023-03-10,55.0,45,25,70
263,ROKU  ,2023-02-08,2023-03-10,56.0,39,18,57
264,ROKU  ,2023-02-08,2023-03-10,57.0,34,18,52
265,ROKU  ,2023-02-08,2023-03-10,58.0,51,7,58
266,ROKU  ,2023-02-08,2023-03-10,59.0,11,16,27
267,ROKU  ,2023-02-08,2023-03-10,60.0,47,39,86
268,ROKU  ,2023-02-08,2023-03-10,61.0,14,14,28
269,ROKU  ,2023-02-08,2023-03-10,62.0,30,39,69
270,ROKU  ,2023-02-08,2023-03-10,63.0,81,28,109
271,ROKU  ,2023-02-08,2023-03-10,64.0,25,50,75
272,ROKU  ,2023-02-08,2023-03-10,65.0,73,45,118
273,ROKU  ,2023-02-08,2023-03-10,66.0,9,2,11
274,ROKU  ,2023-02-08,2023-03-10,67.0,6,1,7
275,ROKU  ,2023-02-08,2023-03-10,68.0,23,3,26
276,ROKU  ,2023-02-08,2023-03-10,69.0,25,1,26
277,ROKU  ,2023-02-08,2023-03-10,70.0,142,26,168
278,ROKU  ,2023-02-08,2023-03-10,71.0,2,0,2
279,ROKU  ,2023-02-08,2023-03-10,72.0,3,1,4
280,ROKU  ,2023-02-08,2023-03-10,73.0,8,0,8
281,ROKU  ,2023-02-08,2023-03-10,74.0,1,0,1
282,ROKU  ,2023-02-08,2023-03-10,75.0,41,0,41
283,ROKU  ,2023-02-08,2023-03-10,76.0,3,0,3
284,ROKU  ,2023-02-08,2023-03-10,77.0,2,0,2
285,ROKU  ,2023-02-08,2023-03-10,78.0,2,0,2
286,ROKU  ,2023-02-08,2023-03-10,80.0,35,0,35
287,ROKU  ,2023-02-08,2023-03-10,85.0,31,0,31
288,ROKU  ,2023-02-08,2023-03-10,90.0,2,0,2
289,ROKU  ,2023-02-08,2023-03-10,95.0,1,0,1
290,ROKU  ,2023-02-08,2023-03-10,100.0,2,0,2
291,ROKU  ,2023-02-08,2023-03-17,20.0,8,218,226
292,ROKU  ,2023-02-08,2023-03-17,22.5,22,519,541
293,ROKU  ,2023-02-08,2023-03-17,25.0,20,2670,2690
294,ROKU  ,2023-02-08,2023-03-17,30.0,12,7625,7637
295,ROKU  ,2023-02-08,2023-03-17,35.0,192,8015,8207
296,ROKU  ,2023-02-08,2023-03-17,40.0,314,3063,3377
297,ROKU  ,2023-02-08,2023-03-17,45.0,463,3005,3468
298,ROKU  ,2023-02-08,2023-03-17,50.0,1181,2873,4054
299,ROKU  ,2023-02-08,2023-03-17,55.0,1878,1203,3081
300,ROKU  ,2023-02-08,2023-03-17,60.0,1521,1539,3060
301,ROKU  ,2023-02-08,2023-03-17,65.0,2261,441,2702
302,ROKU  ,2023-02-08,2023-03-17,70.0,1549,334,1883
303,ROKU  ,2023-02-08,2023-03-17,75.0,1349,147,1496
304,ROKU  ,2023-02-08,2023-03-17,80.0,826,6,832
305,ROKU  ,2023-02-08,2023-03-17,85.0,2250,2,2252
306,ROKU  ,2023-02-08,2023-03-17,90.0,1113,8,1121
307,ROKU  ,2023-02-08,2023-03-17,95.0,813,3,816
308,ROKU  ,2023-02-08,2023-03-17,100.0,2796,0,2796
309,ROKU  ,2023-02-08,2023-03-17,105.0,1040,1,1041
310,ROKU  ,2023-02-08,2023-03-17,110.0,2046,2,2048
311,ROKU  ,2023-02-08,2023-03-24,35.0,0,0,0
312,ROKU  ,2023-02-08,2023-03-24,40.0,0,46,46
313,ROKU  ,2023-02-08,2023-03-24,45.0,5,26,31
314,ROKU  ,2023-02-08,2023-03-24,46.0,5,12,17
315,ROKU  ,2023-02-08,2023-03-24,47.0,0,33,33
316,ROKU  ,2023-02-08,2023-03-24,48.0,0,6,6
317,ROKU  ,2023-02-08,2023-03-24,49.0,0,4,4
318,ROKU  ,2023-02-08,2023-03-24,50.0,10,22,32
319,ROKU  ,2023-02-08,2023-03-24,51.0,10,4,14
320,ROKU  ,2023-02-08,2023-03-24,52.0,5,6,11
321,ROKU  ,2023-02-08,2023-03-24,53.0,1,4,5
322,ROKU  ,2023-02-08,2023-03-24,54.0,0,5,5
323,ROKU  ,2023-02-08,2023-03-24,55.0,31,36,67
324,ROKU  ,2023-02-08,2023-03-24,56.0,2,4,6
325,ROKU  ,2023-02-08,2023-03-24,57.0,2,4,6
326,ROKU  ,2023-02-08,2023-03-24,58.0,0,1,1
327,ROKU  ,2023-02-08,2023-03-24,59.0,3,12,15
328,ROKU  ,2023-02-08,2023-03-24,60.0,44,18,62
329,ROKU  ,2023-02-08,2023-03-24,61.0,16,4,20
330,ROKU  ,2023-02-08,2023-03-24,62.0,7,25,32
331,ROKU  ,2023-02-08,2023-03-24,63.0,11,1,12
332,ROKU  ,2023-02-08,2023-03-24,64.0,42,0,42
333,ROKU  ,2023-02-08,2023-03-24,65.0,26,5,31
334,ROKU  ,2023-02-08,2023-03-24,66.0,10,1,11
335,ROKU  ,2023-02-08,2023-03-24,67.0,5,2,7
336,ROKU  ,2023-02-08,2023-03-24,68.0,13,0,13
337,ROKU  ,2023-02-08,2023-03-24,69.0,19,0,19
338,ROKU  ,2023-02-08,2023-03-24,70.0,10,1,11
339,ROKU  ,2023-02-08,2023-03-24,71.0,3,0,3
340,ROKU  ,2023-02-08,2023-03-24,72.0,7,0,7
341,ROKU  ,2023-02-08,2023-03-24,73.0,1,0,1
342,ROKU  ,2023-02-08,2023-03-24,74.0,2,0,2
343,ROKU  ,2023-02-08,2023-03-24,75.0,9,0,9
344,ROKU  ,2023-02-08,2023-03-24,76.0,0,0,0
345,ROKU  ,2023-02-08,2023-03-24,77.0,0,0,0
346,ROKU  ,2023-02-08,2023-03-24,78.0,1,0,1
347,ROKU  ,2023-02-08,2023-03-24,80.0,2,0,2
348,ROKU  ,2023-02-08,2023-03-24,85.0,5,0,5
349,ROKU  ,2023-02-08,2023-03-24,90.0,1,0,1
350,ROKU  ,2023-02-08,2023-03-24,95.0,41,0,41
351,ROKU  ,2023-02-08,2023-03-24,100.0,12,0,12
352,ROKU  ,2023-02-08,2023-04-21,20.0,0,126,126
353,ROKU  ,2023-02-08,2023-04-21,22.5,2,388,390
354,ROKU  ,2023-02-08,2023-04-21,25.0,18,1136,1154
355,ROKU  ,2023-02-08,2023-04-21,30.0,18,2434,2452
356,ROKU  ,2023-02-08,2023-04-21,35.0,28,689,717
357,ROKU  ,2023-02-08,2023-04-21,40.0,150,1256,1406
358,ROKU  ,2023-02-08,2023-04-21,45.0,366,1444,1810
359,ROKU  ,2023-02-08,2023-04-21,50.0,486,2016,2502
360,ROKU  ,2023-02-08,2023-04-21,55.0,458,993,1451
361,ROKU  ,2023-02-08,2023-04-21,60.0,1313,670,1983
362,ROKU  ,2023-02-08,2023-04-21,65.0,982,624,1606
363,ROKU  ,2023-02-08,2023-04-21,70.0,1061,343,1404
364,ROKU  ,2023-02-08,2023-04-21,75.0,1005,615,1620
365,ROKU  ,2023-02-08,2023-04-21,80.0,785,36,821
366,ROKU  ,2023-02-08,2023-04-21,85.0,603,0,603
367,ROKU  ,2023-02-08,2023-04-21,90.0,242,4,246
368,ROKU  ,2023-02-08,2023-04-21,95.0,217,2,219
369,ROKU  ,2023-02-08,2023-04-21,100.0,1455,1,1456
370,ROKU  ,2023-02-08,2023-04-21,105.0,274,0,274
371,ROKU  ,2023-02-08,2023-04-21,110.0,259,0,259
372,ROKU  ,2023-02-08,2023-04-21,115.0,315,0,315
373,ROKU  ,2023-02-08,2023-04-21,120.0,382,0,382
374,ROKU  ,2023-02-08,2023-04-21,125.0,486,0,486
375,ROKU  ,2023-02-08,2023-06-16,20.0,26,255,281
376,ROKU  ,2023-02-08,2023-06-16,22.5,1,2155,2156
377,ROKU  ,2023-02-08,2023-06-16,25.0,1,1691,1692
378,ROKU  ,2023-02-08,2023-06-16,30.0,12,3251,3263
379,ROKU  ,2023-02-08,2023-06-16,35.0,110,2153,2263
380,ROKU  ,2023-02-08,2023-06-16,40.0,213,3661,3874
381,ROKU  ,2023-02-08,2023-06-16,45.0,435,8407,8842
382,ROKU  ,2023-02-08,2023-06-16,50.0,605,9236,9841
383,ROKU  ,2023-02-08,2023-06-16,55.0,1668,1878,3546
384,ROKU  ,2023-02-08,2023-06-16,60.0,2279,879,3158
385,ROKU  ,2023-02-08,2023-06-16,65.0,1098,733,1831
386,ROKU  ,2023-02-08,2023-06-16,70.0,1701,660,2361
387,ROKU  ,2023-02-08,2023-06-16,75.0,828,1006,1834
388,ROKU  ,2023-02-08,2023-06-16,80.0,1323,457,1780
389,ROKU  ,2023-02-08,2023-06-16,85.0,726,1194,1920
390,ROKU  ,2023-02-08,2023-06-16,90.0,1321,184,1505
391,ROKU  ,2023-02-08,2023-06-16,95.0,536,26,562
392,ROKU  ,2023-02-08,2023-06-16,100.0,1458,19,1477
393,ROKU  ,2023-02-08,2023-06-16,105.0,543,41,584
394,ROKU  ,2023-02-08,2023-06-16,110.0,1224,22,1246
395,ROKU  ,2023-02-08,2023-06-16,115.0,726,4,730
396,ROKU  ,2023-02-08,2023-06-16,120.0,920,0,920
397,ROKU  ,2023-02-08,2023-06-16,125.0,1000,1,1001
398,ROKU  ,2023-02-08,2023-06-16,130.0,646,0,646
399,ROKU  ,2023-02-08,2023-06-16,135.0,829,0,829
400,ROKU  ,2023-02-08,2023-06-16,140.0,1603,0,1603
401,ROKU  ,2023-02-08,2023-07-21,20.0,6,131,137
402,ROKU  ,2023-02-08,2023-07-21,22.5,0,124,124
403,ROKU  ,2023-02-08,2023-07-21,25.0,1,202,203
404,ROKU  ,2023-02-08,2023-07-21,30.0,249,1632,1881
405,ROKU  ,2023-02-08,2023-07-21,35.0,15,1598,1613
406,ROKU  ,2023-02-08,2023-07-21,40.0,132,1666,1798
407,ROKU  ,2023-02-08,2023-07-21,45.0,93,791,884
408,ROKU  ,2023-02-08,2023-07-21,50.0,337,641,978
409,ROKU  ,2023-02-08,2023-07-21,55.0,158,1332,1490
410,ROKU  ,2023-02-08,2023-07-21,60.0,150,563,713
411,ROKU  ,2023-02-08,2023-07-21,65.0,469,366,835
412,ROKU  ,2023-02-08,2023-07-21,70.0,510,71,581
413,ROKU  ,2023-02-08,2023-07-21,75.0,411,420,831
414,ROKU  ,2023-02-08,2023-07-21,80.0,771,799,1570
415,ROKU  ,2023-02-08,2023-07-21,85.0,1316,385,1701
416,ROKU  ,2023-02-08,2023-07-21,90.0,294,97,391
417,ROKU  ,2023-02-08,2023-07-21,95.0,165,10,175
418,ROKU  ,2023-02-08,2023-07-21,100.0,77,69,146
419,ROKU  ,2023-02-08,2023-09-15,20.0,3,6,9
420,ROKU  ,2023-02-08,2023-09-15,22.5,0,70,70
421,ROKU  ,2023-02-08,2023-09-15,25.0,0,297,297
422,ROKU  ,2023-02-08,2023-09-15,30.0,15,71,86
423,ROKU  ,2023-02-08,2023-09-15,35.0,35,584,619
424,ROKU  ,2023-02-08,2023-09-15,40.0,1808,1284,3092
425,ROKU  ,2023-02-08,2023-09-15,45.0,18,763,781
426,ROKU  ,2023-02-08,2023-09-15,50.0,27,611,638
427,ROKU  ,2023-02-08,2023-09-15,55.0,234,194,428
428,ROKU  ,2023-02-08,2023-09-15,60.0,3896,156,4052
429,ROKU  ,2023-02-08,2023-09-15,65.0,883,255,1138
430,ROKU  ,2023-02-08,2023-09-15,70.0,136,66,202
431,ROKU  ,2023-02-08,2023-09-15,75.0,216,61,277
432,ROKU  ,2023-02-08,2023-09-15,80.0,393,7,400
433,ROKU  ,2023-02-08,2023-09-15,85.0,69,27,96
434,ROKU  ,2023-02-08,2023-09-15,90.0,440,10,450
435,ROKU  ,2023-02-08,2023-09-15,95.0,27,0,27
436,ROKU  ,2023-02-08,2023-09-15,100.0,78,70,148
437,ROKU  ,2023-02-08,2024-01-19,20.0,11,84,95
438,ROKU  ,2023-02-08,2024-01-19,22.5,1,97,98
439,ROKU  ,2023-02-08,2024-01-19,25.0,27,888,915
440,ROKU  ,2023-02-08,2024-01-19,30.0,109,2049,2158
441,ROKU  ,2023-02-08,2024-01-19,35.0,119,1141,1260
442,ROKU  ,2023-02-08,2024-01-19,40.0,833,1620,2453
443,ROKU  ,2023-02-08,2024-01-19,45.0,385,2208,2593
444,ROKU  ,2023-02-08,2024-01-19,50.0,319,614,933
445,ROKU  ,2023-02-08,2024-01-19,55.0,199,233,432
446,ROKU  ,2023-02-08,2024-01-19,60.0,636,2182,2818
447,ROKU  ,2023-02-08,2024-01-19,65.0,575,940,1515
448,ROKU  ,2023-02-08,2024-01-19,70.0,605,277,882
449,ROKU  ,2023-02-08,2024-01-19,75.0,288,564,852
450,ROKU  ,2023-02-08,2024-01-19,80.0,390,1007,1397
451,ROKU  ,2023-02-08,2024-01-19,85.0,509,683,1192
452,ROKU  ,2023-02-08,2024-01-19,90.0,2056,786,2842
453,ROKU  ,2023-02-08,2024-01-19,95.0,781,341,1122
454,ROKU  ,2023-02-08,2024-01-19,100.0,1171,347,1518
455,ROKU  ,2023-02-08,2024-01-19,105.0,255,364,619
456,ROKU  ,2023-02-08,2024-01-19,110.0,620,63,683
457,ROKU  ,2023-02-08,2024-01-19,115.0,762,285,1047
458,ROKU  ,2023-02-08,2024-01-19,120.0,2160,7,2167
459,ROKU  ,2023-02-08,2024-01-19,125.0,296,6,302
460,ROKU  ,2023-02-08,2024-01-19,130.0,595,56,651
461,ROKU  ,2023-02-08,2024-01-19,135.0,223,6,229
462,ROKU  ,2023-02-08,2024-01-19,140.0,386,1,387
463,ROKU  ,2023-02-08,2024-01-19,145.0,321,0,321
464,ROKU  ,2023-02-08,2024-01-19,150.0,1639,14,1653
465,ROKU  ,2023-02-08,2024-01-19,155.0,395,2,397
466,ROKU  ,2023-02-08,2024-01-19,160.0,264,14,278
467,ROKU  ,2023-02-08,2024-01-19,165.0,124,0,124
468,ROKU  ,2023-02-08,2024-01-19,170.0,393,0,393
469,ROKU  ,2023-02-08,2024-01-19,175.0,372,0,372
470,ROKU  ,2023-02-08,2024-01-19,180.0,501,1,502
471,ROKU  ,2023-02-08,2024-01-19,185.0,205,8,213
472,ROKU  ,2023-02-08,2024-01-19,190.0,1427,5,1432
473,ROKU  ,2023-02-08,2024-01-19,195.0,188,2,190
474,ROKU  ,2023-02-08,2024-01-19,200.0,1656,0,1656
475,ROKU  ,2023-02-08,2024-01-19,205.0,135,0,135
476,ROKU  ,2023-02-08,2024-01-19,210.0,501,0,501
477,ROKU  ,2023-02-08,2024-01-19,220.0,846,0,846
478,ROKU  ,2023-02-08,2024-01-19,230.0,230,0,230
479,ROKU  ,2023-02-08,2024-01-19,240.0,156,0,156
480,ROKU  ,2023-02-08,2024-01-19,250.0,648,0,648
481,ROKU  ,2023-02-08,2024-01-19,260.0,190,0,190
482,ROKU  ,2023-02-08,2024-01-19,270.0,123,0,123
483,ROKU  ,2023-02-08,2024-01-19,280.0,159,0,159
484,ROKU  ,2023-02-08,2024-01-19,290.0,320,0,320
485,ROKU  ,2023-02-08,2024-01-19,300.0,2207,0,2207
486,ROKU  ,2023-02-08,2024-01-19,310.0,353,0,353
487,ROKU  ,2023-02-08,2024-01-19,320.0,337,0,337
488,ROKU  ,2023-02-08,2024-01-19,330.0,281,0,281
489,ROKU  ,2023-02-08,2024-01-19,340.0,180,0,180
490,ROKU  ,2023-02-08,2024-01-19,350.0,219,0,219
491,ROKU  ,2023-02-08,2024-01-19,360.0,538,0,538
492,ROKU  ,2023-02-08,2024-01-19,370.0,107,0,107
493,ROKU  ,2023-02-08,2024-01-19,380.0,143,0,143
494,ROKU  ,2023-02-08,2024-01-19,390.0,428,0,428
495,ROKU  ,2023-02-08,2024-01-19,400.0,1014,0,1014
496,ROKU  ,2023-02-08,2024-01-19,410.0,124,0,124
497,ROKU  ,2023-02-08,2024-01-19,420.0,283,0,283
498,ROKU  ,2023-02-08,2024-01-19,430.0,457,0,457
499,ROKU  ,2023-02-08,2024-01-19,440.0,142,0,142
500,ROKU  ,2023-02-08,2024-01-19,450.0,294,0,294
501,ROKU  ,2023-02-08,2024-01-19,460.0,31,0,31
502,ROKU  ,2023-02-08,2024-01-19,470.0,179,0,179
503,ROKU  ,2023-02-08,2024-01-19,480.0,45,0,45
504,ROKU  ,2023-02-08,2024-01-19,490.0,29,0,29
505,ROKU  ,2023-02-08,2024-01-19,500.0,367,0,367
506,ROKU  ,2023-02-08,2024-01-19,510.0,143,0,143
507,ROKU  ,2023-02-08,2024-01-19,520.0,2847,0,2847
508,ROKU  ,2023-02-08,2024-06-21,20.0,0,15,15
509,ROKU  ,2023-02-08,2024-06-21,22.5,1,4,5
510,ROKU  ,2023-02-08,2024-06-21,25.0,1,2,3
511,ROKU  ,2023-02-08,2024-06-21,30.0,2,38,40
512,ROKU  ,2023-02-08,2024-06-21,35.0,10,412,422
513,ROKU  ,2023-02-08,2024-06-21,40.0,25,43,68
514,ROKU  ,2023-02-08,2024-06-21,45.0,12,407,419
515,ROKU  ,2023-02-08,2024-06-21,50.0,28,78,106
516,ROKU  ,2023-02-08,2024-06-21,55.0,20,19,39
517,ROKU  ,2023-02-08,2024-06-21,60.0,24,54,78
518,ROKU  ,2023-02-08,2024-06-21,65.0,32,17,49
519,ROKU  ,2023-02-08,2024-06-21,70.0,34,3,37
520,ROKU  ,2023-02-08,2024-06-21,75.0,14,9,23
521,ROKU  ,2023-02-08,2024-06-21,80.0,35,70,105
522,ROKU  ,2023-02-08,2024-06-21,85.0,11,18,29
523,ROKU  ,2023-02-08,2024-06-21,90.0,42,37,79
524,ROKU  ,2023-02-08,2024-06-21,95.0,0,0,0
525,ROKU  ,2023-02-08,2024-06-21,100.0,2,0,2
526,ROKU  ,2023-02-08,2025-01-17,20.0,27,36,63
527,ROKU  ,2023-02-08,2025-01-17,22.5,8,29,37
528,ROKU  ,2023-02-08,2025-01-17,25.0,25,69,94
529,ROKU  ,2023-02-08,2025-01-17,30.0,50,135,185
530,ROKU  ,2023-02-08,2025-01-17,35.0,51,271,322
531,ROKU  ,2023-02-08,2025-01-17,40.0,135,238,373
532,ROKU  ,2023-02-08,2025-01-17,45.0,55,307,362
533,ROKU  ,2023-02-08,2025-01-17,50.0,140,565,705
534,ROKU  ,2023-02-08,2025-01-17,55.0,218,294,512
535,ROKU  ,2023-02-08,2025-01-17,60.0,1878,205,2083
536,ROKU  ,2023-02-08,2025-01-17,65.0,908,49,957
537,ROKU  ,2023-02-08,2025-01-17,70.0,164,33,197
538,ROKU  ,2023-02-08,2025-01-17,75.0,176,1040,1216
539,ROKU  ,2023-02-08,2025-01-17,80.0,114,45,159
540,ROKU  ,2023-02-08,2025-01-17,85.0,47,131,178
541,ROKU  ,2023-02-08,2025-01-17,90.0,60,23,83
542,ROKU  ,2023-02-08,2025-01-17,95.0,67,3,70
543,ROKU  ,2023-02-08,2025-01-17,100.0,227,41,268
544,ROKU  ,2023-02-08,2025-01-17,105.0,472,14,486
545,ROKU  ,2023-02-08,2025-01-17,110.0,873,89,962
