index,ProductSymbol,DateGen,ExpDate,Strike,Call,Put,TotalOI
0,ROKU  ,2023-02-14,2023-02-17,20.0,1,358,359
1,ROKU  ,2023-02-14,2023-02-17,22.5,20,428,448
2,ROKU  ,2023-02-14,2023-02-17,25.0,17,2720,2737
3,ROKU  ,2023-02-14,2023-02-17,30.0,95,5244,5339
4,ROKU  ,2023-02-14,2023-02-17,35.0,85,6008,6093
5,ROKU  ,2023-02-14,2023-02-17,36.0,3,60,63
6,ROKU  ,2023-02-14,2023-02-17,36.5,0,3,3
7,ROKU  ,2023-02-14,2023-02-17,37.0,0,12,12
8,ROKU  ,2023-02-14,2023-02-17,37.5,0,66,66
9,ROKU  ,2023-02-14,2023-02-17,38.0,0,24,24
10,ROKU  ,2023-02-14,2023-02-17,38.5,0,47,47
11,ROKU  ,2023-02-14,2023-02-17,39.0,0,77,77
12,ROKU  ,2023-02-14,2023-02-17,40.0,756,2835,3591
13,ROKU  ,2023-02-14,2023-02-17,41.0,0,50,50
14,ROKU  ,2023-02-14,2023-02-17,42.0,19,577,596
15,ROKU  ,2023-02-14,2023-02-17,43.0,7,841,848
16,ROKU  ,2023-02-14,2023-02-17,44.0,15,239,254
17,ROKU  ,2023-02-14,2023-02-17,45.0,1298,4446,5744
18,ROKU  ,2023-02-14,2023-02-17,45.5,41,256,297
19,ROKU  ,2023-02-14,2023-02-17,46.0,69,381,450
20,ROKU  ,2023-02-14,2023-02-17,46.5,40,252,292
21,ROKU  ,2023-02-14,2023-02-17,47.0,75,861,936
22,ROKU  ,2023-02-14,2023-02-17,47.5,52,661,713
23,ROKU  ,2023-02-14,2023-02-17,48.0,37,910,947
24,ROKU  ,2023-02-14,2023-02-17,48.5,34,287,321
25,ROKU  ,2023-02-14,2023-02-17,49.0,167,551,718
26,ROKU  ,2023-02-14,2023-02-17,49.5,156,523,679
27,ROKU  ,2023-02-14,2023-02-17,50.0,2061,3925,5986
28,ROKU  ,2023-02-14,2023-02-17,51.0,274,1674,1948
29,ROKU  ,2023-02-14,2023-02-17,52.0,114,1035,1149
30,ROKU  ,2023-02-14,2023-02-17,53.0,113,767,880
31,ROKU  ,2023-02-14,2023-02-17,54.0,409,870,1279
32,ROKU  ,2023-02-14,2023-02-17,55.0,2473,1622,4095
33,ROKU  ,2023-02-14,2023-02-17,56.0,628,515,1143
34,ROKU  ,2023-02-14,2023-02-17,57.0,979,211,1190
35,ROKU  ,2023-02-14,2023-02-17,58.0,599,527,1126
36,ROKU  ,2023-02-14,2023-02-17,59.0,683,315,998
37,ROKU  ,2023-02-14,2023-02-17,60.0,3505,1082,4587
38,ROKU  ,2023-02-14,2023-02-17,61.0,1638,178,1816
39,ROKU  ,2023-02-14,2023-02-17,62.0,727,267,994
40,ROKU  ,2023-02-14,2023-02-17,63.0,649,153,802
41,ROKU  ,2023-02-14,2023-02-17,64.0,603,310,913
42,ROKU  ,2023-02-14,2023-02-17,65.0,4561,1090,5651
43,ROKU  ,2023-02-14,2023-02-17,66.0,621,197,818
44,ROKU  ,2023-02-14,2023-02-17,67.0,918,567,1485
45,ROKU  ,2023-02-14,2023-02-17,68.0,569,288,857
46,ROKU  ,2023-02-14,2023-02-17,69.0,338,256,594
47,ROKU  ,2023-02-14,2023-02-17,70.0,2007,288,2295
48,ROKU  ,2023-02-14,2023-02-17,71.0,447,82,529
49,ROKU  ,2023-02-14,2023-02-17,72.0,899,98,997
50,ROKU  ,2023-02-14,2023-02-17,73.0,187,89,276
51,ROKU  ,2023-02-14,2023-02-17,74.0,490,147,637
52,ROKU  ,2023-02-14,2023-02-17,75.0,2003,164,2167
53,ROKU  ,2023-02-14,2023-02-17,76.0,265,25,290
54,ROKU  ,2023-02-14,2023-02-17,77.0,166,46,212
55,ROKU  ,2023-02-14,2023-02-17,78.0,189,37,226
56,ROKU  ,2023-02-14,2023-02-17,79.0,130,27,157
57,ROKU  ,2023-02-14,2023-02-17,80.0,614,24,638
58,ROKU  ,2023-02-14,2023-02-17,81.0,275,37,312
59,ROKU  ,2023-02-14,2023-02-17,82.0,689,30,719
60,ROKU  ,2023-02-14,2023-02-17,83.0,107,20,127
61,ROKU  ,2023-02-14,2023-02-17,84.0,166,9,175
62,ROKU  ,2023-02-14,2023-02-17,85.0,3794,61,3855
63,ROKU  ,2023-02-14,2023-02-17,86.0,34,21,55
64,ROKU  ,2023-02-14,2023-02-17,87.0,238,34,272
65,ROKU  ,2023-02-14,2023-02-17,90.0,3868,23,3891
66,ROKU  ,2023-02-14,2023-02-17,95.0,141,0,141
67,ROKU  ,2023-02-14,2023-02-17,100.0,506,0,506
68,ROKU  ,2023-02-14,2023-02-24,25.0,4,2503,2507
69,ROKU  ,2023-02-14,2023-02-24,30.0,1,191,192
70,ROKU  ,2023-02-14,2023-02-24,32.0,0,89,89
71,ROKU  ,2023-02-14,2023-02-24,33.0,0,53,53
72,ROKU  ,2023-02-14,2023-02-24,34.0,10,246,256
73,ROKU  ,2023-02-14,2023-02-24,35.0,5,487,492
74,ROKU  ,2023-02-14,2023-02-24,36.0,1,196,197
75,ROKU  ,2023-02-14,2023-02-24,36.5,0,0,0
76,ROKU  ,2023-02-14,2023-02-24,37.0,0,69,69
77,ROKU  ,2023-02-14,2023-02-24,37.5,0,2,2
78,ROKU  ,2023-02-14,2023-02-24,38.0,2,100,102
79,ROKU  ,2023-02-14,2023-02-24,38.5,0,10,10
80,ROKU  ,2023-02-14,2023-02-24,39.0,0,186,186
81,ROKU  ,2023-02-14,2023-02-24,39.5,0,5,5
82,ROKU  ,2023-02-14,2023-02-24,40.0,20,283,303
83,ROKU  ,2023-02-14,2023-02-24,40.5,0,1,1
84,ROKU  ,2023-02-14,2023-02-24,41.0,18,90,108
85,ROKU  ,2023-02-14,2023-02-24,41.5,4,0,4
86,ROKU  ,2023-02-14,2023-02-24,42.0,155,45,200
87,ROKU  ,2023-02-14,2023-02-24,42.5,0,0,0
88,ROKU  ,2023-02-14,2023-02-24,43.0,34,119,153
89,ROKU  ,2023-02-14,2023-02-24,43.5,0,15,15
90,ROKU  ,2023-02-14,2023-02-24,44.0,40,135,175
91,ROKU  ,2023-02-14,2023-02-24,44.5,0,3,3
92,ROKU  ,2023-02-14,2023-02-24,45.0,100,223,323
93,ROKU  ,2023-02-14,2023-02-24,45.5,4,4,8
94,ROKU  ,2023-02-14,2023-02-24,46.0,72,106,178
95,ROKU  ,2023-02-14,2023-02-24,46.5,5,1,6
96,ROKU  ,2023-02-14,2023-02-24,47.0,28,78,106
97,ROKU  ,2023-02-14,2023-02-24,47.5,12,2,14
98,ROKU  ,2023-02-14,2023-02-24,48.0,440,73,513
99,ROKU  ,2023-02-14,2023-02-24,48.5,3,3,6
100,ROKU  ,2023-02-14,2023-02-24,49.0,33,94,127
101,ROKU  ,2023-02-14,2023-02-24,49.5,6,0,6
102,ROKU  ,2023-02-14,2023-02-24,50.0,247,341,588
103,ROKU  ,2023-02-14,2023-02-24,51.0,199,152,351
104,ROKU  ,2023-02-14,2023-02-24,52.0,419,183,602
105,ROKU  ,2023-02-14,2023-02-24,53.0,122,123,245
106,ROKU  ,2023-02-14,2023-02-24,54.0,92,145,237
107,ROKU  ,2023-02-14,2023-02-24,55.0,281,275,556
108,ROKU  ,2023-02-14,2023-02-24,56.0,113,441,554
109,ROKU  ,2023-02-14,2023-02-24,57.0,498,58,556
110,ROKU  ,2023-02-14,2023-02-24,58.0,371,158,529
111,ROKU  ,2023-02-14,2023-02-24,59.0,50,77,127
112,ROKU  ,2023-02-14,2023-02-24,60.0,723,112,835
113,ROKU  ,2023-02-14,2023-02-24,61.0,79,52,131
114,ROKU  ,2023-02-14,2023-02-24,62.0,190,77,267
115,ROKU  ,2023-02-14,2023-02-24,63.0,62,61,123
116,ROKU  ,2023-02-14,2023-02-24,64.0,470,118,588
117,ROKU  ,2023-02-14,2023-02-24,65.0,380,183,563
118,ROKU  ,2023-02-14,2023-02-24,66.0,149,62,211
119,ROKU  ,2023-02-14,2023-02-24,67.0,149,69,218
120,ROKU  ,2023-02-14,2023-02-24,68.0,151,87,238
121,ROKU  ,2023-02-14,2023-02-24,69.0,68,47,115
122,ROKU  ,2023-02-14,2023-02-24,70.0,862,22,884
123,ROKU  ,2023-02-14,2023-02-24,71.0,73,19,92
124,ROKU  ,2023-02-14,2023-02-24,72.0,41,18,59
125,ROKU  ,2023-02-14,2023-02-24,73.0,82,16,98
126,ROKU  ,2023-02-14,2023-02-24,74.0,30,13,43
127,ROKU  ,2023-02-14,2023-02-24,75.0,135,4,139
128,ROKU  ,2023-02-14,2023-02-24,76.0,42,19,61
129,ROKU  ,2023-02-14,2023-02-24,77.0,86,5,91
130,ROKU  ,2023-02-14,2023-02-24,78.0,49,5,54
131,ROKU  ,2023-02-14,2023-02-24,79.0,76,8,84
132,ROKU  ,2023-02-14,2023-02-24,80.0,109,7,116
133,ROKU  ,2023-02-14,2023-02-24,81.0,71,5,76
134,ROKU  ,2023-02-14,2023-02-24,82.0,49,22,71
135,ROKU  ,2023-02-14,2023-02-24,83.0,18,0,18
136,ROKU  ,2023-02-14,2023-02-24,84.0,41,2,43
137,ROKU  ,2023-02-14,2023-02-24,85.0,74,4,78
138,ROKU  ,2023-02-14,2023-02-24,86.0,91,1,92
139,ROKU  ,2023-02-14,2023-02-24,87.0,198,0,198
140,ROKU  ,2023-02-14,2023-02-24,90.0,145,6,151
141,ROKU  ,2023-02-14,2023-02-24,95.0,110,4,114
142,ROKU  ,2023-02-14,2023-02-24,100.0,155,0,155
143,ROKU  ,2023-02-14,2023-03-03,25.0,0,743,743
144,ROKU  ,2023-02-14,2023-03-03,30.0,0,114,114
145,ROKU  ,2023-02-14,2023-03-03,35.0,0,201,201
146,ROKU  ,2023-02-14,2023-03-03,38.0,1,272,273
147,ROKU  ,2023-02-14,2023-03-03,39.0,0,43,43
148,ROKU  ,2023-02-14,2023-03-03,40.0,3,133,136
149,ROKU  ,2023-02-14,2023-03-03,41.0,0,30,30
150,ROKU  ,2023-02-14,2023-03-03,42.0,1,25,26
151,ROKU  ,2023-02-14,2023-03-03,43.0,1,76,77
152,ROKU  ,2023-02-14,2023-03-03,44.0,0,123,123
153,ROKU  ,2023-02-14,2023-03-03,45.0,10,1008,1018
154,ROKU  ,2023-02-14,2023-03-03,46.0,2,100,102
155,ROKU  ,2023-02-14,2023-03-03,47.0,55,144,199
156,ROKU  ,2023-02-14,2023-03-03,48.0,33,84,117
157,ROKU  ,2023-02-14,2023-03-03,49.0,36,64,100
158,ROKU  ,2023-02-14,2023-03-03,50.0,35,117,152
159,ROKU  ,2023-02-14,2023-03-03,51.0,26,53,79
160,ROKU  ,2023-02-14,2023-03-03,52.0,50,39,89
161,ROKU  ,2023-02-14,2023-03-03,53.0,37,32,69
162,ROKU  ,2023-02-14,2023-03-03,54.0,38,120,158
163,ROKU  ,2023-02-14,2023-03-03,55.0,83,111,194
164,ROKU  ,2023-02-14,2023-03-03,56.0,116,53,169
165,ROKU  ,2023-02-14,2023-03-03,57.0,63,129,192
166,ROKU  ,2023-02-14,2023-03-03,58.0,64,17,81
167,ROKU  ,2023-02-14,2023-03-03,59.0,30,6,36
168,ROKU  ,2023-02-14,2023-03-03,60.0,104,49,153
169,ROKU  ,2023-02-14,2023-03-03,61.0,64,10,74
170,ROKU  ,2023-02-14,2023-03-03,62.0,49,85,134
171,ROKU  ,2023-02-14,2023-03-03,63.0,54,38,92
172,ROKU  ,2023-02-14,2023-03-03,64.0,53,67,120
173,ROKU  ,2023-02-14,2023-03-03,65.0,651,56,707
174,ROKU  ,2023-02-14,2023-03-03,66.0,60,13,73
175,ROKU  ,2023-02-14,2023-03-03,67.0,850,6,856
176,ROKU  ,2023-02-14,2023-03-03,68.0,38,6,44
177,ROKU  ,2023-02-14,2023-03-03,69.0,19,9,28
178,ROKU  ,2023-02-14,2023-03-03,70.0,547,20,567
179,ROKU  ,2023-02-14,2023-03-03,71.0,24,4,28
180,ROKU  ,2023-02-14,2023-03-03,72.0,48,6,54
181,ROKU  ,2023-02-14,2023-03-03,73.0,6,11,17
182,ROKU  ,2023-02-14,2023-03-03,74.0,9,0,9
183,ROKU  ,2023-02-14,2023-03-03,75.0,70,17,87
184,ROKU  ,2023-02-14,2023-03-03,76.0,3,1,4
185,ROKU  ,2023-02-14,2023-03-03,77.0,15,7,22
186,ROKU  ,2023-02-14,2023-03-03,78.0,47,0,47
187,ROKU  ,2023-02-14,2023-03-03,80.0,58,0,58
188,ROKU  ,2023-02-14,2023-03-03,85.0,144,10,154
189,ROKU  ,2023-02-14,2023-03-03,90.0,94,0,94
190,ROKU  ,2023-02-14,2023-03-03,95.0,66,0,66
191,ROKU  ,2023-02-14,2023-03-03,100.0,232,0,232
192,ROKU  ,2023-02-14,2023-03-10,30.0,0,2551,2551
193,ROKU  ,2023-02-14,2023-03-10,35.0,0,30,30
194,ROKU  ,2023-02-14,2023-03-10,40.0,3,25,28
195,ROKU  ,2023-02-14,2023-03-10,41.0,0,18,18
196,ROKU  ,2023-02-14,2023-03-10,42.0,2,35,37
197,ROKU  ,2023-02-14,2023-03-10,43.0,1,21,22
198,ROKU  ,2023-02-14,2023-03-10,44.0,0,309,309
199,ROKU  ,2023-02-14,2023-03-10,45.0,2,155,157
200,ROKU  ,2023-02-14,2023-03-10,46.0,0,291,291
201,ROKU  ,2023-02-14,2023-03-10,47.0,2,56,58
202,ROKU  ,2023-02-14,2023-03-10,48.0,35,33,68
203,ROKU  ,2023-02-14,2023-03-10,49.0,7,22,29
204,ROKU  ,2023-02-14,2023-03-10,50.0,14,71,85
205,ROKU  ,2023-02-14,2023-03-10,51.0,14,13,27
206,ROKU  ,2023-02-14,2023-03-10,52.0,23,87,110
207,ROKU  ,2023-02-14,2023-03-10,53.0,22,19,41
208,ROKU  ,2023-02-14,2023-03-10,54.0,85,28,113
209,ROKU  ,2023-02-14,2023-03-10,55.0,60,46,106
210,ROKU  ,2023-02-14,2023-03-10,56.0,56,19,75
211,ROKU  ,2023-02-14,2023-03-10,57.0,34,23,57
212,ROKU  ,2023-02-14,2023-03-10,58.0,56,16,72
213,ROKU  ,2023-02-14,2023-03-10,59.0,11,27,38
214,ROKU  ,2023-02-14,2023-03-10,60.0,78,43,121
215,ROKU  ,2023-02-14,2023-03-10,61.0,10,21,31
216,ROKU  ,2023-02-14,2023-03-10,62.0,24,40,64
217,ROKU  ,2023-02-14,2023-03-10,63.0,82,28,110
218,ROKU  ,2023-02-14,2023-03-10,64.0,26,39,65
219,ROKU  ,2023-02-14,2023-03-10,65.0,89,45,134
220,ROKU  ,2023-02-14,2023-03-10,66.0,11,3,14
221,ROKU  ,2023-02-14,2023-03-10,67.0,23,19,42
222,ROKU  ,2023-02-14,2023-03-10,68.0,26,5,31
223,ROKU  ,2023-02-14,2023-03-10,69.0,23,10,33
224,ROKU  ,2023-02-14,2023-03-10,70.0,152,35,187
225,ROKU  ,2023-02-14,2023-03-10,71.0,2,0,2
226,ROKU  ,2023-02-14,2023-03-10,72.0,7,0,7
227,ROKU  ,2023-02-14,2023-03-10,73.0,10,0,10
228,ROKU  ,2023-02-14,2023-03-10,74.0,2,0,2
229,ROKU  ,2023-02-14,2023-03-10,75.0,51,0,51
230,ROKU  ,2023-02-14,2023-03-10,76.0,3,0,3
231,ROKU  ,2023-02-14,2023-03-10,77.0,4,0,4
232,ROKU  ,2023-02-14,2023-03-10,78.0,19,0,19
233,ROKU  ,2023-02-14,2023-03-10,80.0,38,0,38
234,ROKU  ,2023-02-14,2023-03-10,85.0,27,0,27
235,ROKU  ,2023-02-14,2023-03-10,90.0,102,0,102
236,ROKU  ,2023-02-14,2023-03-10,95.0,39,0,39
237,ROKU  ,2023-02-14,2023-03-10,100.0,2,0,2
238,ROKU  ,2023-02-14,2023-03-17,20.0,9,218,227
239,ROKU  ,2023-02-14,2023-03-17,22.5,22,519,541
240,ROKU  ,2023-02-14,2023-03-17,25.0,20,2921,2941
241,ROKU  ,2023-02-14,2023-03-17,30.0,13,7652,7665
242,ROKU  ,2023-02-14,2023-03-17,35.0,189,8001,8190
243,ROKU  ,2023-02-14,2023-03-17,40.0,315,2787,3102
244,ROKU  ,2023-02-14,2023-03-17,45.0,462,3128,3590
245,ROKU  ,2023-02-14,2023-03-17,50.0,1186,2906,4092
246,ROKU  ,2023-02-14,2023-03-17,55.0,1966,1754,3720
247,ROKU  ,2023-02-14,2023-03-17,60.0,1573,1547,3120
248,ROKU  ,2023-02-14,2023-03-17,65.0,2338,422,2760
249,ROKU  ,2023-02-14,2023-03-17,70.0,1628,342,1970
250,ROKU  ,2023-02-14,2023-03-17,75.0,1371,127,1498
251,ROKU  ,2023-02-14,2023-03-17,80.0,889,6,895
252,ROKU  ,2023-02-14,2023-03-17,85.0,2425,5,2430
253,ROKU  ,2023-02-14,2023-03-17,90.0,1662,13,1675
254,ROKU  ,2023-02-14,2023-03-17,95.0,821,4,825
255,ROKU  ,2023-02-14,2023-03-17,100.0,2894,0,2894
256,ROKU  ,2023-02-14,2023-03-17,105.0,968,1,969
257,ROKU  ,2023-02-14,2023-03-17,110.0,2106,0,2106
258,ROKU  ,2023-02-14,2023-03-24,30.0,0,0,0
259,ROKU  ,2023-02-14,2023-03-24,35.0,0,26,26
260,ROKU  ,2023-02-14,2023-03-24,40.0,0,128,128
261,ROKU  ,2023-02-14,2023-03-24,45.0,5,70,75
262,ROKU  ,2023-02-14,2023-03-24,46.0,7,14,21
263,ROKU  ,2023-02-14,2023-03-24,47.0,1,34,35
264,ROKU  ,2023-02-14,2023-03-24,48.0,0,14,14
265,ROKU  ,2023-02-14,2023-03-24,49.0,0,4,4
266,ROKU  ,2023-02-14,2023-03-24,50.0,10,48,58
267,ROKU  ,2023-02-14,2023-03-24,51.0,10,4,14
268,ROKU  ,2023-02-14,2023-03-24,52.0,6,6,12
269,ROKU  ,2023-02-14,2023-03-24,53.0,5,6,11
270,ROKU  ,2023-02-14,2023-03-24,54.0,0,111,111
271,ROKU  ,2023-02-14,2023-03-24,55.0,35,198,233
272,ROKU  ,2023-02-14,2023-03-24,56.0,9,6,15
273,ROKU  ,2023-02-14,2023-03-24,57.0,4,4,8
274,ROKU  ,2023-02-14,2023-03-24,58.0,9,2,11
275,ROKU  ,2023-02-14,2023-03-24,59.0,12,16,28
276,ROKU  ,2023-02-14,2023-03-24,60.0,57,39,96
277,ROKU  ,2023-02-14,2023-03-24,61.0,16,4,20
278,ROKU  ,2023-02-14,2023-03-24,62.0,7,26,33
279,ROKU  ,2023-02-14,2023-03-24,63.0,10,1,11
280,ROKU  ,2023-02-14,2023-03-24,64.0,24,0,24
281,ROKU  ,2023-02-14,2023-03-24,65.0,33,5,38
282,ROKU  ,2023-02-14,2023-03-24,66.0,10,1,11
283,ROKU  ,2023-02-14,2023-03-24,67.0,15,2,17
284,ROKU  ,2023-02-14,2023-03-24,68.0,14,0,14
285,ROKU  ,2023-02-14,2023-03-24,69.0,45,0,45
286,ROKU  ,2023-02-14,2023-03-24,70.0,13,3,16
287,ROKU  ,2023-02-14,2023-03-24,71.0,9,0,9
288,ROKU  ,2023-02-14,2023-03-24,72.0,27,0,27
289,ROKU  ,2023-02-14,2023-03-24,73.0,22,0,22
290,ROKU  ,2023-02-14,2023-03-24,74.0,4,8,12
291,ROKU  ,2023-02-14,2023-03-24,75.0,11,0,11
292,ROKU  ,2023-02-14,2023-03-24,76.0,2,0,2
293,ROKU  ,2023-02-14,2023-03-24,77.0,2,0,2
294,ROKU  ,2023-02-14,2023-03-24,78.0,10,0,10
295,ROKU  ,2023-02-14,2023-03-24,80.0,5,0,5
296,ROKU  ,2023-02-14,2023-03-24,85.0,8,0,8
297,ROKU  ,2023-02-14,2023-03-24,90.0,1,0,1
298,ROKU  ,2023-02-14,2023-03-24,95.0,47,0,47
299,ROKU  ,2023-02-14,2023-03-24,100.0,48,0,48
300,ROKU  ,2023-02-14,2023-03-31,30.0,0,5,5
301,ROKU  ,2023-02-14,2023-03-31,35.0,0,10,10
302,ROKU  ,2023-02-14,2023-03-31,40.0,0,137,137
303,ROKU  ,2023-02-14,2023-03-31,45.0,24,1,25
304,ROKU  ,2023-02-14,2023-03-31,47.0,10,32,42
305,ROKU  ,2023-02-14,2023-03-31,48.0,2,25,27
306,ROKU  ,2023-02-14,2023-03-31,49.0,0,27,27
307,ROKU  ,2023-02-14,2023-03-31,50.0,0,9,9
308,ROKU  ,2023-02-14,2023-03-31,51.0,1,2,3
309,ROKU  ,2023-02-14,2023-03-31,52.0,0,20,20
310,ROKU  ,2023-02-14,2023-03-31,53.0,10,2,12
311,ROKU  ,2023-02-14,2023-03-31,54.0,1,7,8
312,ROKU  ,2023-02-14,2023-03-31,55.0,1,1,2
313,ROKU  ,2023-02-14,2023-03-31,56.0,2,20,22
314,ROKU  ,2023-02-14,2023-03-31,57.0,1,0,1
315,ROKU  ,2023-02-14,2023-03-31,58.0,8,20,28
316,ROKU  ,2023-02-14,2023-03-31,59.0,15,10,25
317,ROKU  ,2023-02-14,2023-03-31,60.0,13,4,17
318,ROKU  ,2023-02-14,2023-03-31,61.0,1,2,3
319,ROKU  ,2023-02-14,2023-03-31,62.0,1,4,5
320,ROKU  ,2023-02-14,2023-03-31,63.0,0,0,0
321,ROKU  ,2023-02-14,2023-03-31,64.0,0,21,21
322,ROKU  ,2023-02-14,2023-03-31,65.0,0,0,0
323,ROKU  ,2023-02-14,2023-03-31,66.0,0,1,1
324,ROKU  ,2023-02-14,2023-03-31,67.0,1,1,2
325,ROKU  ,2023-02-14,2023-03-31,68.0,21,0,21
326,ROKU  ,2023-02-14,2023-03-31,69.0,1,0,1
327,ROKU  ,2023-02-14,2023-03-31,70.0,1,1,2
328,ROKU  ,2023-02-14,2023-03-31,71.0,5,0,5
329,ROKU  ,2023-02-14,2023-03-31,75.0,52,0,52
330,ROKU  ,2023-02-14,2023-03-31,80.0,9,0,9
331,ROKU  ,2023-02-14,2023-03-31,85.0,121,0,121
332,ROKU  ,2023-02-14,2023-03-31,90.0,43,0,43
333,ROKU  ,2023-02-14,2023-04-21,20.0,0,126,126
334,ROKU  ,2023-02-14,2023-04-21,22.5,2,388,390
335,ROKU  ,2023-02-14,2023-04-21,25.0,18,1185,1203
336,ROKU  ,2023-02-14,2023-04-21,30.0,22,2455,2477
337,ROKU  ,2023-02-14,2023-04-21,35.0,29,703,732
338,ROKU  ,2023-02-14,2023-04-21,40.0,153,1252,1405
339,ROKU  ,2023-02-14,2023-04-21,45.0,366,1492,1858
340,ROKU  ,2023-02-14,2023-04-21,50.0,508,2074,2582
341,ROKU  ,2023-02-14,2023-04-21,55.0,501,1160,1661
342,ROKU  ,2023-02-14,2023-04-21,60.0,1351,842,2193
343,ROKU  ,2023-02-14,2023-04-21,65.0,1105,642,1747
344,ROKU  ,2023-02-14,2023-04-21,70.0,1225,355,1580
345,ROKU  ,2023-02-14,2023-04-21,75.0,939,613,1552
346,ROKU  ,2023-02-14,2023-04-21,80.0,830,48,878
347,ROKU  ,2023-02-14,2023-04-21,85.0,626,34,660
348,ROKU  ,2023-02-14,2023-04-21,90.0,320,24,344
349,ROKU  ,2023-02-14,2023-04-21,95.0,218,2,220
350,ROKU  ,2023-02-14,2023-04-21,100.0,1477,3,1480
351,ROKU  ,2023-02-14,2023-04-21,105.0,370,0,370
352,ROKU  ,2023-02-14,2023-04-21,110.0,259,0,259
353,ROKU  ,2023-02-14,2023-04-21,115.0,316,0,316
354,ROKU  ,2023-02-14,2023-04-21,120.0,388,0,388
355,ROKU  ,2023-02-14,2023-04-21,125.0,496,0,496
356,ROKU  ,2023-02-14,2023-06-16,20.0,29,256,285
357,ROKU  ,2023-02-14,2023-06-16,22.5,1,2155,2156
358,ROKU  ,2023-02-14,2023-06-16,25.0,1,1691,1692
359,ROKU  ,2023-02-14,2023-06-16,30.0,12,3233,3245
360,ROKU  ,2023-02-14,2023-06-16,35.0,110,2162,2272
361,ROKU  ,2023-02-14,2023-06-16,40.0,213,3632,3845
362,ROKU  ,2023-02-14,2023-06-16,45.0,431,8408,8839
363,ROKU  ,2023-02-14,2023-06-16,50.0,619,9231,9850
364,ROKU  ,2023-02-14,2023-06-16,55.0,1695,1873,3568
365,ROKU  ,2023-02-14,2023-06-16,60.0,2295,909,3204
366,ROKU  ,2023-02-14,2023-06-16,65.0,1178,727,1905
367,ROKU  ,2023-02-14,2023-06-16,70.0,1743,645,2388
368,ROKU  ,2023-02-14,2023-06-16,75.0,876,1006,1882
369,ROKU  ,2023-02-14,2023-06-16,80.0,1425,457,1882
370,ROKU  ,2023-02-14,2023-06-16,85.0,749,1192,1941
371,ROKU  ,2023-02-14,2023-06-16,90.0,1322,205,1527
372,ROKU  ,2023-02-14,2023-06-16,95.0,538,55,593
373,ROKU  ,2023-02-14,2023-06-16,100.0,1518,40,1558
374,ROKU  ,2023-02-14,2023-06-16,105.0,559,69,628
375,ROKU  ,2023-02-14,2023-06-16,110.0,1227,22,1249
376,ROKU  ,2023-02-14,2023-06-16,115.0,726,4,730
377,ROKU  ,2023-02-14,2023-06-16,120.0,938,0,938
378,ROKU  ,2023-02-14,2023-06-16,125.0,998,1,999
379,ROKU  ,2023-02-14,2023-06-16,130.0,607,0,607
380,ROKU  ,2023-02-14,2023-06-16,135.0,943,0,943
381,ROKU  ,2023-02-14,2023-06-16,140.0,1446,0,1446
382,ROKU  ,2023-02-14,2023-07-21,20.0,6,169,175
383,ROKU  ,2023-02-14,2023-07-21,22.5,0,124,124
384,ROKU  ,2023-02-14,2023-07-21,25.0,1,203,204
385,ROKU  ,2023-02-14,2023-07-21,30.0,249,1742,1991
386,ROKU  ,2023-02-14,2023-07-21,35.0,15,1599,1614
387,ROKU  ,2023-02-14,2023-07-21,40.0,133,1683,1816
388,ROKU  ,2023-02-14,2023-07-21,45.0,93,853,946
389,ROKU  ,2023-02-14,2023-07-21,50.0,336,664,1000
390,ROKU  ,2023-02-14,2023-07-21,55.0,164,1353,1517
391,ROKU  ,2023-02-14,2023-07-21,60.0,152,592,744
392,ROKU  ,2023-02-14,2023-07-21,65.0,590,345,935
393,ROKU  ,2023-02-14,2023-07-21,70.0,564,90,654
394,ROKU  ,2023-02-14,2023-07-21,75.0,480,420,900
395,ROKU  ,2023-02-14,2023-07-21,80.0,823,805,1628
396,ROKU  ,2023-02-14,2023-07-21,85.0,1371,390,1761
397,ROKU  ,2023-02-14,2023-07-21,90.0,306,103,409
398,ROKU  ,2023-02-14,2023-07-21,95.0,206,58,264
399,ROKU  ,2023-02-14,2023-07-21,100.0,228,120,348
400,ROKU  ,2023-02-14,2023-09-15,20.0,3,7,10
401,ROKU  ,2023-02-14,2023-09-15,22.5,0,72,72
402,ROKU  ,2023-02-14,2023-09-15,25.0,0,299,299
403,ROKU  ,2023-02-14,2023-09-15,30.0,15,83,98
404,ROKU  ,2023-02-14,2023-09-15,35.0,35,1439,1474
405,ROKU  ,2023-02-14,2023-09-15,40.0,1834,1280,3114
406,ROKU  ,2023-02-14,2023-09-15,45.0,17,1020,1037
407,ROKU  ,2023-02-14,2023-09-15,50.0,23,609,632
408,ROKU  ,2023-02-14,2023-09-15,55.0,243,193,436
409,ROKU  ,2023-02-14,2023-09-15,60.0,3896,168,4064
410,ROKU  ,2023-02-14,2023-09-15,65.0,863,249,1112
411,ROKU  ,2023-02-14,2023-09-15,70.0,133,71,204
412,ROKU  ,2023-02-14,2023-09-15,75.0,225,61,286
413,ROKU  ,2023-02-14,2023-09-15,80.0,396,7,403
414,ROKU  ,2023-02-14,2023-09-15,85.0,71,28,99
415,ROKU  ,2023-02-14,2023-09-15,90.0,443,11,454
416,ROKU  ,2023-02-14,2023-09-15,95.0,29,3,32
417,ROKU  ,2023-02-14,2023-09-15,100.0,127,77,204
418,ROKU  ,2023-02-14,2024-01-19,20.0,19,85,104
419,ROKU  ,2023-02-14,2024-01-19,22.5,8,97,105
420,ROKU  ,2023-02-14,2024-01-19,25.0,27,941,968
421,ROKU  ,2023-02-14,2024-01-19,30.0,110,2008,2118
422,ROKU  ,2023-02-14,2024-01-19,35.0,119,1141,1260
423,ROKU  ,2023-02-14,2024-01-19,40.0,832,1633,2465
424,ROKU  ,2023-02-14,2024-01-19,45.0,387,2215,2602
425,ROKU  ,2023-02-14,2024-01-19,50.0,323,602,925
426,ROKU  ,2023-02-14,2024-01-19,55.0,211,238,449
427,ROKU  ,2023-02-14,2024-01-19,60.0,650,2144,2794
428,ROKU  ,2023-02-14,2024-01-19,65.0,577,946,1523
429,ROKU  ,2023-02-14,2024-01-19,70.0,619,277,896
430,ROKU  ,2023-02-14,2024-01-19,75.0,294,557,851
431,ROKU  ,2023-02-14,2024-01-19,80.0,390,1005,1395
432,ROKU  ,2023-02-14,2024-01-19,85.0,513,684,1197
433,ROKU  ,2023-02-14,2024-01-19,90.0,2055,801,2856
434,ROKU  ,2023-02-14,2024-01-19,95.0,792,341,1133
435,ROKU  ,2023-02-14,2024-01-19,100.0,1224,347,1571
436,ROKU  ,2023-02-14,2024-01-19,105.0,261,366,627
437,ROKU  ,2023-02-14,2024-01-19,110.0,622,108,730
438,ROKU  ,2023-02-14,2024-01-19,115.0,762,371,1133
439,ROKU  ,2023-02-14,2024-01-19,120.0,2138,15,2153
440,ROKU  ,2023-02-14,2024-01-19,125.0,295,19,314
441,ROKU  ,2023-02-14,2024-01-19,130.0,592,73,665
442,ROKU  ,2023-02-14,2024-01-19,135.0,223,6,229
443,ROKU  ,2023-02-14,2024-01-19,140.0,385,1,386
444,ROKU  ,2023-02-14,2024-01-19,145.0,321,0,321
445,ROKU  ,2023-02-14,2024-01-19,150.0,1645,14,1659
446,ROKU  ,2023-02-14,2024-01-19,155.0,395,2,397
447,ROKU  ,2023-02-14,2024-01-19,160.0,265,4,269
448,ROKU  ,2023-02-14,2024-01-19,165.0,124,0,124
449,ROKU  ,2023-02-14,2024-01-19,170.0,392,0,392
450,ROKU  ,2023-02-14,2024-01-19,175.0,372,0,372
451,ROKU  ,2023-02-14,2024-01-19,180.0,500,1,501
452,ROKU  ,2023-02-14,2024-01-19,185.0,198,8,206
453,ROKU  ,2023-02-14,2024-01-19,190.0,1427,5,1432
454,ROKU  ,2023-02-14,2024-01-19,195.0,188,2,190
455,ROKU  ,2023-02-14,2024-01-19,200.0,1657,0,1657
456,ROKU  ,2023-02-14,2024-01-19,205.0,135,0,135
457,ROKU  ,2023-02-14,2024-01-19,210.0,511,0,511
458,ROKU  ,2023-02-14,2024-01-19,220.0,846,0,846
459,ROKU  ,2023-02-14,2024-01-19,230.0,231,0,231
460,ROKU  ,2023-02-14,2024-01-19,240.0,156,0,156
461,ROKU  ,2023-02-14,2024-01-19,250.0,684,0,684
462,ROKU  ,2023-02-14,2024-01-19,260.0,190,0,190
463,ROKU  ,2023-02-14,2024-01-19,270.0,123,0,123
464,ROKU  ,2023-02-14,2024-01-19,280.0,159,0,159
465,ROKU  ,2023-02-14,2024-01-19,290.0,320,0,320
466,ROKU  ,2023-02-14,2024-01-19,300.0,2236,0,2236
467,ROKU  ,2023-02-14,2024-01-19,310.0,352,0,352
468,ROKU  ,2023-02-14,2024-01-19,320.0,335,0,335
469,ROKU  ,2023-02-14,2024-01-19,330.0,281,0,281
470,ROKU  ,2023-02-14,2024-01-19,340.0,180,0,180
471,ROKU  ,2023-02-14,2024-01-19,350.0,219,0,219
472,ROKU  ,2023-02-14,2024-01-19,360.0,538,0,538
473,ROKU  ,2023-02-14,2024-01-19,370.0,107,0,107
474,ROKU  ,2023-02-14,2024-01-19,380.0,143,0,143
475,ROKU  ,2023-02-14,2024-01-19,390.0,428,0,428
476,ROKU  ,2023-02-14,2024-01-19,400.0,1015,0,1015
477,ROKU  ,2023-02-14,2024-01-19,410.0,144,0,144
478,ROKU  ,2023-02-14,2024-01-19,420.0,283,0,283
479,ROKU  ,2023-02-14,2024-01-19,430.0,457,0,457
480,ROKU  ,2023-02-14,2024-01-19,440.0,143,0,143
481,ROKU  ,2023-02-14,2024-01-19,450.0,294,0,294
482,ROKU  ,2023-02-14,2024-01-19,460.0,31,0,31
483,ROKU  ,2023-02-14,2024-01-19,470.0,179,0,179
484,ROKU  ,2023-02-14,2024-01-19,480.0,45,0,45
485,ROKU  ,2023-02-14,2024-01-19,490.0,29,0,29
486,ROKU  ,2023-02-14,2024-01-19,500.0,367,2,369
487,ROKU  ,2023-02-14,2024-01-19,510.0,143,0,143
488,ROKU  ,2023-02-14,2024-01-19,520.0,2790,0,2790
489,ROKU  ,2023-02-14,2024-06-21,20.0,0,15,15
490,ROKU  ,2023-02-14,2024-06-21,22.5,1,4,5
491,ROKU  ,2023-02-14,2024-06-21,25.0,2,2,4
492,ROKU  ,2023-02-14,2024-06-21,30.0,2,38,40
493,ROKU  ,2023-02-14,2024-06-21,35.0,10,414,424
494,ROKU  ,2023-02-14,2024-06-21,40.0,25,45,70
495,ROKU  ,2023-02-14,2024-06-21,45.0,8,427,435
496,ROKU  ,2023-02-14,2024-06-21,50.0,28,97,125
497,ROKU  ,2023-02-14,2024-06-21,55.0,26,22,48
498,ROKU  ,2023-02-14,2024-06-21,60.0,30,54,84
499,ROKU  ,2023-02-14,2024-06-21,65.0,32,17,49
500,ROKU  ,2023-02-14,2024-06-21,70.0,35,3,38
501,ROKU  ,2023-02-14,2024-06-21,75.0,14,9,23
502,ROKU  ,2023-02-14,2024-06-21,80.0,33,85,118
503,ROKU  ,2023-02-14,2024-06-21,85.0,11,18,29
504,ROKU  ,2023-02-14,2024-06-21,90.0,42,37,79
505,ROKU  ,2023-02-14,2024-06-21,95.0,0,0,0
506,ROKU  ,2023-02-14,2024-06-21,100.0,6,0,6
507,ROKU  ,2023-02-14,2025-01-17,20.0,39,45,84
508,ROKU  ,2023-02-14,2025-01-17,22.5,11,44,55
509,ROKU  ,2023-02-14,2025-01-17,25.0,24,79,103
510,ROKU  ,2023-02-14,2025-01-17,30.0,50,135,185
511,ROKU  ,2023-02-14,2025-01-17,35.0,51,269,320
512,ROKU  ,2023-02-14,2025-01-17,40.0,158,248,406
513,ROKU  ,2023-02-14,2025-01-17,45.0,55,356,411
514,ROKU  ,2023-02-14,2025-01-17,50.0,144,565,709
515,ROKU  ,2023-02-14,2025-01-17,55.0,222,307,529
516,ROKU  ,2023-02-14,2025-01-17,60.0,1882,211,2093
517,ROKU  ,2023-02-14,2025-01-17,65.0,918,51,969
518,ROKU  ,2023-02-14,2025-01-17,70.0,164,33,197
519,ROKU  ,2023-02-14,2025-01-17,75.0,176,1040,1216
520,ROKU  ,2023-02-14,2025-01-17,80.0,113,45,158
521,ROKU  ,2023-02-14,2025-01-17,85.0,47,131,178
522,ROKU  ,2023-02-14,2025-01-17,90.0,61,23,84
523,ROKU  ,2023-02-14,2025-01-17,95.0,72,3,75
524,ROKU  ,2023-02-14,2025-01-17,100.0,232,41,273
525,ROKU  ,2023-02-14,2025-01-17,105.0,476,14,490
526,ROKU  ,2023-02-14,2025-01-17,110.0,933,89,1022
