index,ProductSymbol,DateGen,ExpDate,Strike,Call,Put,TotalOI
0,TSLA  ,2023-02-23,2023-02-24,15.0,24,22,46
1,TSLA  ,2023-02-23,2023-02-24,20.0,19,2,21
2,TSLA  ,2023-02-23,2023-02-24,25.0,19,3,22
3,TSLA  ,2023-02-23,2023-02-24,30.0,8,748,756
4,TSLA  ,2023-02-23,2023-02-24,35.0,6,25,31
5,TSLA  ,2023-02-23,2023-02-24,40.0,0,439,439
6,TSLA  ,2023-02-23,2023-02-24,45.0,0,2046,2046
7,TSLA  ,2023-02-23,2023-02-24,50.0,103,1898,2001
8,TSLA  ,2023-02-23,2023-02-24,55.0,3,806,809
9,TSLA  ,2023-02-23,2023-02-24,60.0,11,1451,1462
10,TSLA  ,2023-02-23,2023-02-24,65.0,6,699,705
11,TSLA  ,2023-02-23,2023-02-24,70.0,6,599,605
12,TSLA  ,2023-02-23,2023-02-24,75.0,1,852,853
13,TSLA  ,2023-02-23,2023-02-24,80.0,6,1122,1128
14,TSLA  ,2023-02-23,2023-02-24,85.0,6,638,644
15,TSLA  ,2023-02-23,2023-02-24,90.0,84,1506,1590
16,TSLA  ,2023-02-23,2023-02-24,95.0,18,1936,1954
17,TSLA  ,2023-02-23,2023-02-24,98.0,14,975,989
18,TSLA  ,2023-02-23,2023-02-24,99.0,17,636,653
19,TSLA  ,2023-02-23,2023-02-24,100.0,82,2490,2572
20,TSLA  ,2023-02-23,2023-02-24,101.0,19,475,494
21,TSLA  ,2023-02-23,2023-02-24,102.0,12,244,256
22,TSLA  ,2023-02-23,2023-02-24,103.0,8,314,322
23,TSLA  ,2023-02-23,2023-02-24,104.0,15,423,438
24,TSLA  ,2023-02-23,2023-02-24,105.0,110,2222,2332
25,TSLA  ,2023-02-23,2023-02-24,106.0,12,682,694
26,TSLA  ,2023-02-23,2023-02-24,107.0,18,1529,1547
27,TSLA  ,2023-02-23,2023-02-24,108.0,56,718,774
28,TSLA  ,2023-02-23,2023-02-24,109.0,49,1058,1107
29,TSLA  ,2023-02-23,2023-02-24,110.0,366,1881,2247
30,TSLA  ,2023-02-23,2023-02-24,111.0,78,497,575
31,TSLA  ,2023-02-23,2023-02-24,112.0,57,599,656
32,TSLA  ,2023-02-23,2023-02-24,113.0,47,1553,1600
33,TSLA  ,2023-02-23,2023-02-24,114.0,351,1057,1408
34,TSLA  ,2023-02-23,2023-02-24,115.0,384,2127,2511
35,TSLA  ,2023-02-23,2023-02-24,116.0,293,2439,2732
36,TSLA  ,2023-02-23,2023-02-24,117.0,263,1247,1510
37,TSLA  ,2023-02-23,2023-02-24,118.0,219,1288,1507
38,TSLA  ,2023-02-23,2023-02-24,119.0,216,792,1008
39,TSLA  ,2023-02-23,2023-02-24,120.0,460,2977,3437
40,TSLA  ,2023-02-23,2023-02-24,121.0,318,819,1137
41,TSLA  ,2023-02-23,2023-02-24,122.0,291,2746,3037
42,TSLA  ,2023-02-23,2023-02-24,123.0,389,561,950
43,TSLA  ,2023-02-23,2023-02-24,124.0,161,897,1058
44,TSLA  ,2023-02-23,2023-02-24,125.0,584,5056,5640
45,TSLA  ,2023-02-23,2023-02-24,126.0,202,712,914
46,TSLA  ,2023-02-23,2023-02-24,127.0,116,1266,1382
47,TSLA  ,2023-02-23,2023-02-24,128.0,174,1339,1513
48,TSLA  ,2023-02-23,2023-02-24,129.0,212,1494,1706
49,TSLA  ,2023-02-23,2023-02-24,130.0,2665,3462,6127
50,TSLA  ,2023-02-23,2023-02-24,131.0,422,1043,1465
51,TSLA  ,2023-02-23,2023-02-24,132.0,250,1525,1775
52,TSLA  ,2023-02-23,2023-02-24,133.0,145,740,885
53,TSLA  ,2023-02-23,2023-02-24,134.0,272,955,1227
54,TSLA  ,2023-02-23,2023-02-24,135.0,1877,3215,5092
55,TSLA  ,2023-02-23,2023-02-24,136.0,108,915,1023
56,TSLA  ,2023-02-23,2023-02-24,137.0,140,2000,2140
57,TSLA  ,2023-02-23,2023-02-24,138.0,257,1104,1361
58,TSLA  ,2023-02-23,2023-02-24,139.0,535,797,1332
59,TSLA  ,2023-02-23,2023-02-24,140.0,1536,7572,9108
60,TSLA  ,2023-02-23,2023-02-24,141.0,326,1862,2188
61,TSLA  ,2023-02-23,2023-02-24,142.0,476,1473,1949
62,TSLA  ,2023-02-23,2023-02-24,143.0,68,867,935
63,TSLA  ,2023-02-23,2023-02-24,144.0,69,4092,4161
64,TSLA  ,2023-02-23,2023-02-24,145.0,1989,6986,8975
65,TSLA  ,2023-02-23,2023-02-24,146.0,88,2801,2889
66,TSLA  ,2023-02-23,2023-02-24,147.0,98,1175,1273
67,TSLA  ,2023-02-23,2023-02-24,148.0,171,3716,3887
68,TSLA  ,2023-02-23,2023-02-24,149.0,119,3709,3828
69,TSLA  ,2023-02-23,2023-02-24,150.0,3113,12369,15482
70,TSLA  ,2023-02-23,2023-02-24,152.5,65,3165,3230
71,TSLA  ,2023-02-23,2023-02-24,155.0,2744,11837,14581
72,TSLA  ,2023-02-23,2023-02-24,157.5,1162,8349,9511
73,TSLA  ,2023-02-23,2023-02-24,160.0,3924,10623,14547
74,TSLA  ,2023-02-23,2023-02-24,162.5,462,4143,4605
75,TSLA  ,2023-02-23,2023-02-24,165.0,2628,10022,12650
76,TSLA  ,2023-02-23,2023-02-24,167.5,1037,6083,7120
77,TSLA  ,2023-02-23,2023-02-24,170.0,9173,14753,23926
78,TSLA  ,2023-02-23,2023-02-24,172.5,778,3885,4663
79,TSLA  ,2023-02-23,2023-02-24,175.0,4084,12832,16916
80,TSLA  ,2023-02-23,2023-02-24,177.5,404,8617,9021
81,TSLA  ,2023-02-23,2023-02-24,180.0,5208,22848,28056
82,TSLA  ,2023-02-23,2023-02-24,182.5,687,12507,13194
83,TSLA  ,2023-02-23,2023-02-24,185.0,2229,18470,20699
84,TSLA  ,2023-02-23,2023-02-24,187.5,1267,10274,11541
85,TSLA  ,2023-02-23,2023-02-24,190.0,13994,36876,50870
86,TSLA  ,2023-02-23,2023-02-24,192.5,2780,9873,12653
87,TSLA  ,2023-02-23,2023-02-24,195.0,7269,19111,26380
88,TSLA  ,2023-02-23,2023-02-24,197.5,4414,9771,14185
89,TSLA  ,2023-02-23,2023-02-24,200.0,30298,16113,46411
90,TSLA  ,2023-02-23,2023-02-24,202.5,18272,6027,24299
91,TSLA  ,2023-02-23,2023-02-24,205.0,18358,8624,26982
92,TSLA  ,2023-02-23,2023-02-24,207.5,13190,5115,18305
93,TSLA  ,2023-02-23,2023-02-24,210.0,40447,8306,48753
94,TSLA  ,2023-02-23,2023-02-24,212.5,10011,3848,13859
95,TSLA  ,2023-02-23,2023-02-24,215.0,27687,6878,34565
96,TSLA  ,2023-02-23,2023-02-24,217.5,6355,2049,8404
97,TSLA  ,2023-02-23,2023-02-24,220.0,36657,3620,40277
98,TSLA  ,2023-02-23,2023-02-24,222.5,8429,1274,9703
99,TSLA  ,2023-02-23,2023-02-24,225.0,32403,1482,33885
100,TSLA  ,2023-02-23,2023-02-24,227.5,8621,812,9433
101,TSLA  ,2023-02-23,2023-02-24,230.0,22097,2218,24315
102,TSLA  ,2023-02-23,2023-02-24,232.5,5287,635,5922
103,TSLA  ,2023-02-23,2023-02-24,235.0,7008,863,7871
104,TSLA  ,2023-02-23,2023-02-24,237.5,3529,699,4228
105,TSLA  ,2023-02-23,2023-02-24,240.0,17297,1271,18568
106,TSLA  ,2023-02-23,2023-02-24,242.5,3071,130,3201
107,TSLA  ,2023-02-23,2023-02-24,245.0,6173,69,6242
108,TSLA  ,2023-02-23,2023-02-24,247.5,3841,138,3979
109,TSLA  ,2023-02-23,2023-02-24,250.0,12399,429,12828
110,TSLA  ,2023-02-23,2023-02-24,252.5,2111,27,2138
111,TSLA  ,2023-02-23,2023-02-24,255.0,6944,42,6986
112,TSLA  ,2023-02-23,2023-02-24,257.5,5077,58,5135
113,TSLA  ,2023-02-23,2023-02-24,260.0,12491,0,12491
114,TSLA  ,2023-02-23,2023-02-24,262.5,2078,0,2078
115,TSLA  ,2023-02-23,2023-02-24,265.0,5598,1,5599
116,TSLA  ,2023-02-23,2023-02-24,267.5,3599,0,3599
117,TSLA  ,2023-02-23,2023-02-24,270.0,8261,0,8261
118,TSLA  ,2023-02-23,2023-02-24,272.5,777,5,782
119,TSLA  ,2023-02-23,2023-02-24,275.0,9805,0,9805
120,TSLA  ,2023-02-23,2023-02-24,277.5,708,0,708
121,TSLA  ,2023-02-23,2023-02-24,280.0,4798,0,4798
122,TSLA  ,2023-02-23,2023-02-24,282.5,302,0,302
123,TSLA  ,2023-02-23,2023-02-24,285.0,6662,0,6662
124,TSLA  ,2023-02-23,2023-02-24,290.0,3134,0,3134
125,TSLA  ,2023-02-23,2023-02-24,295.0,6303,0,6303
126,TSLA  ,2023-02-23,2023-02-24,300.0,5066,0,5066
127,TSLA  ,2023-02-23,2023-02-24,310.0,2663,0,2663
128,TSLA  ,2023-02-23,2023-02-24,320.0,1673,0,1673
129,TSLA  ,2023-02-23,2023-02-24,330.0,1459,1,1460
130,TSLA  ,2023-02-23,2023-02-24,340.0,1516,0,1516
131,TSLA  ,2023-02-23,2023-02-24,350.0,3035,0,3035
132,TSLA  ,2023-02-23,2023-02-24,360.0,10118,0,10118
133,TSLA  ,2023-02-23,2023-03-03,15.0,11,367,378
134,TSLA  ,2023-02-23,2023-03-03,20.0,1,0,1
135,TSLA  ,2023-02-23,2023-03-03,25.0,4,52,56
136,TSLA  ,2023-02-23,2023-03-03,30.0,5,340,345
137,TSLA  ,2023-02-23,2023-03-03,35.0,3,1,4
138,TSLA  ,2023-02-23,2023-03-03,40.0,0,10,10
139,TSLA  ,2023-02-23,2023-03-03,45.0,0,2457,2457
140,TSLA  ,2023-02-23,2023-03-03,50.0,7,895,902
141,TSLA  ,2023-02-23,2023-03-03,55.0,0,165,165
142,TSLA  ,2023-02-23,2023-03-03,60.0,2,1116,1118
143,TSLA  ,2023-02-23,2023-03-03,65.0,2,102,104
144,TSLA  ,2023-02-23,2023-03-03,70.0,2,996,998
145,TSLA  ,2023-02-23,2023-03-03,75.0,1,316,317
146,TSLA  ,2023-02-23,2023-03-03,80.0,112,2291,2403
147,TSLA  ,2023-02-23,2023-03-03,85.0,4,584,588
148,TSLA  ,2023-02-23,2023-03-03,90.0,7,1447,1454
149,TSLA  ,2023-02-23,2023-03-03,95.0,56,2051,2107
150,TSLA  ,2023-02-23,2023-03-03,100.0,111,2163,2274
151,TSLA  ,2023-02-23,2023-03-03,105.0,19,1128,1147
152,TSLA  ,2023-02-23,2023-03-03,108.0,54,971,1025
153,TSLA  ,2023-02-23,2023-03-03,109.0,34,725,759
154,TSLA  ,2023-02-23,2023-03-03,110.0,83,4083,4166
155,TSLA  ,2023-02-23,2023-03-03,111.0,37,611,648
156,TSLA  ,2023-02-23,2023-03-03,112.0,59,647,706
157,TSLA  ,2023-02-23,2023-03-03,113.0,35,849,884
158,TSLA  ,2023-02-23,2023-03-03,114.0,154,719,873
159,TSLA  ,2023-02-23,2023-03-03,115.0,213,1041,1254
160,TSLA  ,2023-02-23,2023-03-03,116.0,189,606,795
161,TSLA  ,2023-02-23,2023-03-03,117.0,483,818,1301
162,TSLA  ,2023-02-23,2023-03-03,118.0,316,853,1169
163,TSLA  ,2023-02-23,2023-03-03,119.0,340,705,1045
164,TSLA  ,2023-02-23,2023-03-03,120.0,942,3036,3978
165,TSLA  ,2023-02-23,2023-03-03,121.0,111,777,888
166,TSLA  ,2023-02-23,2023-03-03,122.0,127,1262,1389
167,TSLA  ,2023-02-23,2023-03-03,123.0,254,1758,2012
168,TSLA  ,2023-02-23,2023-03-03,124.0,465,1702,2167
169,TSLA  ,2023-02-23,2023-03-03,125.0,470,3445,3915
170,TSLA  ,2023-02-23,2023-03-03,126.0,663,634,1297
171,TSLA  ,2023-02-23,2023-03-03,127.0,451,379,830
172,TSLA  ,2023-02-23,2023-03-03,128.0,463,875,1338
173,TSLA  ,2023-02-23,2023-03-03,129.0,647,1626,2273
174,TSLA  ,2023-02-23,2023-03-03,130.0,709,4409,5118
175,TSLA  ,2023-02-23,2023-03-03,131.0,329,842,1171
176,TSLA  ,2023-02-23,2023-03-03,132.0,792,785,1577
177,TSLA  ,2023-02-23,2023-03-03,133.0,628,1320,1948
178,TSLA  ,2023-02-23,2023-03-03,134.0,611,1282,1893
179,TSLA  ,2023-02-23,2023-03-03,135.0,889,2544,3433
180,TSLA  ,2023-02-23,2023-03-03,136.0,133,155,288
181,TSLA  ,2023-02-23,2023-03-03,137.0,124,657,781
182,TSLA  ,2023-02-23,2023-03-03,138.0,74,2812,2886
183,TSLA  ,2023-02-23,2023-03-03,139.0,138,437,575
184,TSLA  ,2023-02-23,2023-03-03,140.0,697,3735,4432
185,TSLA  ,2023-02-23,2023-03-03,141.0,89,769,858
186,TSLA  ,2023-02-23,2023-03-03,142.0,318,418,736
187,TSLA  ,2023-02-23,2023-03-03,143.0,76,220,296
188,TSLA  ,2023-02-23,2023-03-03,144.0,44,3247,3291
189,TSLA  ,2023-02-23,2023-03-03,145.0,696,3131,3827
190,TSLA  ,2023-02-23,2023-03-03,146.0,76,1606,1682
191,TSLA  ,2023-02-23,2023-03-03,147.0,45,373,418
192,TSLA  ,2023-02-23,2023-03-03,148.0,54,649,703
193,TSLA  ,2023-02-23,2023-03-03,149.0,314,1989,2303
194,TSLA  ,2023-02-23,2023-03-03,150.0,1122,13033,14155
195,TSLA  ,2023-02-23,2023-03-03,152.5,183,2277,2460
196,TSLA  ,2023-02-23,2023-03-03,155.0,1833,2210,4043
197,TSLA  ,2023-02-23,2023-03-03,157.5,201,2124,2325
198,TSLA  ,2023-02-23,2023-03-03,160.0,1462,11607,13069
199,TSLA  ,2023-02-23,2023-03-03,162.5,455,2944,3399
200,TSLA  ,2023-02-23,2023-03-03,165.0,1847,4749,6596
201,TSLA  ,2023-02-23,2023-03-03,167.5,335,2302,2637
202,TSLA  ,2023-02-23,2023-03-03,170.0,2880,7165,10045
203,TSLA  ,2023-02-23,2023-03-03,172.5,1412,1913,3325
204,TSLA  ,2023-02-23,2023-03-03,175.0,1405,5510,6915
205,TSLA  ,2023-02-23,2023-03-03,177.5,835,1015,1850
206,TSLA  ,2023-02-23,2023-03-03,180.0,3215,6909,10124
207,TSLA  ,2023-02-23,2023-03-03,182.5,489,1734,2223
208,TSLA  ,2023-02-23,2023-03-03,185.0,2421,5435,7856
209,TSLA  ,2023-02-23,2023-03-03,187.5,1781,1402,3183
210,TSLA  ,2023-02-23,2023-03-03,190.0,3982,8269,12251
211,TSLA  ,2023-02-23,2023-03-03,192.5,1485,1861,3346
212,TSLA  ,2023-02-23,2023-03-03,195.0,4360,5256,9616
213,TSLA  ,2023-02-23,2023-03-03,197.5,3238,2468,5706
214,TSLA  ,2023-02-23,2023-03-03,200.0,26180,8052,34232
215,TSLA  ,2023-02-23,2023-03-03,202.5,6306,3024,9330
216,TSLA  ,2023-02-23,2023-03-03,205.0,7757,2828,10585
217,TSLA  ,2023-02-23,2023-03-03,207.5,3266,2186,5452
218,TSLA  ,2023-02-23,2023-03-03,210.0,17355,5786,23141
219,TSLA  ,2023-02-23,2023-03-03,212.5,2818,1342,4160
220,TSLA  ,2023-02-23,2023-03-03,215.0,7697,1704,9401
221,TSLA  ,2023-02-23,2023-03-03,217.5,2756,1368,4124
222,TSLA  ,2023-02-23,2023-03-03,220.0,27385,1621,29006
223,TSLA  ,2023-02-23,2023-03-03,222.5,1932,603,2535
224,TSLA  ,2023-02-23,2023-03-03,225.0,7869,461,8330
225,TSLA  ,2023-02-23,2023-03-03,227.5,1566,352,1918
226,TSLA  ,2023-02-23,2023-03-03,230.0,11537,728,12265
227,TSLA  ,2023-02-23,2023-03-03,232.5,1318,389,1707
228,TSLA  ,2023-02-23,2023-03-03,235.0,3853,839,4692
229,TSLA  ,2023-02-23,2023-03-03,237.5,882,518,1400
230,TSLA  ,2023-02-23,2023-03-03,240.0,7127,1538,8665
231,TSLA  ,2023-02-23,2023-03-03,242.5,621,307,928
232,TSLA  ,2023-02-23,2023-03-03,245.0,4723,477,5200
233,TSLA  ,2023-02-23,2023-03-03,247.5,689,316,1005
234,TSLA  ,2023-02-23,2023-03-03,250.0,14168,422,14590
235,TSLA  ,2023-02-23,2023-03-03,252.5,548,330,878
236,TSLA  ,2023-02-23,2023-03-03,255.0,4311,157,4468
237,TSLA  ,2023-02-23,2023-03-03,257.5,535,372,907
238,TSLA  ,2023-02-23,2023-03-03,260.0,3737,452,4189
239,TSLA  ,2023-02-23,2023-03-03,262.5,354,378,732
240,TSLA  ,2023-02-23,2023-03-03,265.0,4453,428,4881
241,TSLA  ,2023-02-23,2023-03-03,267.5,335,319,654
242,TSLA  ,2023-02-23,2023-03-03,270.0,4665,525,5190
243,TSLA  ,2023-02-23,2023-03-03,275.0,4992,362,5354
244,TSLA  ,2023-02-23,2023-03-03,280.0,3475,63,3538
245,TSLA  ,2023-02-23,2023-03-03,285.0,3775,3,3778
246,TSLA  ,2023-02-23,2023-03-03,290.0,4592,0,4592
247,TSLA  ,2023-02-23,2023-03-03,295.0,4836,0,4836
248,TSLA  ,2023-02-23,2023-03-03,300.0,9711,4,9715
249,TSLA  ,2023-02-23,2023-03-03,305.0,1122,0,1122
250,TSLA  ,2023-02-23,2023-03-03,310.0,1674,0,1674
251,TSLA  ,2023-02-23,2023-03-03,315.0,2196,0,2196
252,TSLA  ,2023-02-23,2023-03-03,320.0,4968,5,4973
253,TSLA  ,2023-02-23,2023-03-03,325.0,3310,0,3310
254,TSLA  ,2023-02-23,2023-03-03,330.0,3443,0,3443
255,TSLA  ,2023-02-23,2023-03-03,335.0,1086,0,1086
256,TSLA  ,2023-02-23,2023-03-03,340.0,6989,0,6989
257,TSLA  ,2023-02-23,2023-03-03,345.0,241,0,241
258,TSLA  ,2023-02-23,2023-03-03,350.0,1174,1,1175
259,TSLA  ,2023-02-23,2023-03-03,360.0,3344,0,3344
260,TSLA  ,2023-02-23,2023-03-10,15.0,3,100,103
261,TSLA  ,2023-02-23,2023-03-10,20.0,3,25,28
262,TSLA  ,2023-02-23,2023-03-10,25.0,0,0,0
263,TSLA  ,2023-02-23,2023-03-10,30.0,3,2,5
264,TSLA  ,2023-02-23,2023-03-10,35.0,0,0,0
265,TSLA  ,2023-02-23,2023-03-10,40.0,0,10,10
266,TSLA  ,2023-02-23,2023-03-10,45.0,0,65,65
267,TSLA  ,2023-02-23,2023-03-10,50.0,5,930,935
268,TSLA  ,2023-02-23,2023-03-10,55.0,1,1219,1220
269,TSLA  ,2023-02-23,2023-03-10,60.0,0,56,56
270,TSLA  ,2023-02-23,2023-03-10,65.0,50,24,74
271,TSLA  ,2023-02-23,2023-03-10,70.0,0,129,129
272,TSLA  ,2023-02-23,2023-03-10,75.0,0,510,510
273,TSLA  ,2023-02-23,2023-03-10,80.0,0,471,471
274,TSLA  ,2023-02-23,2023-03-10,85.0,0,118,118
275,TSLA  ,2023-02-23,2023-03-10,90.0,1,314,315
276,TSLA  ,2023-02-23,2023-03-10,95.0,11,626,637
277,TSLA  ,2023-02-23,2023-03-10,100.0,23,856,879
278,TSLA  ,2023-02-23,2023-03-10,105.0,6,442,448
279,TSLA  ,2023-02-23,2023-03-10,110.0,27,940,967
280,TSLA  ,2023-02-23,2023-03-10,115.0,61,777,838
281,TSLA  ,2023-02-23,2023-03-10,120.0,51,1743,1794
282,TSLA  ,2023-02-23,2023-03-10,125.0,18,955,973
283,TSLA  ,2023-02-23,2023-03-10,130.0,96,718,814
284,TSLA  ,2023-02-23,2023-03-10,134.0,24,197,221
285,TSLA  ,2023-02-23,2023-03-10,135.0,40,700,740
286,TSLA  ,2023-02-23,2023-03-10,136.0,55,207,262
287,TSLA  ,2023-02-23,2023-03-10,137.0,8,91,99
288,TSLA  ,2023-02-23,2023-03-10,138.0,17,113,130
289,TSLA  ,2023-02-23,2023-03-10,139.0,3,136,139
290,TSLA  ,2023-02-23,2023-03-10,140.0,71,1292,1363
291,TSLA  ,2023-02-23,2023-03-10,141.0,146,456,602
292,TSLA  ,2023-02-23,2023-03-10,142.0,28,239,267
293,TSLA  ,2023-02-23,2023-03-10,143.0,19,325,344
294,TSLA  ,2023-02-23,2023-03-10,144.0,26,170,196
295,TSLA  ,2023-02-23,2023-03-10,145.0,103,531,634
296,TSLA  ,2023-02-23,2023-03-10,146.0,45,184,229
297,TSLA  ,2023-02-23,2023-03-10,147.0,106,203,309
298,TSLA  ,2023-02-23,2023-03-10,148.0,99,802,901
299,TSLA  ,2023-02-23,2023-03-10,149.0,22,297,319
300,TSLA  ,2023-02-23,2023-03-10,150.0,257,4481,4738
301,TSLA  ,2023-02-23,2023-03-10,152.5,153,511,664
302,TSLA  ,2023-02-23,2023-03-10,155.0,611,806,1417
303,TSLA  ,2023-02-23,2023-03-10,157.5,123,416,539
304,TSLA  ,2023-02-23,2023-03-10,160.0,265,1330,1595
305,TSLA  ,2023-02-23,2023-03-10,162.5,135,602,737
306,TSLA  ,2023-02-23,2023-03-10,165.0,304,1977,2281
307,TSLA  ,2023-02-23,2023-03-10,167.5,652,602,1254
308,TSLA  ,2023-02-23,2023-03-10,170.0,482,2405,2887
309,TSLA  ,2023-02-23,2023-03-10,172.5,234,618,852
310,TSLA  ,2023-02-23,2023-03-10,175.0,438,1406,1844
311,TSLA  ,2023-02-23,2023-03-10,177.5,1791,880,2671
312,TSLA  ,2023-02-23,2023-03-10,180.0,779,3057,3836
313,TSLA  ,2023-02-23,2023-03-10,182.5,256,533,789
314,TSLA  ,2023-02-23,2023-03-10,185.0,641,1290,1931
315,TSLA  ,2023-02-23,2023-03-10,187.5,1342,346,1688
316,TSLA  ,2023-02-23,2023-03-10,190.0,1683,2472,4155
317,TSLA  ,2023-02-23,2023-03-10,192.5,1029,618,1647
318,TSLA  ,2023-02-23,2023-03-10,195.0,1501,5773,7274
319,TSLA  ,2023-02-23,2023-03-10,197.5,875,1227,2102
320,TSLA  ,2023-02-23,2023-03-10,200.0,3274,1922,5196
321,TSLA  ,2023-02-23,2023-03-10,202.5,2112,1156,3268
322,TSLA  ,2023-02-23,2023-03-10,205.0,2305,1882,4187
323,TSLA  ,2023-02-23,2023-03-10,207.5,1076,723,1799
324,TSLA  ,2023-02-23,2023-03-10,210.0,3281,1038,4319
325,TSLA  ,2023-02-23,2023-03-10,212.5,1140,582,1722
326,TSLA  ,2023-02-23,2023-03-10,215.0,1917,2086,4003
327,TSLA  ,2023-02-23,2023-03-10,217.5,412,213,625
328,TSLA  ,2023-02-23,2023-03-10,220.0,3069,187,3256
329,TSLA  ,2023-02-23,2023-03-10,222.5,538,118,656
330,TSLA  ,2023-02-23,2023-03-10,225.0,1819,175,1994
331,TSLA  ,2023-02-23,2023-03-10,227.5,503,38,541
332,TSLA  ,2023-02-23,2023-03-10,230.0,2210,138,2348
333,TSLA  ,2023-02-23,2023-03-10,235.0,1036,42,1078
334,TSLA  ,2023-02-23,2023-03-10,240.0,1776,132,1908
335,TSLA  ,2023-02-23,2023-03-10,245.0,890,76,966
336,TSLA  ,2023-02-23,2023-03-10,250.0,3881,223,4104
337,TSLA  ,2023-02-23,2023-03-10,255.0,579,5,584
338,TSLA  ,2023-02-23,2023-03-10,260.0,1567,66,1633
339,TSLA  ,2023-02-23,2023-03-10,265.0,3859,8,3867
340,TSLA  ,2023-02-23,2023-03-10,270.0,853,5,858
341,TSLA  ,2023-02-23,2023-03-10,275.0,740,5,745
342,TSLA  ,2023-02-23,2023-03-10,280.0,2064,9,2073
343,TSLA  ,2023-02-23,2023-03-10,285.0,900,0,900
344,TSLA  ,2023-02-23,2023-03-10,290.0,668,0,668
345,TSLA  ,2023-02-23,2023-03-10,295.0,629,1,630
346,TSLA  ,2023-02-23,2023-03-10,300.0,3144,0,3144
347,TSLA  ,2023-02-23,2023-03-10,310.0,2749,5,2754
348,TSLA  ,2023-02-23,2023-03-10,320.0,2713,1,2714
349,TSLA  ,2023-02-23,2023-03-10,330.0,531,0,531
350,TSLA  ,2023-02-23,2023-03-10,340.0,504,0,504
351,TSLA  ,2023-02-23,2023-03-10,350.0,845,0,845
352,TSLA  ,2023-02-23,2023-03-10,360.0,1353,0,1353
353,TSLA  ,2023-02-23,2023-03-17,1.67,50,24731,24781
354,TSLA  ,2023-02-23,2023-03-17,3.33,29,6941,6970
355,TSLA  ,2023-02-23,2023-03-17,5.0,2,8008,8010
356,TSLA  ,2023-02-23,2023-03-17,6.67,57,4669,4726
357,TSLA  ,2023-02-23,2023-03-17,8.33,3,1379,1382
358,TSLA  ,2023-02-23,2023-03-17,10.0,838,4105,4943
359,TSLA  ,2023-02-23,2023-03-17,11.67,1692,5414,7106
360,TSLA  ,2023-02-23,2023-03-17,13.33,1657,2125,3782
361,TSLA  ,2023-02-23,2023-03-17,15.0,987,5169,6156
362,TSLA  ,2023-02-23,2023-03-17,16.67,863,15330,16193
363,TSLA  ,2023-02-23,2023-03-17,18.33,466,12017,12483
364,TSLA  ,2023-02-23,2023-03-17,33.33,454,33620,34074
365,TSLA  ,2023-02-23,2023-03-17,50.0,742,25153,25895
366,TSLA  ,2023-02-23,2023-03-17,55.0,34,10792,10826
367,TSLA  ,2023-02-23,2023-03-17,60.0,182,9793,9975
368,TSLA  ,2023-02-23,2023-03-17,65.0,24,3850,3874
369,TSLA  ,2023-02-23,2023-03-17,66.67,883,18885,19768
370,TSLA  ,2023-02-23,2023-03-17,70.0,49,8142,8191
371,TSLA  ,2023-02-23,2023-03-17,75.0,54,5448,5502
372,TSLA  ,2023-02-23,2023-03-17,80.0,208,11822,12030
373,TSLA  ,2023-02-23,2023-03-17,83.33,886,5180,6066
374,TSLA  ,2023-02-23,2023-03-17,85.0,89,3610,3699
375,TSLA  ,2023-02-23,2023-03-17,90.0,663,15572,16235
376,TSLA  ,2023-02-23,2023-03-17,95.0,337,3312,3649
377,TSLA  ,2023-02-23,2023-03-17,100.0,1827,39450,41277
378,TSLA  ,2023-02-23,2023-03-17,105.0,1399,4575,5974
379,TSLA  ,2023-02-23,2023-03-17,110.0,2708,14205,16913
380,TSLA  ,2023-02-23,2023-03-17,115.0,3393,9233,12626
381,TSLA  ,2023-02-23,2023-03-17,116.67,1366,10936,12302
382,TSLA  ,2023-02-23,2023-03-17,120.0,12421,26161,38582
383,TSLA  ,2023-02-23,2023-03-17,123.33,2746,6725,9471
384,TSLA  ,2023-02-23,2023-03-17,125.0,3561,12655,16216
385,TSLA  ,2023-02-23,2023-03-17,126.67,1686,5964,7650
386,TSLA  ,2023-02-23,2023-03-17,130.0,7372,11340,18712
387,TSLA  ,2023-02-23,2023-03-17,133.33,3430,9759,13189
388,TSLA  ,2023-02-23,2023-03-17,135.0,27613,34328,61941
389,TSLA  ,2023-02-23,2023-03-17,136.67,3042,3660,6702
390,TSLA  ,2023-02-23,2023-03-17,140.0,7011,25654,32665
391,TSLA  ,2023-02-23,2023-03-17,143.33,2428,4727,7155
392,TSLA  ,2023-02-23,2023-03-17,145.0,4107,8449,12556
393,TSLA  ,2023-02-23,2023-03-17,146.67,1861,4317,6178
394,TSLA  ,2023-02-23,2023-03-17,150.0,13135,29199,42334
395,TSLA  ,2023-02-23,2023-03-17,153.33,1673,2862,4535
396,TSLA  ,2023-02-23,2023-03-17,155.0,5271,6374,11645
397,TSLA  ,2023-02-23,2023-03-17,156.67,2248,3520,5768
398,TSLA  ,2023-02-23,2023-03-17,160.0,7816,26461,34277
399,TSLA  ,2023-02-23,2023-03-17,163.33,3070,5979,9049
400,TSLA  ,2023-02-23,2023-03-17,165.0,6984,7317,14301
401,TSLA  ,2023-02-23,2023-03-17,166.67,6281,11992,18273
402,TSLA  ,2023-02-23,2023-03-17,170.0,11737,23429,35166
403,TSLA  ,2023-02-23,2023-03-17,172.5,30,128,158
404,TSLA  ,2023-02-23,2023-03-17,173.33,3206,12407,15613
405,TSLA  ,2023-02-23,2023-03-17,175.0,4770,9800,14570
406,TSLA  ,2023-02-23,2023-03-17,176.67,5203,3584,8787
407,TSLA  ,2023-02-23,2023-03-17,177.5,21,221,242
408,TSLA  ,2023-02-23,2023-03-17,180.0,20269,26099,46368
409,TSLA  ,2023-02-23,2023-03-17,182.5,16,178,194
410,TSLA  ,2023-02-23,2023-03-17,183.33,3321,8122,11443
411,TSLA  ,2023-02-23,2023-03-17,185.0,3490,6128,9618
412,TSLA  ,2023-02-23,2023-03-17,186.67,2798,4649,7447
413,TSLA  ,2023-02-23,2023-03-17,187.5,136,486,622
414,TSLA  ,2023-02-23,2023-03-17,190.0,17235,24540,41775
415,TSLA  ,2023-02-23,2023-03-17,192.5,357,413,770
416,TSLA  ,2023-02-23,2023-03-17,193.33,2267,6511,8778
417,TSLA  ,2023-02-23,2023-03-17,195.0,14119,14848,28967
418,TSLA  ,2023-02-23,2023-03-17,196.67,2933,4658,7591
419,TSLA  ,2023-02-23,2023-03-17,197.5,274,790,1064
420,TSLA  ,2023-02-23,2023-03-17,198.33,3976,3752,7728
421,TSLA  ,2023-02-23,2023-03-17,200.0,44360,39722,84082
422,TSLA  ,2023-02-23,2023-03-17,201.67,5017,2840,7857
423,TSLA  ,2023-02-23,2023-03-17,202.5,817,351,1168
424,TSLA  ,2023-02-23,2023-03-17,203.33,3455,3326,6781
425,TSLA  ,2023-02-23,2023-03-17,205.0,4310,5120,9430
426,TSLA  ,2023-02-23,2023-03-17,206.67,2980,3123,6103
427,TSLA  ,2023-02-23,2023-03-17,207.5,311,335,646
428,TSLA  ,2023-02-23,2023-03-17,208.33,2664,1366,4030
429,TSLA  ,2023-02-23,2023-03-17,210.0,12625,6158,18783
430,TSLA  ,2023-02-23,2023-03-17,211.67,2289,854,3143
431,TSLA  ,2023-02-23,2023-03-17,212.5,238,95,333
432,TSLA  ,2023-02-23,2023-03-17,213.33,1981,1157,3138
433,TSLA  ,2023-02-23,2023-03-17,215.0,14397,6647,21044
434,TSLA  ,2023-02-23,2023-03-17,216.67,4764,2913,7677
435,TSLA  ,2023-02-23,2023-03-17,217.5,161,14,175
436,TSLA  ,2023-02-23,2023-03-17,218.33,1676,4908,6584
437,TSLA  ,2023-02-23,2023-03-17,220.0,18824,1974,20798
438,TSLA  ,2023-02-23,2023-03-17,221.67,1662,371,2033
439,TSLA  ,2023-02-23,2023-03-17,222.5,269,8,277
440,TSLA  ,2023-02-23,2023-03-17,223.33,1466,389,1855
441,TSLA  ,2023-02-23,2023-03-17,225.0,5462,1788,7250
442,TSLA  ,2023-02-23,2023-03-17,226.67,2636,226,2862
443,TSLA  ,2023-02-23,2023-03-17,227.5,171,14,185
444,TSLA  ,2023-02-23,2023-03-17,228.33,5144,89,5233
445,TSLA  ,2023-02-23,2023-03-17,230.0,10606,1869,12475
446,TSLA  ,2023-02-23,2023-03-17,231.67,1473,110,1583
447,TSLA  ,2023-02-23,2023-03-17,233.33,6918,435,7353
448,TSLA  ,2023-02-23,2023-03-17,235.0,9590,124,9714
449,TSLA  ,2023-02-23,2023-03-17,236.67,1337,88,1425
450,TSLA  ,2023-02-23,2023-03-17,238.33,1219,116,1335
451,TSLA  ,2023-02-23,2023-03-17,240.0,8837,592,9429
452,TSLA  ,2023-02-23,2023-03-17,241.67,1503,67,1570
453,TSLA  ,2023-02-23,2023-03-17,243.33,1419,416,1835
454,TSLA  ,2023-02-23,2023-03-17,245.0,2558,164,2722
455,TSLA  ,2023-02-23,2023-03-17,246.67,1535,32,1567
456,TSLA  ,2023-02-23,2023-03-17,248.33,1317,42,1359
457,TSLA  ,2023-02-23,2023-03-17,250.0,26357,2273,28630
458,TSLA  ,2023-02-23,2023-03-17,251.67,1530,65,1595
459,TSLA  ,2023-02-23,2023-03-17,253.33,870,80,950
460,TSLA  ,2023-02-23,2023-03-17,255.0,5098,104,5202
461,TSLA  ,2023-02-23,2023-03-17,256.67,748,21,769
462,TSLA  ,2023-02-23,2023-03-17,258.33,1002,30,1032
463,TSLA  ,2023-02-23,2023-03-17,260.0,10860,1479,12339
464,TSLA  ,2023-02-23,2023-03-17,261.67,1620,12,1632
465,TSLA  ,2023-02-23,2023-03-17,263.33,1135,67,1202
466,TSLA  ,2023-02-23,2023-03-17,265.0,2963,34,2997
467,TSLA  ,2023-02-23,2023-03-17,266.67,11071,391,11462
468,TSLA  ,2023-02-23,2023-03-17,270.0,6557,44,6601
469,TSLA  ,2023-02-23,2023-03-17,273.33,3913,84,3997
470,TSLA  ,2023-02-23,2023-03-17,275.0,1692,15,1707
471,TSLA  ,2023-02-23,2023-03-17,276.67,1577,46,1623
472,TSLA  ,2023-02-23,2023-03-17,280.0,4002,146,4148
473,TSLA  ,2023-02-23,2023-03-17,283.33,6763,53,6816
474,TSLA  ,2023-02-23,2023-03-17,285.0,1201,21,1222
475,TSLA  ,2023-02-23,2023-03-17,286.67,2030,48,2078
476,TSLA  ,2023-02-23,2023-03-17,290.0,4053,73,4126
477,TSLA  ,2023-02-23,2023-03-17,293.33,7368,359,7727
478,TSLA  ,2023-02-23,2023-03-17,295.0,2949,28,2977
479,TSLA  ,2023-02-23,2023-03-17,296.67,995,26,1021
480,TSLA  ,2023-02-23,2023-03-17,298.33,1039,55,1094
481,TSLA  ,2023-02-23,2023-03-17,300.0,73781,479,74260
482,TSLA  ,2023-02-23,2023-03-17,301.67,1621,40,1661
483,TSLA  ,2023-02-23,2023-03-17,303.33,1468,11,1479
484,TSLA  ,2023-02-23,2023-03-17,305.0,2675,45,2720
485,TSLA  ,2023-02-23,2023-03-17,306.67,2018,17,2035
486,TSLA  ,2023-02-23,2023-03-17,308.33,3531,20,3551
487,TSLA  ,2023-02-23,2023-03-17,310.0,4509,36,4545
488,TSLA  ,2023-02-23,2023-03-17,311.67,2111,14,2125
489,TSLA  ,2023-02-23,2023-03-17,313.33,2556,11,2567
490,TSLA  ,2023-02-23,2023-03-17,316.67,29624,3,29627
491,TSLA  ,2023-02-23,2023-03-17,320.0,15155,0,15155
492,TSLA  ,2023-02-23,2023-03-17,323.33,464,0,464
493,TSLA  ,2023-02-23,2023-03-17,326.67,738,0,738
494,TSLA  ,2023-02-23,2023-03-17,330.0,3404,1,3405
495,TSLA  ,2023-02-23,2023-03-17,333.33,20496,25,20521
496,TSLA  ,2023-02-23,2023-03-17,336.67,827,0,827
497,TSLA  ,2023-02-23,2023-03-17,340.0,5890,0,5890
498,TSLA  ,2023-02-23,2023-03-17,343.33,1928,0,1928
499,TSLA  ,2023-02-23,2023-03-17,346.67,626,0,626
500,TSLA  ,2023-02-23,2023-03-17,350.0,11387,3,11390
501,TSLA  ,2023-02-23,2023-03-17,353.33,1419,0,1419
502,TSLA  ,2023-02-23,2023-03-17,356.67,746,0,746
503,TSLA  ,2023-02-23,2023-03-17,360.0,18772,0,18772
504,TSLA  ,2023-02-23,2023-03-17,363.33,602,0,602
505,TSLA  ,2023-02-23,2023-03-17,366.67,7779,0,7779
506,TSLA  ,2023-02-23,2023-03-17,370.0,1427,0,1427
507,TSLA  ,2023-02-23,2023-03-17,373.33,689,0,689
508,TSLA  ,2023-02-23,2023-03-17,383.33,12766,0,12766
509,TSLA  ,2023-02-23,2023-03-17,400.0,36957,0,36957
510,TSLA  ,2023-02-23,2023-03-17,416.67,13209,0,13209
511,TSLA  ,2023-02-23,2023-03-17,433.33,19544,0,19544
512,TSLA  ,2023-02-23,2023-03-17,441.67,2040,0,2040
513,TSLA  ,2023-02-23,2023-03-17,450.0,5910,0,5910
514,TSLA  ,2023-02-23,2023-03-17,458.33,2595,0,2595
515,TSLA  ,2023-02-23,2023-03-17,466.67,2897,4,2901
516,TSLA  ,2023-02-23,2023-03-17,475.0,3846,0,3846
517,TSLA  ,2023-02-23,2023-03-17,483.33,1983,0,1983
518,TSLA  ,2023-02-23,2023-03-17,491.67,2508,0,2508
519,TSLA  ,2023-02-23,2023-03-17,500.0,14180,6,14186
520,TSLA  ,2023-02-23,2023-03-17,508.33,3939,0,3939
521,TSLA  ,2023-02-23,2023-03-17,516.67,1215,0,1215
522,TSLA  ,2023-02-23,2023-03-17,525.0,4901,0,4901
523,TSLA  ,2023-02-23,2023-03-17,533.33,4745,0,4745
524,TSLA  ,2023-02-23,2023-03-17,541.67,1103,0,1103
525,TSLA  ,2023-02-23,2023-03-17,550.0,5090,0,5090
526,TSLA  ,2023-02-23,2023-03-17,558.33,3800,0,3800
527,TSLA  ,2023-02-23,2023-03-17,566.67,7724,0,7724
528,TSLA  ,2023-02-23,2023-03-17,575.0,11867,0,11867
529,TSLA  ,2023-02-23,2023-03-17,583.33,2663,0,2663
530,TSLA  ,2023-02-23,2023-03-17,591.67,1176,0,1176
531,TSLA  ,2023-02-23,2023-03-17,600.0,5758,0,5758
532,TSLA  ,2023-02-23,2023-03-17,608.33,581,0,581
533,TSLA  ,2023-02-23,2023-03-17,616.67,3998,0,3998
534,TSLA  ,2023-02-23,2023-03-17,625.0,1050,0,1050
535,TSLA  ,2023-02-23,2023-03-17,633.33,2372,0,2372
536,TSLA  ,2023-02-23,2023-03-17,641.67,1644,0,1644
537,TSLA  ,2023-02-23,2023-03-17,650.0,9133,0,9133
538,TSLA  ,2023-02-23,2023-03-17,666.67,70958,0,70958
539,TSLA  ,2023-02-23,2023-03-17,675.0,21633,0,21633
540,TSLA  ,2023-02-23,2023-03-17,683.33,4041,0,4041
541,TSLA  ,2023-02-23,2023-03-17,691.67,1388,0,1388
542,TSLA  ,2023-02-23,2023-03-17,700.0,4724,0,4724
543,TSLA  ,2023-02-23,2023-03-17,708.33,602,0,602
544,TSLA  ,2023-02-23,2023-03-17,716.67,783,0,783
545,TSLA  ,2023-02-23,2023-03-17,725.0,1042,0,1042
546,TSLA  ,2023-02-23,2023-03-17,733.33,1614,0,1614
547,TSLA  ,2023-02-23,2023-03-17,741.67,756,0,756
548,TSLA  ,2023-02-23,2023-03-17,750.0,754,0,754
549,TSLA  ,2023-02-23,2023-03-17,758.33,1235,0,1235
550,TSLA  ,2023-02-23,2023-03-17,766.67,1260,0,1260
551,TSLA  ,2023-02-23,2023-03-17,775.0,849,0,849
552,TSLA  ,2023-02-23,2023-03-17,783.33,1306,0,1306
553,TSLA  ,2023-02-23,2023-03-17,791.67,1448,0,1448
554,TSLA  ,2023-02-23,2023-03-17,800.0,5382,0,5382
555,TSLA  ,2023-02-23,2023-03-17,808.33,1842,0,1842
556,TSLA  ,2023-02-23,2023-03-17,816.67,2608,0,2608
557,TSLA  ,2023-02-23,2023-03-17,825.0,60257,0,60257
558,TSLA  ,2023-02-23,2023-03-24,20.0,6,122,128
559,TSLA  ,2023-02-23,2023-03-24,25.0,0,0,0
560,TSLA  ,2023-02-23,2023-03-24,30.0,0,11,11
561,TSLA  ,2023-02-23,2023-03-24,35.0,0,1,1
562,TSLA  ,2023-02-23,2023-03-24,40.0,0,0,0
563,TSLA  ,2023-02-23,2023-03-24,45.0,0,1,1
564,TSLA  ,2023-02-23,2023-03-24,50.0,21,1544,1565
565,TSLA  ,2023-02-23,2023-03-24,55.0,3,0,3
566,TSLA  ,2023-02-23,2023-03-24,60.0,0,29,29
567,TSLA  ,2023-02-23,2023-03-24,65.0,0,15,15
568,TSLA  ,2023-02-23,2023-03-24,70.0,0,27,27
569,TSLA  ,2023-02-23,2023-03-24,75.0,0,46,46
570,TSLA  ,2023-02-23,2023-03-24,80.0,0,83,83
571,TSLA  ,2023-02-23,2023-03-24,85.0,1,29,30
572,TSLA  ,2023-02-23,2023-03-24,90.0,4,41,45
573,TSLA  ,2023-02-23,2023-03-24,95.0,0,88,88
574,TSLA  ,2023-02-23,2023-03-24,100.0,12,397,409
575,TSLA  ,2023-02-23,2023-03-24,105.0,10,176,186
576,TSLA  ,2023-02-23,2023-03-24,110.0,6,147,153
577,TSLA  ,2023-02-23,2023-03-24,115.0,5,133,138
578,TSLA  ,2023-02-23,2023-03-24,120.0,2,805,807
579,TSLA  ,2023-02-23,2023-03-24,125.0,9,1212,1221
580,TSLA  ,2023-02-23,2023-03-24,130.0,175,400,575
581,TSLA  ,2023-02-23,2023-03-24,135.0,38,518,556
582,TSLA  ,2023-02-23,2023-03-24,140.0,31,1093,1124
583,TSLA  ,2023-02-23,2023-03-24,145.0,57,430,487
584,TSLA  ,2023-02-23,2023-03-24,146.0,11,55,66
585,TSLA  ,2023-02-23,2023-03-24,147.0,89,70,159
586,TSLA  ,2023-02-23,2023-03-24,148.0,78,98,176
587,TSLA  ,2023-02-23,2023-03-24,149.0,62,86,148
588,TSLA  ,2023-02-23,2023-03-24,150.0,80,1016,1096
589,TSLA  ,2023-02-23,2023-03-24,152.5,34,185,219
590,TSLA  ,2023-02-23,2023-03-24,155.0,488,760,1248
591,TSLA  ,2023-02-23,2023-03-24,157.5,82,449,531
592,TSLA  ,2023-02-23,2023-03-24,160.0,126,698,824
593,TSLA  ,2023-02-23,2023-03-24,162.5,45,195,240
594,TSLA  ,2023-02-23,2023-03-24,165.0,126,834,960
595,TSLA  ,2023-02-23,2023-03-24,167.5,38,529,567
596,TSLA  ,2023-02-23,2023-03-24,170.0,200,1212,1412
597,TSLA  ,2023-02-23,2023-03-24,172.5,65,322,387
598,TSLA  ,2023-02-23,2023-03-24,175.0,159,1542,1701
599,TSLA  ,2023-02-23,2023-03-24,177.5,181,476,657
600,TSLA  ,2023-02-23,2023-03-24,180.0,318,1102,1420
601,TSLA  ,2023-02-23,2023-03-24,182.5,124,167,291
602,TSLA  ,2023-02-23,2023-03-24,185.0,146,733,879
603,TSLA  ,2023-02-23,2023-03-24,187.5,140,174,314
604,TSLA  ,2023-02-23,2023-03-24,190.0,543,975,1518
605,TSLA  ,2023-02-23,2023-03-24,192.5,111,227,338
606,TSLA  ,2023-02-23,2023-03-24,195.0,618,645,1263
607,TSLA  ,2023-02-23,2023-03-24,197.5,1255,227,1482
608,TSLA  ,2023-02-23,2023-03-24,200.0,3193,2069,5262
609,TSLA  ,2023-02-23,2023-03-24,202.5,826,178,1004
610,TSLA  ,2023-02-23,2023-03-24,205.0,1496,258,1754
611,TSLA  ,2023-02-23,2023-03-24,207.5,437,158,595
612,TSLA  ,2023-02-23,2023-03-24,210.0,2786,434,3220
613,TSLA  ,2023-02-23,2023-03-24,212.5,588,936,1524
614,TSLA  ,2023-02-23,2023-03-24,215.0,1226,506,1732
615,TSLA  ,2023-02-23,2023-03-24,217.5,1192,61,1253
616,TSLA  ,2023-02-23,2023-03-24,220.0,2235,852,3087
617,TSLA  ,2023-02-23,2023-03-24,222.5,326,80,406
618,TSLA  ,2023-02-23,2023-03-24,225.0,676,116,792
619,TSLA  ,2023-02-23,2023-03-24,230.0,1030,238,1268
620,TSLA  ,2023-02-23,2023-03-24,235.0,594,114,708
621,TSLA  ,2023-02-23,2023-03-24,240.0,425,145,570
622,TSLA  ,2023-02-23,2023-03-24,245.0,650,19,669
623,TSLA  ,2023-02-23,2023-03-24,250.0,1909,53,1962
624,TSLA  ,2023-02-23,2023-03-24,255.0,350,21,371
625,TSLA  ,2023-02-23,2023-03-24,260.0,716,28,744
626,TSLA  ,2023-02-23,2023-03-24,265.0,452,1,453
627,TSLA  ,2023-02-23,2023-03-24,270.0,639,4,643
628,TSLA  ,2023-02-23,2023-03-24,275.0,332,3,335
629,TSLA  ,2023-02-23,2023-03-24,280.0,351,0,351
630,TSLA  ,2023-02-23,2023-03-24,285.0,367,0,367
631,TSLA  ,2023-02-23,2023-03-24,290.0,254,0,254
632,TSLA  ,2023-02-23,2023-03-24,295.0,96,0,96
633,TSLA  ,2023-02-23,2023-03-24,300.0,879,28,907
634,TSLA  ,2023-02-23,2023-03-24,310.0,286,0,286
635,TSLA  ,2023-02-23,2023-03-24,320.0,352,1,353
636,TSLA  ,2023-02-23,2023-03-24,330.0,159,1,160
637,TSLA  ,2023-02-23,2023-03-24,340.0,361,0,361
638,TSLA  ,2023-02-23,2023-03-24,350.0,479,0,479
639,TSLA  ,2023-02-23,2023-03-24,360.0,774,0,774
640,TSLA  ,2023-02-23,2023-03-31,25.0,3,0,3
641,TSLA  ,2023-02-23,2023-03-31,30.0,0,0,0
642,TSLA  ,2023-02-23,2023-03-31,35.0,0,1,1
643,TSLA  ,2023-02-23,2023-03-31,40.0,0,5,5
644,TSLA  ,2023-02-23,2023-03-31,45.0,0,2,2
645,TSLA  ,2023-02-23,2023-03-31,50.0,0,6,6
646,TSLA  ,2023-02-23,2023-03-31,55.0,0,0,0
647,TSLA  ,2023-02-23,2023-03-31,60.0,0,26,26
648,TSLA  ,2023-02-23,2023-03-31,65.0,0,9,9
649,TSLA  ,2023-02-23,2023-03-31,70.0,0,21,21
650,TSLA  ,2023-02-23,2023-03-31,75.0,0,14,14
651,TSLA  ,2023-02-23,2023-03-31,80.0,4,59,63
652,TSLA  ,2023-02-23,2023-03-31,85.0,38,13,51
653,TSLA  ,2023-02-23,2023-03-31,90.0,0,61,61
654,TSLA  ,2023-02-23,2023-03-31,95.0,0,198,198
655,TSLA  ,2023-02-23,2023-03-31,100.0,3,385,388
656,TSLA  ,2023-02-23,2023-03-31,105.0,2,190,192
657,TSLA  ,2023-02-23,2023-03-31,110.0,11,285,296
658,TSLA  ,2023-02-23,2023-03-31,115.0,7,355,362
659,TSLA  ,2023-02-23,2023-03-31,120.0,76,220,296
660,TSLA  ,2023-02-23,2023-03-31,125.0,99,224,323
661,TSLA  ,2023-02-23,2023-03-31,130.0,14,525,539
662,TSLA  ,2023-02-23,2023-03-31,135.0,14,452,466
663,TSLA  ,2023-02-23,2023-03-31,140.0,48,540,588
664,TSLA  ,2023-02-23,2023-03-31,145.0,56,454,510
665,TSLA  ,2023-02-23,2023-03-31,150.0,173,891,1064
666,TSLA  ,2023-02-23,2023-03-31,155.0,373,211,584
667,TSLA  ,2023-02-23,2023-03-31,160.0,100,503,603
668,TSLA  ,2023-02-23,2023-03-31,165.0,60,451,511
669,TSLA  ,2023-02-23,2023-03-31,170.0,50,1087,1137
670,TSLA  ,2023-02-23,2023-03-31,172.5,13,881,894
671,TSLA  ,2023-02-23,2023-03-31,175.0,50,591,641
672,TSLA  ,2023-02-23,2023-03-31,177.5,446,257,703
673,TSLA  ,2023-02-23,2023-03-31,180.0,431,830,1261
674,TSLA  ,2023-02-23,2023-03-31,182.5,17,185,202
675,TSLA  ,2023-02-23,2023-03-31,185.0,61,1311,1372
676,TSLA  ,2023-02-23,2023-03-31,187.5,81,127,208
677,TSLA  ,2023-02-23,2023-03-31,190.0,233,922,1155
678,TSLA  ,2023-02-23,2023-03-31,192.5,117,123,240
679,TSLA  ,2023-02-23,2023-03-31,195.0,288,5307,5595
680,TSLA  ,2023-02-23,2023-03-31,197.5,139,741,880
681,TSLA  ,2023-02-23,2023-03-31,200.0,726,1507,2233
682,TSLA  ,2023-02-23,2023-03-31,202.5,2264,418,2682
683,TSLA  ,2023-02-23,2023-03-31,205.0,708,939,1647
684,TSLA  ,2023-02-23,2023-03-31,207.5,387,206,593
685,TSLA  ,2023-02-23,2023-03-31,210.0,1522,459,1981
686,TSLA  ,2023-02-23,2023-03-31,212.5,392,106,498
687,TSLA  ,2023-02-23,2023-03-31,215.0,648,161,809
688,TSLA  ,2023-02-23,2023-03-31,217.5,273,67,340
689,TSLA  ,2023-02-23,2023-03-31,220.0,1244,169,1413
690,TSLA  ,2023-02-23,2023-03-31,222.5,118,14,132
691,TSLA  ,2023-02-23,2023-03-31,225.0,600,112,712
692,TSLA  ,2023-02-23,2023-03-31,230.0,1172,30,1202
693,TSLA  ,2023-02-23,2023-03-31,235.0,419,23,442
694,TSLA  ,2023-02-23,2023-03-31,240.0,994,2,996
695,TSLA  ,2023-02-23,2023-03-31,245.0,317,29,346
696,TSLA  ,2023-02-23,2023-03-31,250.0,1249,4,1253
697,TSLA  ,2023-02-23,2023-03-31,255.0,321,2,323
698,TSLA  ,2023-02-23,2023-03-31,260.0,418,13,431
699,TSLA  ,2023-02-23,2023-03-31,265.0,202,10,212
700,TSLA  ,2023-02-23,2023-03-31,270.0,440,13,453
701,TSLA  ,2023-02-23,2023-03-31,275.0,481,3,484
702,TSLA  ,2023-02-23,2023-03-31,280.0,593,2,595
703,TSLA  ,2023-02-23,2023-03-31,285.0,559,0,559
704,TSLA  ,2023-02-23,2023-03-31,290.0,331,0,331
705,TSLA  ,2023-02-23,2023-03-31,295.0,206,25,231
706,TSLA  ,2023-02-23,2023-03-31,300.0,844,25,869
707,TSLA  ,2023-02-23,2023-03-31,310.0,310,1,311
708,TSLA  ,2023-02-23,2023-03-31,320.0,282,4,286
709,TSLA  ,2023-02-23,2023-03-31,330.0,137,0,137
710,TSLA  ,2023-02-23,2023-03-31,340.0,162,0,162
711,TSLA  ,2023-02-23,2023-03-31,350.0,122,0,122
712,TSLA  ,2023-02-23,2023-03-31,360.0,473,0,473
713,TSLA  ,2023-02-23,2023-04-21,5.0,14,101,115
714,TSLA  ,2023-02-23,2023-04-21,10.0,0,8,8
715,TSLA  ,2023-02-23,2023-04-21,15.0,4,41,45
716,TSLA  ,2023-02-23,2023-04-21,20.0,4,346,350
717,TSLA  ,2023-02-23,2023-04-21,25.0,7,2494,2501
718,TSLA  ,2023-02-23,2023-04-21,30.0,0,5277,5277
719,TSLA  ,2023-02-23,2023-04-21,35.0,5,1049,1054
720,TSLA  ,2023-02-23,2023-04-21,40.0,7,630,637
721,TSLA  ,2023-02-23,2023-04-21,45.0,2,861,863
722,TSLA  ,2023-02-23,2023-04-21,50.0,133,5208,5341
723,TSLA  ,2023-02-23,2023-04-21,55.0,15,2781,2796
724,TSLA  ,2023-02-23,2023-04-21,60.0,18,2042,2060
725,TSLA  ,2023-02-23,2023-04-21,65.0,66,5214,5280
726,TSLA  ,2023-02-23,2023-04-21,70.0,63,4480,4543
727,TSLA  ,2023-02-23,2023-04-21,75.0,124,13319,13443
728,TSLA  ,2023-02-23,2023-04-21,80.0,25226,4548,29774
729,TSLA  ,2023-02-23,2023-04-21,85.0,91,3322,3413
730,TSLA  ,2023-02-23,2023-04-21,90.0,273,2282,2555
731,TSLA  ,2023-02-23,2023-04-21,95.0,150,6182,6332
732,TSLA  ,2023-02-23,2023-04-21,100.0,1565,28229,29794
733,TSLA  ,2023-02-23,2023-04-21,105.0,362,3022,3384
734,TSLA  ,2023-02-23,2023-04-21,108.33,898,4902,5800
735,TSLA  ,2023-02-23,2023-04-21,110.0,1075,7438,8513
736,TSLA  ,2023-02-23,2023-04-21,115.0,1423,3606,5029
737,TSLA  ,2023-02-23,2023-04-21,116.67,2538,9437,11975
738,TSLA  ,2023-02-23,2023-04-21,120.0,7252,14101,21353
739,TSLA  ,2023-02-23,2023-04-21,125.0,10829,13266,24095
740,TSLA  ,2023-02-23,2023-04-21,130.0,1795,7487,9282
741,TSLA  ,2023-02-23,2023-04-21,133.33,4582,3691,8273
742,TSLA  ,2023-02-23,2023-04-21,135.0,1469,2781,4250
743,TSLA  ,2023-02-23,2023-04-21,140.0,2968,7528,10496
744,TSLA  ,2023-02-23,2023-04-21,141.67,6291,3518,9809
745,TSLA  ,2023-02-23,2023-04-21,145.0,2011,3037,5048
746,TSLA  ,2023-02-23,2023-04-21,150.0,8357,19390,27747
747,TSLA  ,2023-02-23,2023-04-21,155.0,1415,2371,3786
748,TSLA  ,2023-02-23,2023-04-21,158.33,2993,4173,7166
749,TSLA  ,2023-02-23,2023-04-21,160.0,3496,6059,9555
750,TSLA  ,2023-02-23,2023-04-21,165.0,1677,2911,4588
751,TSLA  ,2023-02-23,2023-04-21,166.67,2650,5424,8074
752,TSLA  ,2023-02-23,2023-04-21,170.0,1986,4274,6260
753,TSLA  ,2023-02-23,2023-04-21,175.0,10796,8400,19196
754,TSLA  ,2023-02-23,2023-04-21,180.0,2986,5055,8041
755,TSLA  ,2023-02-23,2023-04-21,183.33,2726,4084,6810
756,TSLA  ,2023-02-23,2023-04-21,185.0,2418,3601,6019
757,TSLA  ,2023-02-23,2023-04-21,190.0,2682,8244,10926
758,TSLA  ,2023-02-23,2023-04-21,191.67,2999,18428,21427
759,TSLA  ,2023-02-23,2023-04-21,195.0,3531,2868,6399
760,TSLA  ,2023-02-23,2023-04-21,200.0,14900,10056,24956
761,TSLA  ,2023-02-23,2023-04-21,205.0,3504,2652,6156
762,TSLA  ,2023-02-23,2023-04-21,208.33,6073,2858,8931
763,TSLA  ,2023-02-23,2023-04-21,210.0,5964,3517,9481
764,TSLA  ,2023-02-23,2023-04-21,215.0,3348,1665,5013
765,TSLA  ,2023-02-23,2023-04-21,216.67,2130,3149,5279
766,TSLA  ,2023-02-23,2023-04-21,220.0,7661,1251,8912
767,TSLA  ,2023-02-23,2023-04-21,225.0,8853,2248,11101
768,TSLA  ,2023-02-23,2023-04-21,230.0,3035,686,3721
769,TSLA  ,2023-02-23,2023-04-21,233.33,1746,826,2572
770,TSLA  ,2023-02-23,2023-04-21,235.0,1485,372,1857
771,TSLA  ,2023-02-23,2023-04-21,240.0,8111,541,8652
772,TSLA  ,2023-02-23,2023-04-21,241.67,1084,103,1187
773,TSLA  ,2023-02-23,2023-04-21,243.33,1385,53,1438
774,TSLA  ,2023-02-23,2023-04-21,245.0,1665,178,1843
775,TSLA  ,2023-02-23,2023-04-21,246.67,1445,87,1532
776,TSLA  ,2023-02-23,2023-04-21,248.33,872,329,1201
777,TSLA  ,2023-02-23,2023-04-21,250.0,9737,883,10620
778,TSLA  ,2023-02-23,2023-04-21,251.67,2023,83,2106
779,TSLA  ,2023-02-23,2023-04-21,253.33,1381,45,1426
780,TSLA  ,2023-02-23,2023-04-21,255.0,1813,48,1861
781,TSLA  ,2023-02-23,2023-04-21,258.33,1175,896,2071
782,TSLA  ,2023-02-23,2023-04-21,260.0,2380,6,2386
783,TSLA  ,2023-02-23,2023-04-21,265.0,1308,6,1314
784,TSLA  ,2023-02-23,2023-04-21,266.67,1936,199,2135
785,TSLA  ,2023-02-23,2023-04-21,270.0,2570,2,2572
786,TSLA  ,2023-02-23,2023-04-21,275.0,2292,112,2404
787,TSLA  ,2023-02-23,2023-04-21,280.0,2175,207,2382
788,TSLA  ,2023-02-23,2023-04-21,283.33,1341,215,1556
789,TSLA  ,2023-02-23,2023-04-21,285.0,292,50,342
790,TSLA  ,2023-02-23,2023-04-21,290.0,510,0,510
791,TSLA  ,2023-02-23,2023-04-21,291.67,3099,30,3129
792,TSLA  ,2023-02-23,2023-04-21,295.0,132,1,133
793,TSLA  ,2023-02-23,2023-04-21,300.0,9626,43,9669
794,TSLA  ,2023-02-23,2023-04-21,305.0,276,0,276
795,TSLA  ,2023-02-23,2023-04-21,308.33,4070,26,4096
796,TSLA  ,2023-02-23,2023-04-21,310.0,1070,0,1070
797,TSLA  ,2023-02-23,2023-04-21,316.67,21952,4,21956
798,TSLA  ,2023-02-23,2023-04-21,320.0,158,0,158
799,TSLA  ,2023-02-23,2023-04-21,325.0,2771,11,2782
800,TSLA  ,2023-02-23,2023-04-21,330.0,71,30,101
801,TSLA  ,2023-02-23,2023-04-21,333.33,7713,0,7713
802,TSLA  ,2023-02-23,2023-04-21,340.0,17,0,17
803,TSLA  ,2023-02-23,2023-04-21,341.67,844,8,852
804,TSLA  ,2023-02-23,2023-04-21,350.0,3636,7,3643
805,TSLA  ,2023-02-23,2023-04-21,358.33,975,0,975
806,TSLA  ,2023-02-23,2023-04-21,360.0,45,0,45
807,TSLA  ,2023-02-23,2023-04-21,366.67,1196,3,1199
808,TSLA  ,2023-02-23,2023-04-21,370.0,44,0,44
809,TSLA  ,2023-02-23,2023-04-21,375.0,1637,8,1645
810,TSLA  ,2023-02-23,2023-04-21,383.33,721,0,721
811,TSLA  ,2023-02-23,2023-04-21,391.67,439,0,439
812,TSLA  ,2023-02-23,2023-04-21,400.0,3715,0,3715
813,TSLA  ,2023-02-23,2023-04-21,408.33,447,0,447
814,TSLA  ,2023-02-23,2023-04-21,416.67,1135,0,1135
815,TSLA  ,2023-02-23,2023-04-21,425.0,4962,0,4962
816,TSLA  ,2023-02-23,2023-04-21,433.33,17035,0,17035
817,TSLA  ,2023-02-23,2023-04-21,441.67,751,0,751
818,TSLA  ,2023-02-23,2023-04-21,450.0,1371,0,1371
819,TSLA  ,2023-02-23,2023-04-21,458.33,3253,0,3253
820,TSLA  ,2023-02-23,2023-04-21,466.67,409,0,409
821,TSLA  ,2023-02-23,2023-04-21,475.0,960,0,960
822,TSLA  ,2023-02-23,2023-04-21,483.33,826,0,826
823,TSLA  ,2023-02-23,2023-04-21,491.67,195,0,195
824,TSLA  ,2023-02-23,2023-04-21,500.0,3643,0,3643
825,TSLA  ,2023-02-23,2023-04-21,508.33,900,0,900
826,TSLA  ,2023-02-23,2023-04-21,516.67,508,0,508
827,TSLA  ,2023-02-23,2023-04-21,525.0,488,0,488
828,TSLA  ,2023-02-23,2023-04-21,533.33,535,0,535
829,TSLA  ,2023-02-23,2023-04-21,541.67,599,0,599
830,TSLA  ,2023-02-23,2023-04-21,550.0,11287,0,11287
831,TSLA  ,2023-02-23,2023-04-21,558.33,316,0,316
832,TSLA  ,2023-02-23,2023-04-21,566.67,631,0,631
833,TSLA  ,2023-02-23,2023-04-21,575.0,1711,0,1711
834,TSLA  ,2023-02-23,2023-04-21,583.33,1049,0,1049
835,TSLA  ,2023-02-23,2023-04-21,600.0,21998,0,21998
836,TSLA  ,2023-02-23,2023-05-19,50.0,62,3290,3352
837,TSLA  ,2023-02-23,2023-05-19,55.0,51,600,651
838,TSLA  ,2023-02-23,2023-05-19,60.0,159,951,1110
839,TSLA  ,2023-02-23,2023-05-19,65.0,64,453,517
840,TSLA  ,2023-02-23,2023-05-19,70.0,178,1454,1632
841,TSLA  ,2023-02-23,2023-05-19,75.0,135,1650,1785
842,TSLA  ,2023-02-23,2023-05-19,80.0,84,1615,1699
843,TSLA  ,2023-02-23,2023-05-19,85.0,62,1779,1841
844,TSLA  ,2023-02-23,2023-05-19,90.0,243,2856,3099
845,TSLA  ,2023-02-23,2023-05-19,95.0,134,1900,2034
846,TSLA  ,2023-02-23,2023-05-19,100.0,1101,19767,20868
847,TSLA  ,2023-02-23,2023-05-19,105.0,286,6188,6474
848,TSLA  ,2023-02-23,2023-05-19,110.0,980,7316,8296
849,TSLA  ,2023-02-23,2023-05-19,115.0,1338,1962,3300
850,TSLA  ,2023-02-23,2023-05-19,120.0,2194,8136,10330
851,TSLA  ,2023-02-23,2023-05-19,125.0,3744,2588,6332
852,TSLA  ,2023-02-23,2023-05-19,130.0,2704,5040,7744
853,TSLA  ,2023-02-23,2023-05-19,135.0,2090,2268,4358
854,TSLA  ,2023-02-23,2023-05-19,140.0,1888,11624,13512
855,TSLA  ,2023-02-23,2023-05-19,145.0,2510,2102,4612
856,TSLA  ,2023-02-23,2023-05-19,150.0,3977,4933,8910
857,TSLA  ,2023-02-23,2023-05-19,155.0,1382,1712,3094
858,TSLA  ,2023-02-23,2023-05-19,160.0,3190,4832,8022
859,TSLA  ,2023-02-23,2023-05-19,165.0,1379,1517,2896
860,TSLA  ,2023-02-23,2023-05-19,170.0,2809,4833,7642
861,TSLA  ,2023-02-23,2023-05-19,175.0,2172,1911,4083
862,TSLA  ,2023-02-23,2023-05-19,180.0,8034,4072,12106
863,TSLA  ,2023-02-23,2023-05-19,185.0,1813,1563,3376
864,TSLA  ,2023-02-23,2023-05-19,190.0,2642,3697,6339
865,TSLA  ,2023-02-23,2023-05-19,195.0,3257,2310,5567
866,TSLA  ,2023-02-23,2023-05-19,200.0,8984,3734,12718
867,TSLA  ,2023-02-23,2023-05-19,205.0,4210,5014,9224
868,TSLA  ,2023-02-23,2023-05-19,210.0,10784,3085,13869
869,TSLA  ,2023-02-23,2023-05-19,215.0,26058,2568,28626
870,TSLA  ,2023-02-23,2023-05-19,220.0,7578,1774,9352
871,TSLA  ,2023-02-23,2023-05-19,225.0,3302,923,4225
872,TSLA  ,2023-02-23,2023-05-19,230.0,2373,679,3052
873,TSLA  ,2023-02-23,2023-05-19,235.0,1789,296,2085
874,TSLA  ,2023-02-23,2023-05-19,240.0,2870,103,2973
875,TSLA  ,2023-02-23,2023-05-19,245.0,1167,149,1316
876,TSLA  ,2023-02-23,2023-05-19,250.0,3565,88,3653
877,TSLA  ,2023-02-23,2023-05-19,255.0,44,2,46
878,TSLA  ,2023-02-23,2023-05-19,260.0,1356,144,1500
879,TSLA  ,2023-02-23,2023-05-19,265.0,15,0,15
880,TSLA  ,2023-02-23,2023-05-19,270.0,3513,130,3643
881,TSLA  ,2023-02-23,2023-05-19,275.0,52,0,52
882,TSLA  ,2023-02-23,2023-05-19,280.0,878,23,901
883,TSLA  ,2023-02-23,2023-05-19,285.0,5,0,5
884,TSLA  ,2023-02-23,2023-05-19,290.0,438,367,805
885,TSLA  ,2023-02-23,2023-05-19,295.0,2,0,2
886,TSLA  ,2023-02-23,2023-05-19,300.0,1928,544,2472
887,TSLA  ,2023-02-23,2023-05-19,310.0,548,5249,5797
888,TSLA  ,2023-02-23,2023-05-19,320.0,1013,1168,2181
889,TSLA  ,2023-02-23,2023-05-19,330.0,604,26,630
890,TSLA  ,2023-02-23,2023-05-19,340.0,586,3,589
891,TSLA  ,2023-02-23,2023-05-19,350.0,481,5,486
892,TSLA  ,2023-02-23,2023-05-19,360.0,759,1,760
893,TSLA  ,2023-02-23,2023-05-19,370.0,234,0,234
894,TSLA  ,2023-02-23,2023-05-19,380.0,404,0,404
895,TSLA  ,2023-02-23,2023-05-19,390.0,1107,1,1108
896,TSLA  ,2023-02-23,2023-05-19,400.0,28,0,28
897,TSLA  ,2023-02-23,2023-05-19,410.0,102,0,102
898,TSLA  ,2023-02-23,2023-06-16,1.67,103,41939,42042
899,TSLA  ,2023-02-23,2023-06-16,3.33,399,5010,5409
900,TSLA  ,2023-02-23,2023-06-16,5.0,108,1684,1792
901,TSLA  ,2023-02-23,2023-06-16,6.67,75,1309,1384
902,TSLA  ,2023-02-23,2023-06-16,8.33,425,2371,2796
903,TSLA  ,2023-02-23,2023-06-16,10.0,3235,3746,6981
904,TSLA  ,2023-02-23,2023-06-16,11.67,155,8573,8728
905,TSLA  ,2023-02-23,2023-06-16,13.33,1234,5646,6880
906,TSLA  ,2023-02-23,2023-06-16,15.0,168,4104,4272
907,TSLA  ,2023-02-23,2023-06-16,16.67,489,9830,10319
908,TSLA  ,2023-02-23,2023-06-16,18.33,88,5228,5316
909,TSLA  ,2023-02-23,2023-06-16,33.33,862,16918,17780
910,TSLA  ,2023-02-23,2023-06-16,50.0,1111,17777,18888
911,TSLA  ,2023-02-23,2023-06-16,55.0,31,7369,7400
912,TSLA  ,2023-02-23,2023-06-16,60.0,15,2266,2281
913,TSLA  ,2023-02-23,2023-06-16,65.0,4,636,640
914,TSLA  ,2023-02-23,2023-06-16,66.67,1011,14234,15245
915,TSLA  ,2023-02-23,2023-06-16,70.0,49,4060,4109
916,TSLA  ,2023-02-23,2023-06-16,75.0,84,6701,6785
917,TSLA  ,2023-02-23,2023-06-16,80.0,184,3849,4033
918,TSLA  ,2023-02-23,2023-06-16,83.33,704,5054,5758
919,TSLA  ,2023-02-23,2023-06-16,85.0,86,4491,4577
920,TSLA  ,2023-02-23,2023-06-16,90.0,206,4192,4398
921,TSLA  ,2023-02-23,2023-06-16,95.0,123,1632,1755
922,TSLA  ,2023-02-23,2023-06-16,100.0,3474,30562,34036
923,TSLA  ,2023-02-23,2023-06-16,105.0,362,5356,5718
924,TSLA  ,2023-02-23,2023-06-16,110.0,1203,5565,6768
925,TSLA  ,2023-02-23,2023-06-16,115.0,597,2923,3520
926,TSLA  ,2023-02-23,2023-06-16,116.67,1787,5248,7035
927,TSLA  ,2023-02-23,2023-06-16,120.0,3430,10041,13471
928,TSLA  ,2023-02-23,2023-06-16,123.33,459,1128,1587
929,TSLA  ,2023-02-23,2023-06-16,125.0,4147,8699,12846
930,TSLA  ,2023-02-23,2023-06-16,126.67,908,1346,2254
931,TSLA  ,2023-02-23,2023-06-16,130.0,3664,9303,12967
932,TSLA  ,2023-02-23,2023-06-16,133.33,2526,8748,11274
933,TSLA  ,2023-02-23,2023-06-16,135.0,2726,2654,5380
934,TSLA  ,2023-02-23,2023-06-16,136.67,1082,2575,3657
935,TSLA  ,2023-02-23,2023-06-16,140.0,7596,7225,14821
936,TSLA  ,2023-02-23,2023-06-16,143.33,1229,3230,4459
937,TSLA  ,2023-02-23,2023-06-16,145.0,2172,3724,5896
938,TSLA  ,2023-02-23,2023-06-16,146.67,1581,1971,3552
939,TSLA  ,2023-02-23,2023-06-16,150.0,12497,14636,27133
940,TSLA  ,2023-02-23,2023-06-16,153.33,2438,3164,5602
941,TSLA  ,2023-02-23,2023-06-16,155.0,1172,3173,4345
942,TSLA  ,2023-02-23,2023-06-16,156.67,1639,786,2425
943,TSLA  ,2023-02-23,2023-06-16,160.0,6509,7024,13533
944,TSLA  ,2023-02-23,2023-06-16,163.33,971,1208,2179
945,TSLA  ,2023-02-23,2023-06-16,165.0,1747,2903,4650
946,TSLA  ,2023-02-23,2023-06-16,166.67,3620,13370,16990
947,TSLA  ,2023-02-23,2023-06-16,170.0,2590,4895,7485
948,TSLA  ,2023-02-23,2023-06-16,173.33,1451,6286,7737
949,TSLA  ,2023-02-23,2023-06-16,175.0,2623,5494,8117
950,TSLA  ,2023-02-23,2023-06-16,180.0,10036,8722,18758
951,TSLA  ,2023-02-23,2023-06-16,183.33,9413,10232,19645
952,TSLA  ,2023-02-23,2023-06-16,185.0,7998,7117,15115
953,TSLA  ,2023-02-23,2023-06-16,186.67,962,2022,2984
954,TSLA  ,2023-02-23,2023-06-16,190.0,5732,4855,10587
955,TSLA  ,2023-02-23,2023-06-16,193.33,1959,7800,9759
956,TSLA  ,2023-02-23,2023-06-16,195.0,2900,2857,5757
957,TSLA  ,2023-02-23,2023-06-16,200.0,25610,21982,47592
958,TSLA  ,2023-02-23,2023-06-16,205.0,2789,1456,4245
959,TSLA  ,2023-02-23,2023-06-16,206.67,2537,2935,5472
960,TSLA  ,2023-02-23,2023-06-16,210.0,5997,4357,10354
961,TSLA  ,2023-02-23,2023-06-16,213.33,2331,2774,5105
962,TSLA  ,2023-02-23,2023-06-16,215.0,3883,1406,5289
963,TSLA  ,2023-02-23,2023-06-16,216.67,6687,6190,12877
964,TSLA  ,2023-02-23,2023-06-16,220.0,8250,7112,15362
965,TSLA  ,2023-02-23,2023-06-16,225.0,2390,1472,3862
966,TSLA  ,2023-02-23,2023-06-16,226.67,2765,2274,5039
967,TSLA  ,2023-02-23,2023-06-16,230.0,7234,3060,10294
968,TSLA  ,2023-02-23,2023-06-16,233.33,11491,7996,19487
969,TSLA  ,2023-02-23,2023-06-16,235.0,3855,875,4730
970,TSLA  ,2023-02-23,2023-06-16,240.0,8404,3114,11518
971,TSLA  ,2023-02-23,2023-06-16,243.33,1345,1704,3049
972,TSLA  ,2023-02-23,2023-06-16,245.0,1990,86,2076
973,TSLA  ,2023-02-23,2023-06-16,246.67,3068,95,3163
974,TSLA  ,2023-02-23,2023-06-16,250.0,15831,3542,19373
975,TSLA  ,2023-02-23,2023-06-16,253.33,1505,195,1700
976,TSLA  ,2023-02-23,2023-06-16,255.0,1215,73,1288
977,TSLA  ,2023-02-23,2023-06-16,260.0,6030,81,6111
978,TSLA  ,2023-02-23,2023-06-16,265.0,2455,84,2539
979,TSLA  ,2023-02-23,2023-06-16,266.67,7298,408,7706
980,TSLA  ,2023-02-23,2023-06-16,270.0,1529,6,1535
981,TSLA  ,2023-02-23,2023-06-16,273.33,1402,1051,2453
982,TSLA  ,2023-02-23,2023-06-16,275.0,2176,9,2185
983,TSLA  ,2023-02-23,2023-06-16,280.0,4359,70,4429
984,TSLA  ,2023-02-23,2023-06-16,283.33,4646,51,4697
985,TSLA  ,2023-02-23,2023-06-16,285.0,1008,2,1010
986,TSLA  ,2023-02-23,2023-06-16,286.67,723,50,773
987,TSLA  ,2023-02-23,2023-06-16,290.0,1482,826,2308
988,TSLA  ,2023-02-23,2023-06-16,293.33,1608,62,1670
989,TSLA  ,2023-02-23,2023-06-16,295.0,313,258,571
990,TSLA  ,2023-02-23,2023-06-16,300.0,18231,196,18427
991,TSLA  ,2023-02-23,2023-06-16,305.0,943,5,948
992,TSLA  ,2023-02-23,2023-06-16,306.67,1437,30,1467
993,TSLA  ,2023-02-23,2023-06-16,310.0,1780,44,1824
994,TSLA  ,2023-02-23,2023-06-16,313.33,542,33,575
995,TSLA  ,2023-02-23,2023-06-16,315.0,337,82,419
996,TSLA  ,2023-02-23,2023-06-16,316.67,7186,241,7427
997,TSLA  ,2023-02-23,2023-06-16,320.0,2485,3,2488
998,TSLA  ,2023-02-23,2023-06-16,326.67,9837,8,9845
999,TSLA  ,2023-02-23,2023-06-16,330.0,2541,51,2592
1000,TSLA  ,2023-02-23,2023-06-16,333.33,33414,231,33645
1001,TSLA  ,2023-02-23,2023-06-16,340.0,1734,3,1737
1002,TSLA  ,2023-02-23,2023-06-16,346.67,1317,0,1317
1003,TSLA  ,2023-02-23,2023-06-16,350.0,8597,334,8931
1004,TSLA  ,2023-02-23,2023-06-16,353.33,986,0,986
1005,TSLA  ,2023-02-23,2023-06-16,360.0,1925,3,1928
1006,TSLA  ,2023-02-23,2023-06-16,366.67,11029,469,11498
1007,TSLA  ,2023-02-23,2023-06-16,370.0,1010,0,1010
1008,TSLA  ,2023-02-23,2023-06-16,383.33,10899,0,10899
1009,TSLA  ,2023-02-23,2023-06-16,400.0,18163,961,19124
1010,TSLA  ,2023-02-23,2023-06-16,416.67,3566,0,3566
1011,TSLA  ,2023-02-23,2023-06-16,433.33,9651,0,9651
1012,TSLA  ,2023-02-23,2023-06-16,450.0,8171,0,8171
1013,TSLA  ,2023-02-23,2023-06-16,466.67,20924,0,20924
1014,TSLA  ,2023-02-23,2023-06-16,483.33,8305,0,8305
1015,TSLA  ,2023-02-23,2023-06-16,500.0,21063,0,21063
1016,TSLA  ,2023-02-23,2023-06-16,516.67,2618,0,2618
1017,TSLA  ,2023-02-23,2023-06-16,533.33,4873,0,4873
1018,TSLA  ,2023-02-23,2023-06-16,550.0,6103,0,6103
1019,TSLA  ,2023-02-23,2023-06-16,558.33,1603,0,1603
1020,TSLA  ,2023-02-23,2023-06-16,566.67,1276,0,1276
1021,TSLA  ,2023-02-23,2023-06-16,575.0,719,0,719
1022,TSLA  ,2023-02-23,2023-06-16,583.33,1203,0,1203
1023,TSLA  ,2023-02-23,2023-06-16,591.67,399,0,399
1024,TSLA  ,2023-02-23,2023-06-16,600.0,6656,0,6656
1025,TSLA  ,2023-02-23,2023-06-16,608.33,1106,0,1106
1026,TSLA  ,2023-02-23,2023-06-16,616.67,548,0,548
1027,TSLA  ,2023-02-23,2023-06-16,625.0,2139,0,2139
1028,TSLA  ,2023-02-23,2023-06-16,633.33,5398,0,5398
1029,TSLA  ,2023-02-23,2023-06-16,641.67,450,0,450
1030,TSLA  ,2023-02-23,2023-06-16,650.0,590,0,590
1031,TSLA  ,2023-02-23,2023-06-16,666.67,18710,0,18710
1032,TSLA  ,2023-02-23,2023-06-16,675.0,936,0,936
1033,TSLA  ,2023-02-23,2023-06-16,683.33,607,0,607
1034,TSLA  ,2023-02-23,2023-06-16,691.67,894,0,894
1035,TSLA  ,2023-02-23,2023-06-16,700.0,2806,0,2806
1036,TSLA  ,2023-02-23,2023-06-16,708.33,547,0,547
1037,TSLA  ,2023-02-23,2023-06-16,716.67,705,0,705
1038,TSLA  ,2023-02-23,2023-06-16,725.0,1184,0,1184
1039,TSLA  ,2023-02-23,2023-06-16,733.33,2256,0,2256
1040,TSLA  ,2023-02-23,2023-06-16,741.67,755,0,755
1041,TSLA  ,2023-02-23,2023-06-16,750.0,11723,0,11723
1042,TSLA  ,2023-02-23,2023-06-16,758.33,1299,0,1299
1043,TSLA  ,2023-02-23,2023-06-16,766.67,1263,0,1263
1044,TSLA  ,2023-02-23,2023-06-16,775.0,1153,0,1153
1045,TSLA  ,2023-02-23,2023-06-16,783.33,2229,0,2229
1046,TSLA  ,2023-02-23,2023-06-16,791.67,1890,0,1890
1047,TSLA  ,2023-02-23,2023-06-16,800.0,10196,0,10196
1048,TSLA  ,2023-02-23,2023-06-16,808.33,1281,0,1281
1049,TSLA  ,2023-02-23,2023-06-16,816.67,1918,0,1918
1050,TSLA  ,2023-02-23,2023-06-16,825.0,42746,0,42746
1051,TSLA  ,2023-02-23,2023-07-21,5.0,32,723,755
1052,TSLA  ,2023-02-23,2023-07-21,10.0,5,907,912
1053,TSLA  ,2023-02-23,2023-07-21,15.0,4,657,661
1054,TSLA  ,2023-02-23,2023-07-21,20.0,17,1214,1231
1055,TSLA  ,2023-02-23,2023-07-21,25.0,25,1025,1050
1056,TSLA  ,2023-02-23,2023-07-21,30.0,111,1449,1560
1057,TSLA  ,2023-02-23,2023-07-21,35.0,42,840,882
1058,TSLA  ,2023-02-23,2023-07-21,40.0,21,1197,1218
1059,TSLA  ,2023-02-23,2023-07-21,45.0,38,651,689
1060,TSLA  ,2023-02-23,2023-07-21,50.0,70,5156,5226
1061,TSLA  ,2023-02-23,2023-07-21,55.0,86,1857,1943
1062,TSLA  ,2023-02-23,2023-07-21,60.0,94,3690,3784
1063,TSLA  ,2023-02-23,2023-07-21,65.0,89,406,495
1064,TSLA  ,2023-02-23,2023-07-21,70.0,25,2224,2249
1065,TSLA  ,2023-02-23,2023-07-21,75.0,63,4238,4301
1066,TSLA  ,2023-02-23,2023-07-21,80.0,79,3678,3757
1067,TSLA  ,2023-02-23,2023-07-21,85.0,54,1390,1444
1068,TSLA  ,2023-02-23,2023-07-21,90.0,121,3490,3611
1069,TSLA  ,2023-02-23,2023-07-21,95.0,68,1672,1740
1070,TSLA  ,2023-02-23,2023-07-21,100.0,336,5839,6175
1071,TSLA  ,2023-02-23,2023-07-21,105.0,373,2540,2913
1072,TSLA  ,2023-02-23,2023-07-21,110.0,1123,3791,4914
1073,TSLA  ,2023-02-23,2023-07-21,115.0,455,1057,1512
1074,TSLA  ,2023-02-23,2023-07-21,120.0,1249,4550,5799
1075,TSLA  ,2023-02-23,2023-07-21,125.0,1406,2223,3629
1076,TSLA  ,2023-02-23,2023-07-21,130.0,1500,2195,3695
1077,TSLA  ,2023-02-23,2023-07-21,135.0,1144,2996,4140
1078,TSLA  ,2023-02-23,2023-07-21,140.0,1484,4224,5708
1079,TSLA  ,2023-02-23,2023-07-21,145.0,1065,2290,3355
1080,TSLA  ,2023-02-23,2023-07-21,150.0,3190,3981,7171
1081,TSLA  ,2023-02-23,2023-07-21,155.0,1684,2881,4565
1082,TSLA  ,2023-02-23,2023-07-21,160.0,1763,1722,3485
1083,TSLA  ,2023-02-23,2023-07-21,165.0,673,1512,2185
1084,TSLA  ,2023-02-23,2023-07-21,170.0,1832,2851,4683
1085,TSLA  ,2023-02-23,2023-07-21,175.0,1640,1539,3179
1086,TSLA  ,2023-02-23,2023-07-21,180.0,2094,1960,4054
1087,TSLA  ,2023-02-23,2023-07-21,185.0,3935,13279,17214
1088,TSLA  ,2023-02-23,2023-07-21,190.0,3854,2352,6206
1089,TSLA  ,2023-02-23,2023-07-21,195.0,2858,1841,4699
1090,TSLA  ,2023-02-23,2023-07-21,200.0,5844,3806,9650
1091,TSLA  ,2023-02-23,2023-07-21,205.0,3739,2356,6095
1092,TSLA  ,2023-02-23,2023-07-21,210.0,6786,2357,9143
1093,TSLA  ,2023-02-23,2023-07-21,215.0,3408,1479,4887
1094,TSLA  ,2023-02-23,2023-07-21,220.0,2839,1583,4422
1095,TSLA  ,2023-02-23,2023-07-21,225.0,5282,2123,7405
1096,TSLA  ,2023-02-23,2023-07-21,230.0,1970,1273,3243
1097,TSLA  ,2023-02-23,2023-07-21,235.0,1706,697,2403
1098,TSLA  ,2023-02-23,2023-07-21,240.0,2493,1749,4242
1099,TSLA  ,2023-02-23,2023-07-21,245.0,2471,718,3189
1100,TSLA  ,2023-02-23,2023-07-21,250.0,24440,1513,25953
1101,TSLA  ,2023-02-23,2023-07-21,255.0,1013,681,1694
1102,TSLA  ,2023-02-23,2023-07-21,260.0,1619,119,1738
1103,TSLA  ,2023-02-23,2023-07-21,265.0,677,9,686
1104,TSLA  ,2023-02-23,2023-07-21,270.0,833,125,958
1105,TSLA  ,2023-02-23,2023-07-21,275.0,568,82,650
1106,TSLA  ,2023-02-23,2023-07-21,280.0,1154,147,1301
1107,TSLA  ,2023-02-23,2023-07-21,285.0,1049,147,1196
1108,TSLA  ,2023-02-23,2023-07-21,290.0,371,35,406
1109,TSLA  ,2023-02-23,2023-07-21,295.0,476,11,487
1110,TSLA  ,2023-02-23,2023-07-21,300.0,2651,42,2693
1111,TSLA  ,2023-02-23,2023-07-21,305.0,237,6,243
1112,TSLA  ,2023-02-23,2023-07-21,310.0,1392,6,1398
1113,TSLA  ,2023-02-23,2023-07-21,315.0,404,1,405
1114,TSLA  ,2023-02-23,2023-07-21,320.0,973,2,975
1115,TSLA  ,2023-02-23,2023-07-21,325.0,670,2,672
1116,TSLA  ,2023-02-23,2023-07-21,330.0,434,25,459
1117,TSLA  ,2023-02-23,2023-07-21,335.0,168,7,175
1118,TSLA  ,2023-02-23,2023-07-21,340.0,437,16,453
1119,TSLA  ,2023-02-23,2023-07-21,345.0,215,0,215
1120,TSLA  ,2023-02-23,2023-07-21,350.0,807,1,808
1121,TSLA  ,2023-02-23,2023-07-21,355.0,279,1,280
1122,TSLA  ,2023-02-23,2023-07-21,360.0,562,3,565
1123,TSLA  ,2023-02-23,2023-07-21,365.0,877,0,877
1124,TSLA  ,2023-02-23,2023-07-21,370.0,1052,0,1052
1125,TSLA  ,2023-02-23,2023-07-21,375.0,3142,0,3142
1126,TSLA  ,2023-02-23,2023-07-21,380.0,193,0,193
1127,TSLA  ,2023-02-23,2023-07-21,390.0,638,0,638
1128,TSLA  ,2023-02-23,2023-07-21,400.0,60,0,60
1129,TSLA  ,2023-02-23,2023-07-21,410.0,229,0,229
1130,TSLA  ,2023-02-23,2023-09-15,1.67,861,20381,21242
1131,TSLA  ,2023-02-23,2023-09-15,3.33,1085,2859,3944
1132,TSLA  ,2023-02-23,2023-09-15,5.0,34,943,977
1133,TSLA  ,2023-02-23,2023-09-15,6.67,29,3369,3398
1134,TSLA  ,2023-02-23,2023-09-15,8.33,32,1183,1215
1135,TSLA  ,2023-02-23,2023-09-15,10.0,26,2920,2946
1136,TSLA  ,2023-02-23,2023-09-15,11.67,49,620,669
1137,TSLA  ,2023-02-23,2023-09-15,13.33,83,230,313
1138,TSLA  ,2023-02-23,2023-09-15,15.0,0,138,138
1139,TSLA  ,2023-02-23,2023-09-15,16.67,143,4213,4356
1140,TSLA  ,2023-02-23,2023-09-15,30.0,0,310,310
1141,TSLA  ,2023-02-23,2023-09-15,33.33,3118,11342,14460
1142,TSLA  ,2023-02-23,2023-09-15,35.0,5,529,534
1143,TSLA  ,2023-02-23,2023-09-15,40.0,9,281,290
1144,TSLA  ,2023-02-23,2023-09-15,45.0,9,49,58
1145,TSLA  ,2023-02-23,2023-09-15,50.0,418,7866,8284
1146,TSLA  ,2023-02-23,2023-09-15,55.0,23,2378,2401
1147,TSLA  ,2023-02-23,2023-09-15,60.0,30,4762,4792
1148,TSLA  ,2023-02-23,2023-09-15,65.0,4,2216,2220
1149,TSLA  ,2023-02-23,2023-09-15,66.67,434,5690,6124
1150,TSLA  ,2023-02-23,2023-09-15,70.0,101,620,721
1151,TSLA  ,2023-02-23,2023-09-15,75.0,26,651,677
1152,TSLA  ,2023-02-23,2023-09-15,80.0,275,912,1187
1153,TSLA  ,2023-02-23,2023-09-15,83.33,406,4270,4676
1154,TSLA  ,2023-02-23,2023-09-15,85.0,52,338,390
1155,TSLA  ,2023-02-23,2023-09-15,90.0,485,2722,3207
1156,TSLA  ,2023-02-23,2023-09-15,95.0,70,2436,2506
1157,TSLA  ,2023-02-23,2023-09-15,100.0,2489,12146,14635
1158,TSLA  ,2023-02-23,2023-09-15,105.0,88,2169,2257
1159,TSLA  ,2023-02-23,2023-09-15,108.33,397,2109,2506
1160,TSLA  ,2023-02-23,2023-09-15,110.0,1198,1524,2722
1161,TSLA  ,2023-02-23,2023-09-15,115.0,260,2827,3087
1162,TSLA  ,2023-02-23,2023-09-15,116.67,569,12232,12801
1163,TSLA  ,2023-02-23,2023-09-15,120.0,854,2048,2902
1164,TSLA  ,2023-02-23,2023-09-15,123.33,523,1352,1875
1165,TSLA  ,2023-02-23,2023-09-15,125.0,1737,8141,9878
1166,TSLA  ,2023-02-23,2023-09-15,126.67,130,1069,1199
1167,TSLA  ,2023-02-23,2023-09-15,130.0,1399,5019,6418
1168,TSLA  ,2023-02-23,2023-09-15,133.33,220,2349,2569
1169,TSLA  ,2023-02-23,2023-09-15,135.0,231,1238,1469
1170,TSLA  ,2023-02-23,2023-09-15,136.67,287,968,1255
1171,TSLA  ,2023-02-23,2023-09-15,140.0,1732,2735,4467
1172,TSLA  ,2023-02-23,2023-09-15,141.67,763,1682,2445
1173,TSLA  ,2023-02-23,2023-09-15,143.33,284,1583,1867
1174,TSLA  ,2023-02-23,2023-09-15,145.0,347,2628,2975
1175,TSLA  ,2023-02-23,2023-09-15,146.67,1372,1093,2465
1176,TSLA  ,2023-02-23,2023-09-15,150.0,33705,9068,42773
1177,TSLA  ,2023-02-23,2023-09-15,153.33,30476,1822,32298
1178,TSLA  ,2023-02-23,2023-09-15,155.0,424,397,821
1179,TSLA  ,2023-02-23,2023-09-15,156.67,394,828,1222
1180,TSLA  ,2023-02-23,2023-09-15,158.33,313,603,916
1181,TSLA  ,2023-02-23,2023-09-15,160.0,3730,7233,10963
1182,TSLA  ,2023-02-23,2023-09-15,163.33,396,1501,1897
1183,TSLA  ,2023-02-23,2023-09-15,165.0,1247,960,2207
1184,TSLA  ,2023-02-23,2023-09-15,166.67,1391,3252,4643
1185,TSLA  ,2023-02-23,2023-09-15,170.0,634,796,1430
1186,TSLA  ,2023-02-23,2023-09-15,173.33,10306,3044,13350
1187,TSLA  ,2023-02-23,2023-09-15,175.0,10893,7937,18830
1188,TSLA  ,2023-02-23,2023-09-15,180.0,33690,7837,41527
1189,TSLA  ,2023-02-23,2023-09-15,183.33,32272,4815,37087
1190,TSLA  ,2023-02-23,2023-09-15,185.0,340,838,1178
1191,TSLA  ,2023-02-23,2023-09-15,186.67,519,3490,4009
1192,TSLA  ,2023-02-23,2023-09-15,190.0,745,3534,4279
1193,TSLA  ,2023-02-23,2023-09-15,191.67,489,1220,1709
1194,TSLA  ,2023-02-23,2023-09-15,193.33,897,3031,3928
1195,TSLA  ,2023-02-23,2023-09-15,195.0,479,1030,1509
1196,TSLA  ,2023-02-23,2023-09-15,200.0,11872,17377,29249
1197,TSLA  ,2023-02-23,2023-09-15,205.0,645,655,1300
1198,TSLA  ,2023-02-23,2023-09-15,206.67,1184,687,1871
1199,TSLA  ,2023-02-23,2023-09-15,208.33,620,1952,2572
1200,TSLA  ,2023-02-23,2023-09-15,210.0,2431,443,2874
1201,TSLA  ,2023-02-23,2023-09-15,213.33,970,1207,2177
1202,TSLA  ,2023-02-23,2023-09-15,215.0,1197,330,1527
1203,TSLA  ,2023-02-23,2023-09-15,216.67,2035,4088,6123
1204,TSLA  ,2023-02-23,2023-09-15,220.0,8889,4196,13085
1205,TSLA  ,2023-02-23,2023-09-15,225.0,3152,3423,6575
1206,TSLA  ,2023-02-23,2023-09-15,226.67,2324,1554,3878
1207,TSLA  ,2023-02-23,2023-09-15,230.0,3420,1105,4525
1208,TSLA  ,2023-02-23,2023-09-15,233.33,2804,3590,6394
1209,TSLA  ,2023-02-23,2023-09-15,235.0,790,1015,1805
1210,TSLA  ,2023-02-23,2023-09-15,240.0,1931,1885,3816
1211,TSLA  ,2023-02-23,2023-09-15,241.67,1348,1004,2352
1212,TSLA  ,2023-02-23,2023-09-15,245.0,238,370,608
1213,TSLA  ,2023-02-23,2023-09-15,246.67,511,963,1474
1214,TSLA  ,2023-02-23,2023-09-15,250.0,10901,5775,16676
1215,TSLA  ,2023-02-23,2023-09-15,253.33,815,705,1520
1216,TSLA  ,2023-02-23,2023-09-15,255.0,358,156,514
1217,TSLA  ,2023-02-23,2023-09-15,258.33,1170,2412,3582
1218,TSLA  ,2023-02-23,2023-09-15,260.0,11986,1418,13404
1219,TSLA  ,2023-02-23,2023-09-15,265.0,1217,151,1368
1220,TSLA  ,2023-02-23,2023-09-15,266.67,2345,324,2669
1221,TSLA  ,2023-02-23,2023-09-15,270.0,528,162,690
1222,TSLA  ,2023-02-23,2023-09-15,273.33,857,383,1240
1223,TSLA  ,2023-02-23,2023-09-15,275.0,2900,3223,6123
1224,TSLA  ,2023-02-23,2023-09-15,280.0,2467,576,3043
1225,TSLA  ,2023-02-23,2023-09-15,283.33,1307,316,1623
1226,TSLA  ,2023-02-23,2023-09-15,286.67,590,97,687
1227,TSLA  ,2023-02-23,2023-09-15,290.0,1492,65,1557
1228,TSLA  ,2023-02-23,2023-09-15,291.67,958,386,1344
1229,TSLA  ,2023-02-23,2023-09-15,293.33,1345,460,1805
1230,TSLA  ,2023-02-23,2023-09-15,300.0,8004,967,8971
1231,TSLA  ,2023-02-23,2023-09-15,306.67,2722,327,3049
1232,TSLA  ,2023-02-23,2023-09-15,308.33,868,335,1203
1233,TSLA  ,2023-02-23,2023-09-15,310.0,103,0,103
1234,TSLA  ,2023-02-23,2023-09-15,313.33,804,287,1091
1235,TSLA  ,2023-02-23,2023-09-15,316.67,1622,162,1784
1236,TSLA  ,2023-02-23,2023-09-15,320.0,3466,169,3635
1237,TSLA  ,2023-02-23,2023-09-15,325.0,2811,75,2886
1238,TSLA  ,2023-02-23,2023-09-15,326.67,1070,5,1075
1239,TSLA  ,2023-02-23,2023-09-15,333.33,6457,83,6540
1240,TSLA  ,2023-02-23,2023-09-15,340.0,23368,148,23516
1241,TSLA  ,2023-02-23,2023-09-15,341.67,186,187,373
1242,TSLA  ,2023-02-23,2023-09-15,346.67,574,137,711
1243,TSLA  ,2023-02-23,2023-09-15,350.0,20931,328,21259
1244,TSLA  ,2023-02-23,2023-09-15,353.33,22639,149,22788
1245,TSLA  ,2023-02-23,2023-09-15,358.33,463,287,750
1246,TSLA  ,2023-02-23,2023-09-15,360.0,3415,307,3722
1247,TSLA  ,2023-02-23,2023-09-15,366.67,2798,561,3359
1248,TSLA  ,2023-02-23,2023-09-15,375.0,3313,160,3473
1249,TSLA  ,2023-02-23,2023-09-15,383.33,4643,47,4690
1250,TSLA  ,2023-02-23,2023-09-15,391.67,842,14,856
1251,TSLA  ,2023-02-23,2023-09-15,400.0,6011,69,6080
1252,TSLA  ,2023-02-23,2023-09-15,408.33,1610,1,1611
1253,TSLA  ,2023-02-23,2023-09-15,416.67,1110,0,1110
1254,TSLA  ,2023-02-23,2023-09-15,425.0,3325,0,3325
1255,TSLA  ,2023-02-23,2023-09-15,433.33,4936,12,4948
1256,TSLA  ,2023-02-23,2023-09-15,441.67,1060,0,1060
1257,TSLA  ,2023-02-23,2023-09-15,450.0,2545,0,2545
1258,TSLA  ,2023-02-23,2023-09-15,458.33,401,0,401
1259,TSLA  ,2023-02-23,2023-09-15,466.67,2696,0,2696
1260,TSLA  ,2023-02-23,2023-09-15,475.0,337,0,337
1261,TSLA  ,2023-02-23,2023-09-15,483.33,669,0,669
1262,TSLA  ,2023-02-23,2023-09-15,491.67,1097,0,1097
1263,TSLA  ,2023-02-23,2023-09-15,500.0,5563,0,5563
1264,TSLA  ,2023-02-23,2023-09-15,508.33,812,0,812
1265,TSLA  ,2023-02-23,2023-09-15,516.67,1270,0,1270
1266,TSLA  ,2023-02-23,2023-09-15,525.0,1191,0,1191
1267,TSLA  ,2023-02-23,2023-09-15,533.33,1582,0,1582
1268,TSLA  ,2023-02-23,2023-09-15,541.67,1167,0,1167
1269,TSLA  ,2023-02-23,2023-09-15,550.0,11729,0,11729
1270,TSLA  ,2023-02-23,2023-09-15,558.33,188,0,188
1271,TSLA  ,2023-02-23,2023-09-15,566.67,4046,0,4046
1272,TSLA  ,2023-02-23,2023-09-15,575.0,414,0,414
1273,TSLA  ,2023-02-23,2023-09-15,583.33,515,0,515
1274,TSLA  ,2023-02-23,2023-09-15,591.67,2112,0,2112
1275,TSLA  ,2023-02-23,2023-09-15,600.0,8739,0,8739
1276,TSLA  ,2023-02-23,2023-09-15,608.33,676,0,676
1277,TSLA  ,2023-02-23,2023-09-15,616.67,1021,0,1021
1278,TSLA  ,2023-02-23,2023-09-15,625.0,1093,0,1093
1279,TSLA  ,2023-02-23,2023-09-15,633.33,716,0,716
1280,TSLA  ,2023-02-23,2023-09-15,641.67,425,0,425
1281,TSLA  ,2023-02-23,2023-09-15,650.0,27723,0,27723
1282,TSLA  ,2023-02-23,2023-09-15,658.33,1206,0,1206
1283,TSLA  ,2023-02-23,2023-09-15,666.67,1367,0,1367
1284,TSLA  ,2023-02-23,2023-09-15,675.0,467,0,467
1285,TSLA  ,2023-02-23,2023-09-15,683.33,459,0,459
1286,TSLA  ,2023-02-23,2023-09-15,700.0,1578,0,1578
1287,TSLA  ,2023-02-23,2023-09-15,716.67,1040,0,1040
1288,TSLA  ,2023-02-23,2023-09-15,733.33,2322,0,2322
1289,TSLA  ,2023-02-23,2023-09-15,750.0,8211,0,8211
1290,TSLA  ,2023-02-23,2023-09-15,758.33,72031,0,72031
1291,TSLA  ,2023-02-23,2023-12-15,50.0,1399,14211,15610
1292,TSLA  ,2023-02-23,2023-12-15,55.0,222,1196,1418
1293,TSLA  ,2023-02-23,2023-12-15,60.0,40,1353,1393
1294,TSLA  ,2023-02-23,2023-12-15,65.0,4,388,392
1295,TSLA  ,2023-02-23,2023-12-15,70.0,27,3880,3907
1296,TSLA  ,2023-02-23,2023-12-15,75.0,19,4131,4150
1297,TSLA  ,2023-02-23,2023-12-15,80.0,156,961,1117
1298,TSLA  ,2023-02-23,2023-12-15,85.0,2574,2368,4942
1299,TSLA  ,2023-02-23,2023-12-15,90.0,1648,6022,7670
1300,TSLA  ,2023-02-23,2023-12-15,95.0,831,515,1346
1301,TSLA  ,2023-02-23,2023-12-15,100.0,3404,7142,10546
1302,TSLA  ,2023-02-23,2023-12-15,105.0,322,2275,2597
1303,TSLA  ,2023-02-23,2023-12-15,110.0,679,2233,2912
1304,TSLA  ,2023-02-23,2023-12-15,115.0,1711,1683,3394
1305,TSLA  ,2023-02-23,2023-12-15,120.0,1027,1404,2431
1306,TSLA  ,2023-02-23,2023-12-15,125.0,527,1588,2115
1307,TSLA  ,2023-02-23,2023-12-15,130.0,770,11525,12295
1308,TSLA  ,2023-02-23,2023-12-15,135.0,788,6174,6962
1309,TSLA  ,2023-02-23,2023-12-15,140.0,944,2288,3232
1310,TSLA  ,2023-02-23,2023-12-15,145.0,620,960,1580
1311,TSLA  ,2023-02-23,2023-12-15,150.0,1503,12720,14223
1312,TSLA  ,2023-02-23,2023-12-15,155.0,393,1048,1441
1313,TSLA  ,2023-02-23,2023-12-15,160.0,2833,11051,13884
1314,TSLA  ,2023-02-23,2023-12-15,165.0,1440,531,1971
1315,TSLA  ,2023-02-23,2023-12-15,170.0,747,4565,5312
1316,TSLA  ,2023-02-23,2023-12-15,175.0,2078,454,2532
1317,TSLA  ,2023-02-23,2023-12-15,180.0,1598,1300,2898
1318,TSLA  ,2023-02-23,2023-12-15,185.0,562,660,1222
1319,TSLA  ,2023-02-23,2023-12-15,190.0,1100,567,1667
1320,TSLA  ,2023-02-23,2023-12-15,195.0,785,1026,1811
1321,TSLA  ,2023-02-23,2023-12-15,200.0,8225,1559,9784
1322,TSLA  ,2023-02-23,2023-12-15,205.0,6596,829,7425
1323,TSLA  ,2023-02-23,2023-12-15,210.0,3163,769,3932
1324,TSLA  ,2023-02-23,2023-12-15,215.0,1282,655,1937
1325,TSLA  ,2023-02-23,2023-12-15,220.0,1624,1197,2821
1326,TSLA  ,2023-02-23,2023-12-15,225.0,1121,303,1424
1327,TSLA  ,2023-02-23,2023-12-15,230.0,2250,734,2984
1328,TSLA  ,2023-02-23,2023-12-15,235.0,511,448,959
1329,TSLA  ,2023-02-23,2023-12-15,240.0,5780,709,6489
1330,TSLA  ,2023-02-23,2023-12-15,245.0,2367,514,2881
1331,TSLA  ,2023-02-23,2023-12-15,250.0,15773,3668,19441
1332,TSLA  ,2023-02-23,2023-12-15,260.0,10283,1779,12062
1333,TSLA  ,2023-02-23,2023-12-15,270.0,4019,522,4541
1334,TSLA  ,2023-02-23,2023-12-15,280.0,1479,680,2159
1335,TSLA  ,2023-02-23,2023-12-15,290.0,502,493,995
1336,TSLA  ,2023-02-23,2023-12-15,300.0,1760,1045,2805
1337,TSLA  ,2023-02-23,2023-12-15,310.0,765,621,1386
1338,TSLA  ,2023-02-23,2023-12-15,320.0,1160,543,1703
1339,TSLA  ,2023-02-23,2023-12-15,330.0,424,232,656
1340,TSLA  ,2023-02-23,2023-12-15,340.0,329,120,449
1341,TSLA  ,2023-02-23,2023-12-15,350.0,1099,183,1282
1342,TSLA  ,2023-02-23,2023-12-15,360.0,612,117,729
1343,TSLA  ,2023-02-23,2023-12-15,370.0,159,244,403
1344,TSLA  ,2023-02-23,2023-12-15,380.0,488,321,809
1345,TSLA  ,2023-02-23,2023-12-15,390.0,1517,147,1664
1346,TSLA  ,2023-02-23,2023-12-15,400.0,14,0,14
1347,TSLA  ,2023-02-23,2023-12-15,410.0,43,45,88
1348,TSLA  ,2023-02-23,2024-01-19,1.67,2505,29779,32284
1349,TSLA  ,2023-02-23,2024-01-19,3.33,968,6105,7073
1350,TSLA  ,2023-02-23,2024-01-19,5.0,259,10876,11135
1351,TSLA  ,2023-02-23,2024-01-19,6.67,76,3483,3559
1352,TSLA  ,2023-02-23,2024-01-19,8.33,3902,2871,6773
1353,TSLA  ,2023-02-23,2024-01-19,10.0,294,4575,4869
1354,TSLA  ,2023-02-23,2024-01-19,11.67,253,3730,3983
1355,TSLA  ,2023-02-23,2024-01-19,13.33,819,512,1331
1356,TSLA  ,2023-02-23,2024-01-19,15.0,279,2088,2367
1357,TSLA  ,2023-02-23,2024-01-19,16.67,486,4691,5177
1358,TSLA  ,2023-02-23,2024-01-19,18.33,393,6118,6511
1359,TSLA  ,2023-02-23,2024-01-19,20.0,257,7615,7872
1360,TSLA  ,2023-02-23,2024-01-19,21.67,118,844,962
1361,TSLA  ,2023-02-23,2024-01-19,23.33,382,3875,4257
1362,TSLA  ,2023-02-23,2024-01-19,25.0,369,3209,3578
1363,TSLA  ,2023-02-23,2024-01-19,26.67,833,1127,1960
1364,TSLA  ,2023-02-23,2024-01-19,28.33,341,747,1088
1365,TSLA  ,2023-02-23,2024-01-19,30.0,228,8841,9069
1366,TSLA  ,2023-02-23,2024-01-19,31.67,1326,1348,2674
1367,TSLA  ,2023-02-23,2024-01-19,33.33,4315,32821,37136
1368,TSLA  ,2023-02-23,2024-01-19,50.0,2166,31126,33292
1369,TSLA  ,2023-02-23,2024-01-19,55.0,80,1491,1571
1370,TSLA  ,2023-02-23,2024-01-19,60.0,250,2628,2878
1371,TSLA  ,2023-02-23,2024-01-19,65.0,266,751,1017
1372,TSLA  ,2023-02-23,2024-01-19,66.67,4703,14832,19535
1373,TSLA  ,2023-02-23,2024-01-19,70.0,155,815,970
1374,TSLA  ,2023-02-23,2024-01-19,75.0,91,1224,1315
1375,TSLA  ,2023-02-23,2024-01-19,80.0,405,2023,2428
1376,TSLA  ,2023-02-23,2024-01-19,83.33,1067,8128,9195
1377,TSLA  ,2023-02-23,2024-01-19,85.0,511,435,946
1378,TSLA  ,2023-02-23,2024-01-19,90.0,3548,1339,4887
1379,TSLA  ,2023-02-23,2024-01-19,95.0,2981,1554,4535
1380,TSLA  ,2023-02-23,2024-01-19,100.0,13993,41250,55243
1381,TSLA  ,2023-02-23,2024-01-19,105.0,1277,2124,3401
1382,TSLA  ,2023-02-23,2024-01-19,110.0,4800,7102,11902
1383,TSLA  ,2023-02-23,2024-01-19,115.0,4673,5600,10273
1384,TSLA  ,2023-02-23,2024-01-19,116.67,1928,8423,10351
1385,TSLA  ,2023-02-23,2024-01-19,120.0,3435,6593,10028
1386,TSLA  ,2023-02-23,2024-01-19,123.33,1961,2225,4186
1387,TSLA  ,2023-02-23,2024-01-19,125.0,2409,13686,16095
1388,TSLA  ,2023-02-23,2024-01-19,126.67,1743,6632,8375
1389,TSLA  ,2023-02-23,2024-01-19,130.0,5078,11803,16881
1390,TSLA  ,2023-02-23,2024-01-19,133.33,2435,11092,13527
1391,TSLA  ,2023-02-23,2024-01-19,135.0,1260,1315,2575
1392,TSLA  ,2023-02-23,2024-01-19,136.67,2432,2315,4747
1393,TSLA  ,2023-02-23,2024-01-19,140.0,5090,4282,9372
1394,TSLA  ,2023-02-23,2024-01-19,143.33,1674,2303,3977
1395,TSLA  ,2023-02-23,2024-01-19,145.0,783,872,1655
1396,TSLA  ,2023-02-23,2024-01-19,146.67,1043,1013,2056
1397,TSLA  ,2023-02-23,2024-01-19,150.0,17743,22403,40146
1398,TSLA  ,2023-02-23,2024-01-19,153.33,10511,1071,11582
1399,TSLA  ,2023-02-23,2024-01-19,155.0,562,1462,2024
1400,TSLA  ,2023-02-23,2024-01-19,156.67,1725,905,2630
1401,TSLA  ,2023-02-23,2024-01-19,160.0,3063,12521,15584
1402,TSLA  ,2023-02-23,2024-01-19,163.33,476,8287,8763
1403,TSLA  ,2023-02-23,2024-01-19,165.0,694,583,1277
1404,TSLA  ,2023-02-23,2024-01-19,166.67,6755,6906,13661
1405,TSLA  ,2023-02-23,2024-01-19,170.0,2797,6385,9182
1406,TSLA  ,2023-02-23,2024-01-19,173.33,853,2605,3458
1407,TSLA  ,2023-02-23,2024-01-19,175.0,1732,3967,5699
1408,TSLA  ,2023-02-23,2024-01-19,176.67,1022,1263,2285
1409,TSLA  ,2023-02-23,2024-01-19,180.0,39012,11074,50086
1410,TSLA  ,2023-02-23,2024-01-19,183.33,34446,7441,41887
1411,TSLA  ,2023-02-23,2024-01-19,185.0,1349,783,2132
1412,TSLA  ,2023-02-23,2024-01-19,186.67,1259,2294,3553
1413,TSLA  ,2023-02-23,2024-01-19,190.0,1597,748,2345
1414,TSLA  ,2023-02-23,2024-01-19,193.33,2293,9813,12106
1415,TSLA  ,2023-02-23,2024-01-19,195.0,729,1995,2724
1416,TSLA  ,2023-02-23,2024-01-19,200.0,33578,23840,57418
1417,TSLA  ,2023-02-23,2024-01-19,203.33,6322,2366,8688
1418,TSLA  ,2023-02-23,2024-01-19,206.67,1685,1293,2978
1419,TSLA  ,2023-02-23,2024-01-19,210.0,11356,6932,18288
1420,TSLA  ,2023-02-23,2024-01-19,213.33,1841,2696,4537
1421,TSLA  ,2023-02-23,2024-01-19,216.67,8595,6745,15340
1422,TSLA  ,2023-02-23,2024-01-19,220.0,7003,7210,14213
1423,TSLA  ,2023-02-23,2024-01-19,223.33,6088,1685,7773
1424,TSLA  ,2023-02-23,2024-01-19,226.67,19999,2995,22994
1425,TSLA  ,2023-02-23,2024-01-19,230.0,14561,18663,33224
1426,TSLA  ,2023-02-23,2024-01-19,233.33,36933,13573,50506
1427,TSLA  ,2023-02-23,2024-01-19,236.67,2012,1702,3714
1428,TSLA  ,2023-02-23,2024-01-19,240.0,4589,3780,8369
1429,TSLA  ,2023-02-23,2024-01-19,243.33,1291,2021,3312
1430,TSLA  ,2023-02-23,2024-01-19,246.67,1191,2109,3300
1431,TSLA  ,2023-02-23,2024-01-19,250.0,22191,5347,27538
1432,TSLA  ,2023-02-23,2024-01-19,253.33,2869,2090,4959
1433,TSLA  ,2023-02-23,2024-01-19,256.67,2827,1641,4468
1434,TSLA  ,2023-02-23,2024-01-19,260.0,7657,3240,10897
1435,TSLA  ,2023-02-23,2024-01-19,263.33,7759,2159,9918
1436,TSLA  ,2023-02-23,2024-01-19,266.67,10196,8769,18965
1437,TSLA  ,2023-02-23,2024-01-19,270.0,4685,5121,9806
1438,TSLA  ,2023-02-23,2024-01-19,273.33,3397,3092,6489
1439,TSLA  ,2023-02-23,2024-01-19,276.67,1977,1781,3758
1440,TSLA  ,2023-02-23,2024-01-19,280.0,9298,6511,15809
1441,TSLA  ,2023-02-23,2024-01-19,283.33,3144,3089,6233
1442,TSLA  ,2023-02-23,2024-01-19,286.67,2472,1509,3981
1443,TSLA  ,2023-02-23,2024-01-19,290.0,9077,577,9654
1444,TSLA  ,2023-02-23,2024-01-19,293.33,2901,1989,4890
1445,TSLA  ,2023-02-23,2024-01-19,296.67,2179,1688,3867
1446,TSLA  ,2023-02-23,2024-01-19,300.0,25704,6204,31908
1447,TSLA  ,2023-02-23,2024-01-19,303.33,3451,289,3740
1448,TSLA  ,2023-02-23,2024-01-19,306.67,6581,134,6715
1449,TSLA  ,2023-02-23,2024-01-19,310.0,3712,1038,4750
1450,TSLA  ,2023-02-23,2024-01-19,313.33,1200,26,1226
1451,TSLA  ,2023-02-23,2024-01-19,316.67,4149,306,4455
1452,TSLA  ,2023-02-23,2024-01-19,320.0,6747,325,7072
1453,TSLA  ,2023-02-23,2024-01-19,323.33,453,268,721
1454,TSLA  ,2023-02-23,2024-01-19,325.0,10253,135,10388
1455,TSLA  ,2023-02-23,2024-01-19,326.67,1376,630,2006
1456,TSLA  ,2023-02-23,2024-01-19,330.0,7452,11,7463
1457,TSLA  ,2023-02-23,2024-01-19,333.33,30441,1723,32164
1458,TSLA  ,2023-02-23,2024-01-19,336.67,1467,7,1474
1459,TSLA  ,2023-02-23,2024-01-19,340.0,3712,5,3717
1460,TSLA  ,2023-02-23,2024-01-19,341.67,928,10,938
1461,TSLA  ,2023-02-23,2024-01-19,343.33,552,0,552
1462,TSLA  ,2023-02-23,2024-01-19,346.67,2398,3,2401
1463,TSLA  ,2023-02-23,2024-01-19,350.0,15584,761,16345
1464,TSLA  ,2023-02-23,2024-01-19,353.33,1163,0,1163
1465,TSLA  ,2023-02-23,2024-01-19,356.67,902,0,902
1466,TSLA  ,2023-02-23,2024-01-19,358.33,1237,3,1240
1467,TSLA  ,2023-02-23,2024-01-19,360.0,9291,600,9891
1468,TSLA  ,2023-02-23,2024-01-19,363.33,517,7,524
1469,TSLA  ,2023-02-23,2024-01-19,366.67,38803,2807,41610
1470,TSLA  ,2023-02-23,2024-01-19,370.0,5982,4,5986
1471,TSLA  ,2023-02-23,2024-01-19,373.33,1058,12,1070
1472,TSLA  ,2023-02-23,2024-01-19,375.0,11421,8,11429
1473,TSLA  ,2023-02-23,2024-01-19,376.67,553,106,659
1474,TSLA  ,2023-02-23,2024-01-19,380.0,1117,2,1119
1475,TSLA  ,2023-02-23,2024-01-19,383.33,3092,3,3095
1476,TSLA  ,2023-02-23,2024-01-19,386.67,408,203,611
1477,TSLA  ,2023-02-23,2024-01-19,390.0,920,1,921
1478,TSLA  ,2023-02-23,2024-01-19,391.67,2316,1,2317
1479,TSLA  ,2023-02-23,2024-01-19,393.33,518,4,522
1480,TSLA  ,2023-02-23,2024-01-19,396.67,2708,0,2708
1481,TSLA  ,2023-02-23,2024-01-19,400.0,41301,1021,42322
1482,TSLA  ,2023-02-23,2024-01-19,408.33,5170,21,5191
1483,TSLA  ,2023-02-23,2024-01-19,416.67,4046,2172,6218
1484,TSLA  ,2023-02-23,2024-01-19,425.0,4493,18,4511
1485,TSLA  ,2023-02-23,2024-01-19,433.33,5781,3,5784
1486,TSLA  ,2023-02-23,2024-01-19,441.67,1302,0,1302
1487,TSLA  ,2023-02-23,2024-01-19,450.0,7991,2592,10583
1488,TSLA  ,2023-02-23,2024-01-19,458.33,2004,0,2004
1489,TSLA  ,2023-02-23,2024-01-19,466.67,27612,0,27612
1490,TSLA  ,2023-02-23,2024-01-19,475.0,5074,195,5269
1491,TSLA  ,2023-02-23,2024-01-19,483.33,1583,20,1603
1492,TSLA  ,2023-02-23,2024-01-19,491.67,2151,0,2151
1493,TSLA  ,2023-02-23,2024-01-19,500.0,36378,0,36378
1494,TSLA  ,2023-02-23,2024-01-19,516.67,4839,0,4839
1495,TSLA  ,2023-02-23,2024-01-19,533.33,20825,0,20825
1496,TSLA  ,2023-02-23,2024-01-19,550.0,16154,0,16154
1497,TSLA  ,2023-02-23,2024-01-19,558.33,1202,0,1202
1498,TSLA  ,2023-02-23,2024-01-19,566.67,11406,0,11406
1499,TSLA  ,2023-02-23,2024-01-19,575.0,13823,0,13823
1500,TSLA  ,2023-02-23,2024-01-19,583.33,13823,0,13823
1501,TSLA  ,2023-02-23,2024-01-19,591.67,2279,0,2279
1502,TSLA  ,2023-02-23,2024-01-19,600.0,18644,0,18644
1503,TSLA  ,2023-02-23,2024-01-19,608.33,2281,0,2281
1504,TSLA  ,2023-02-23,2024-01-19,616.67,11852,0,11852
1505,TSLA  ,2023-02-23,2024-01-19,625.0,2413,0,2413
1506,TSLA  ,2023-02-23,2024-01-19,633.33,5739,0,5739
1507,TSLA  ,2023-02-23,2024-01-19,641.67,929,0,929
1508,TSLA  ,2023-02-23,2024-01-19,650.0,3209,0,3209
1509,TSLA  ,2023-02-23,2024-01-19,666.67,40730,0,40730
1510,TSLA  ,2023-02-23,2024-01-19,675.0,4363,0,4363
1511,TSLA  ,2023-02-23,2024-01-19,683.33,7130,0,7130
1512,TSLA  ,2023-02-23,2024-01-19,691.67,1564,0,1564
1513,TSLA  ,2023-02-23,2024-01-19,700.0,5357,0,5357
1514,TSLA  ,2023-02-23,2024-01-19,708.33,762,0,762
1515,TSLA  ,2023-02-23,2024-01-19,716.67,6080,0,6080
1516,TSLA  ,2023-02-23,2024-01-19,725.0,2753,3,2756
1517,TSLA  ,2023-02-23,2024-01-19,733.33,3398,0,3398
1518,TSLA  ,2023-02-23,2024-01-19,741.67,805,0,805
1519,TSLA  ,2023-02-23,2024-01-19,750.0,2379,0,2379
1520,TSLA  ,2023-02-23,2024-01-19,758.33,932,0,932
1521,TSLA  ,2023-02-23,2024-01-19,766.67,2114,0,2114
1522,TSLA  ,2023-02-23,2024-01-19,775.0,2836,0,2836
1523,TSLA  ,2023-02-23,2024-01-19,783.33,743,0,743
1524,TSLA  ,2023-02-23,2024-01-19,791.67,3183,0,3183
1525,TSLA  ,2023-02-23,2024-01-19,800.0,13908,0,13908
1526,TSLA  ,2023-02-23,2024-01-19,808.33,3965,0,3965
1527,TSLA  ,2023-02-23,2024-01-19,816.67,5822,0,5822
1528,TSLA  ,2023-02-23,2024-01-19,825.0,77914,0,77914
1529,TSLA  ,2023-02-23,2024-03-15,1.67,106,1895,2001
1530,TSLA  ,2023-02-23,2024-03-15,3.33,22,779,801
1531,TSLA  ,2023-02-23,2024-03-15,5.0,64,905,969
1532,TSLA  ,2023-02-23,2024-03-15,6.67,6,93,99
1533,TSLA  ,2023-02-23,2024-03-15,8.33,16,139,155
1534,TSLA  ,2023-02-23,2024-03-15,10.0,17,345,362
1535,TSLA  ,2023-02-23,2024-03-15,11.67,11,420,431
1536,TSLA  ,2023-02-23,2024-03-15,13.33,21,55,76
1537,TSLA  ,2023-02-23,2024-03-15,15.0,24,423,447
1538,TSLA  ,2023-02-23,2024-03-15,16.67,124,259,383
1539,TSLA  ,2023-02-23,2024-03-15,33.33,809,2003,2812
1540,TSLA  ,2023-02-23,2024-03-15,50.0,452,5792,6244
1541,TSLA  ,2023-02-23,2024-03-15,55.0,30,303,333
1542,TSLA  ,2023-02-23,2024-03-15,60.0,45,858,903
1543,TSLA  ,2023-02-23,2024-03-15,65.0,31,828,859
1544,TSLA  ,2023-02-23,2024-03-15,66.67,2037,1010,3047
1545,TSLA  ,2023-02-23,2024-03-15,70.0,50,238,288
1546,TSLA  ,2023-02-23,2024-03-15,75.0,20,446,466
1547,TSLA  ,2023-02-23,2024-03-15,80.0,191,558,749
1548,TSLA  ,2023-02-23,2024-03-15,83.33,999,4510,5509
1549,TSLA  ,2023-02-23,2024-03-15,85.0,291,1100,1391
1550,TSLA  ,2023-02-23,2024-03-15,90.0,768,781,1549
1551,TSLA  ,2023-02-23,2024-03-15,95.0,1561,411,1972
1552,TSLA  ,2023-02-23,2024-03-15,100.0,3359,3189,6548
1553,TSLA  ,2023-02-23,2024-03-15,105.0,819,729,1548
1554,TSLA  ,2023-02-23,2024-03-15,110.0,913,2548,3461
1555,TSLA  ,2023-02-23,2024-03-15,115.0,2046,211,2257
1556,TSLA  ,2023-02-23,2024-03-15,116.67,609,1050,1659
1557,TSLA  ,2023-02-23,2024-03-15,120.0,327,719,1046
1558,TSLA  ,2023-02-23,2024-03-15,125.0,793,742,1535
1559,TSLA  ,2023-02-23,2024-03-15,130.0,1556,543,2099
1560,TSLA  ,2023-02-23,2024-03-15,133.33,590,5742,6332
1561,TSLA  ,2023-02-23,2024-03-15,135.0,206,307,513
1562,TSLA  ,2023-02-23,2024-03-15,140.0,224,277,501
1563,TSLA  ,2023-02-23,2024-03-15,141.67,567,348,915
1564,TSLA  ,2023-02-23,2024-03-15,145.0,300,407,707
1565,TSLA  ,2023-02-23,2024-03-15,150.0,1299,4452,5751
1566,TSLA  ,2023-02-23,2024-03-15,155.0,92,210,302
1567,TSLA  ,2023-02-23,2024-03-15,158.33,174,583,757
1568,TSLA  ,2023-02-23,2024-03-15,160.0,244,4374,4618
1569,TSLA  ,2023-02-23,2024-03-15,165.0,155,3893,4048
1570,TSLA  ,2023-02-23,2024-03-15,166.67,587,1181,1768
1571,TSLA  ,2023-02-23,2024-03-15,170.0,290,8894,9184
1572,TSLA  ,2023-02-23,2024-03-15,175.0,745,1943,2688
1573,TSLA  ,2023-02-23,2024-03-15,180.0,282,649,931
1574,TSLA  ,2023-02-23,2024-03-15,183.33,514,1196,1710
1575,TSLA  ,2023-02-23,2024-03-15,185.0,252,260,512
1576,TSLA  ,2023-02-23,2024-03-15,190.0,1209,278,1487
1577,TSLA  ,2023-02-23,2024-03-15,191.67,1476,1393,2869
1578,TSLA  ,2023-02-23,2024-03-15,195.0,548,143,691
1579,TSLA  ,2023-02-23,2024-03-15,200.0,5353,4731,10084
1580,TSLA  ,2023-02-23,2024-03-15,208.33,1199,728,1927
1581,TSLA  ,2023-02-23,2024-03-15,210.0,505,199,704
1582,TSLA  ,2023-02-23,2024-03-15,216.67,1499,841,2340
1583,TSLA  ,2023-02-23,2024-03-15,220.0,526,65,591
1584,TSLA  ,2023-02-23,2024-03-15,225.0,2082,2421,4503
1585,TSLA  ,2023-02-23,2024-03-15,230.0,284,82,366
1586,TSLA  ,2023-02-23,2024-03-15,233.33,1627,996,2623
1587,TSLA  ,2023-02-23,2024-03-15,240.0,185,51,236
1588,TSLA  ,2023-02-23,2024-03-15,241.67,1131,955,2086
1589,TSLA  ,2023-02-23,2024-03-15,250.0,2160,1406,3566
1590,TSLA  ,2023-02-23,2024-03-15,258.33,4133,1036,5169
1591,TSLA  ,2023-02-23,2024-03-15,260.0,586,95,681
1592,TSLA  ,2023-02-23,2024-03-15,266.67,4467,810,5277
1593,TSLA  ,2023-02-23,2024-03-15,270.0,309,3,312
1594,TSLA  ,2023-02-23,2024-03-15,275.0,8970,1011,9981
1595,TSLA  ,2023-02-23,2024-03-15,280.0,152,89,241
1596,TSLA  ,2023-02-23,2024-03-15,283.33,1140,709,1849
1597,TSLA  ,2023-02-23,2024-03-15,290.0,14,4,18
1598,TSLA  ,2023-02-23,2024-03-15,291.67,1289,129,1418
1599,TSLA  ,2023-02-23,2024-03-15,300.0,4870,707,5577
1600,TSLA  ,2023-02-23,2024-03-15,308.33,397,41,438
1601,TSLA  ,2023-02-23,2024-03-15,310.0,23,0,23
1602,TSLA  ,2023-02-23,2024-03-15,316.67,926,391,1317
1603,TSLA  ,2023-02-23,2024-03-15,325.0,1580,17,1597
1604,TSLA  ,2023-02-23,2024-03-15,333.33,1094,27,1121
1605,TSLA  ,2023-02-23,2024-03-15,341.67,294,45,339
1606,TSLA  ,2023-02-23,2024-03-15,350.0,846,82,928
1607,TSLA  ,2023-02-23,2024-03-15,358.33,464,69,533
1608,TSLA  ,2023-02-23,2024-03-15,366.67,535,250,785
1609,TSLA  ,2023-02-23,2024-03-15,375.0,829,2,831
1610,TSLA  ,2023-02-23,2024-03-15,383.33,195,1338,1533
1611,TSLA  ,2023-02-23,2024-03-15,391.67,318,8,326
1612,TSLA  ,2023-02-23,2024-03-15,400.0,1290,221,1511
1613,TSLA  ,2023-02-23,2024-03-15,408.33,640,53,693
1614,TSLA  ,2023-02-23,2024-03-15,416.67,367,366,733
1615,TSLA  ,2023-02-23,2024-03-15,425.0,891,48,939
1616,TSLA  ,2023-02-23,2024-03-15,433.33,566,0,566
1617,TSLA  ,2023-02-23,2024-03-15,441.67,171,0,171
1618,TSLA  ,2023-02-23,2024-03-15,450.0,1476,0,1476
1619,TSLA  ,2023-02-23,2024-03-15,458.33,245,2,247
1620,TSLA  ,2023-02-23,2024-03-15,466.67,823,0,823
1621,TSLA  ,2023-02-23,2024-03-15,475.0,432,0,432
1622,TSLA  ,2023-02-23,2024-03-15,483.33,487,0,487
1623,TSLA  ,2023-02-23,2024-03-15,491.67,321,0,321
1624,TSLA  ,2023-02-23,2024-03-15,500.0,2980,0,2980
1625,TSLA  ,2023-02-23,2024-03-15,508.33,227,0,227
1626,TSLA  ,2023-02-23,2024-03-15,516.67,692,0,692
1627,TSLA  ,2023-02-23,2024-03-15,525.0,118,0,118
1628,TSLA  ,2023-02-23,2024-03-15,533.33,221,0,221
1629,TSLA  ,2023-02-23,2024-03-15,541.67,165,0,165
1630,TSLA  ,2023-02-23,2024-03-15,550.0,490,0,490
1631,TSLA  ,2023-02-23,2024-03-15,558.33,264,0,264
1632,TSLA  ,2023-02-23,2024-03-15,566.67,386,0,386
1633,TSLA  ,2023-02-23,2024-03-15,575.0,670,0,670
1634,TSLA  ,2023-02-23,2024-03-15,583.33,490,0,490
1635,TSLA  ,2023-02-23,2024-03-15,600.0,3923,0,3923
1636,TSLA  ,2023-02-23,2024-06-21,1.67,629,16460,17089
1637,TSLA  ,2023-02-23,2024-06-21,3.33,149,3280,3429
1638,TSLA  ,2023-02-23,2024-06-21,5.0,20,1519,1539
1639,TSLA  ,2023-02-23,2024-06-21,6.67,219,1218,1437
1640,TSLA  ,2023-02-23,2024-06-21,8.33,121,368,489
1641,TSLA  ,2023-02-23,2024-06-21,10.0,275,1827,2102
1642,TSLA  ,2023-02-23,2024-06-21,11.67,540,336,876
1643,TSLA  ,2023-02-23,2024-06-21,13.33,36,217,253
1644,TSLA  ,2023-02-23,2024-06-21,16.67,1407,3649,5056
1645,TSLA  ,2023-02-23,2024-06-21,33.33,7801,5347,13148
1646,TSLA  ,2023-02-23,2024-06-21,50.0,1903,4882,6785
1647,TSLA  ,2023-02-23,2024-06-21,55.0,6,383,389
1648,TSLA  ,2023-02-23,2024-06-21,60.0,57,511,568
1649,TSLA  ,2023-02-23,2024-06-21,65.0,114,2124,2238
1650,TSLA  ,2023-02-23,2024-06-21,66.67,1877,4359,6236
1651,TSLA  ,2023-02-23,2024-06-21,70.0,48,270,318
1652,TSLA  ,2023-02-23,2024-06-21,75.0,74,195,269
1653,TSLA  ,2023-02-23,2024-06-21,80.0,113,1475,1588
1654,TSLA  ,2023-02-23,2024-06-21,83.33,30601,4179,34780
1655,TSLA  ,2023-02-23,2024-06-21,85.0,60,862,922
1656,TSLA  ,2023-02-23,2024-06-21,90.0,530,1185,1715
1657,TSLA  ,2023-02-23,2024-06-21,95.0,363,428,791
1658,TSLA  ,2023-02-23,2024-06-21,100.0,5366,9905,15271
1659,TSLA  ,2023-02-23,2024-06-21,105.0,798,910,1708
1660,TSLA  ,2023-02-23,2024-06-21,110.0,494,2231,2725
1661,TSLA  ,2023-02-23,2024-06-21,115.0,414,254,668
1662,TSLA  ,2023-02-23,2024-06-21,116.67,2471,1020,3491
1663,TSLA  ,2023-02-23,2024-06-21,120.0,572,1241,1813
1664,TSLA  ,2023-02-23,2024-06-21,123.33,643,3518,4161
1665,TSLA  ,2023-02-23,2024-06-21,125.0,166,2237,2403
1666,TSLA  ,2023-02-23,2024-06-21,126.67,668,1259,1927
1667,TSLA  ,2023-02-23,2024-06-21,130.0,840,1826,2666
1668,TSLA  ,2023-02-23,2024-06-21,133.33,1903,2857,4760
1669,TSLA  ,2023-02-23,2024-06-21,135.0,60,383,443
1670,TSLA  ,2023-02-23,2024-06-21,136.67,427,1837,2264
1671,TSLA  ,2023-02-23,2024-06-21,140.0,1502,2594,4096
1672,TSLA  ,2023-02-23,2024-06-21,143.33,1405,1654,3059
1673,TSLA  ,2023-02-23,2024-06-21,145.0,618,218,836
1674,TSLA  ,2023-02-23,2024-06-21,146.67,1652,563,2215
1675,TSLA  ,2023-02-23,2024-06-21,150.0,4385,9852,14237
1676,TSLA  ,2023-02-23,2024-06-21,153.33,296,853,1149
1677,TSLA  ,2023-02-23,2024-06-21,155.0,84,446,530
1678,TSLA  ,2023-02-23,2024-06-21,156.67,384,272,656
1679,TSLA  ,2023-02-23,2024-06-21,160.0,881,2743,3624
1680,TSLA  ,2023-02-23,2024-06-21,163.33,187,1441,1628
1681,TSLA  ,2023-02-23,2024-06-21,165.0,347,897,1244
1682,TSLA  ,2023-02-23,2024-06-21,166.67,1724,5527,7251
1683,TSLA  ,2023-02-23,2024-06-21,170.0,312,881,1193
1684,TSLA  ,2023-02-23,2024-06-21,173.33,594,5867,6461
1685,TSLA  ,2023-02-23,2024-06-21,175.0,939,397,1336
1686,TSLA  ,2023-02-23,2024-06-21,180.0,1365,6672,8037
1687,TSLA  ,2023-02-23,2024-06-21,183.33,931,3710,4641
1688,TSLA  ,2023-02-23,2024-06-21,185.0,296,243,539
1689,TSLA  ,2023-02-23,2024-06-21,186.67,1322,1656,2978
1690,TSLA  ,2023-02-23,2024-06-21,190.0,335,122,457
1691,TSLA  ,2023-02-23,2024-06-21,193.33,1027,4332,5359
1692,TSLA  ,2023-02-23,2024-06-21,195.0,233,914,1147
1693,TSLA  ,2023-02-23,2024-06-21,200.0,4882,10055,14937
1694,TSLA  ,2023-02-23,2024-06-21,206.67,1123,2953,4076
1695,TSLA  ,2023-02-23,2024-06-21,210.0,419,139,558
1696,TSLA  ,2023-02-23,2024-06-21,213.33,838,1202,2040
1697,TSLA  ,2023-02-23,2024-06-21,216.67,1657,5370,7027
1698,TSLA  ,2023-02-23,2024-06-21,220.0,2544,2408,4952
1699,TSLA  ,2023-02-23,2024-06-21,226.67,2601,3524,6125
1700,TSLA  ,2023-02-23,2024-06-21,230.0,572,149,721
1701,TSLA  ,2023-02-23,2024-06-21,233.33,6651,7245,13896
1702,TSLA  ,2023-02-23,2024-06-21,240.0,2140,4867,7007
1703,TSLA  ,2023-02-23,2024-06-21,246.67,2259,1234,3493
1704,TSLA  ,2023-02-23,2024-06-21,250.0,5563,3591,9154
1705,TSLA  ,2023-02-23,2024-06-21,253.33,1312,852,2164
1706,TSLA  ,2023-02-23,2024-06-21,260.0,2077,950,3027
1707,TSLA  ,2023-02-23,2024-06-21,266.67,10110,3339,13449
1708,TSLA  ,2023-02-23,2024-06-21,270.0,1455,1885,3340
1709,TSLA  ,2023-02-23,2024-06-21,273.33,1257,792,2049
1710,TSLA  ,2023-02-23,2024-06-21,276.67,1023,809,1832
1711,TSLA  ,2023-02-23,2024-06-21,280.0,1242,1601,2843
1712,TSLA  ,2023-02-23,2024-06-21,283.33,3609,1362,4971
1713,TSLA  ,2023-02-23,2024-06-21,286.67,1004,766,1770
1714,TSLA  ,2023-02-23,2024-06-21,290.0,2339,1161,3500
1715,TSLA  ,2023-02-23,2024-06-21,293.33,1112,970,2082
1716,TSLA  ,2023-02-23,2024-06-21,296.67,1025,361,1386
1717,TSLA  ,2023-02-23,2024-06-21,300.0,9305,843,10148
1718,TSLA  ,2023-02-23,2024-06-21,303.33,1422,687,2109
1719,TSLA  ,2023-02-23,2024-06-21,306.67,1512,269,1781
1720,TSLA  ,2023-02-23,2024-06-21,310.0,1824,519,2343
1721,TSLA  ,2023-02-23,2024-06-21,313.33,1249,722,1971
1722,TSLA  ,2023-02-23,2024-06-21,316.67,2377,59,2436
1723,TSLA  ,2023-02-23,2024-06-21,320.0,696,664,1360
1724,TSLA  ,2023-02-23,2024-06-21,323.33,457,309,766
1725,TSLA  ,2023-02-23,2024-06-21,326.67,573,315,888
1726,TSLA  ,2023-02-23,2024-06-21,330.0,2725,127,2852
1727,TSLA  ,2023-02-23,2024-06-21,333.33,7542,1108,8650
1728,TSLA  ,2023-02-23,2024-06-21,336.67,2328,248,2576
1729,TSLA  ,2023-02-23,2024-06-21,340.0,781,121,902
1730,TSLA  ,2023-02-23,2024-06-21,343.33,1223,146,1369
1731,TSLA  ,2023-02-23,2024-06-21,346.67,399,73,472
1732,TSLA  ,2023-02-23,2024-06-21,350.0,3459,71,3530
1733,TSLA  ,2023-02-23,2024-06-21,353.33,207,70,277
1734,TSLA  ,2023-02-23,2024-06-21,356.67,479,53,532
1735,TSLA  ,2023-02-23,2024-06-21,360.0,2635,33,2668
1736,TSLA  ,2023-02-23,2024-06-21,363.33,357,0,357
1737,TSLA  ,2023-02-23,2024-06-21,366.67,4711,11,4722
1738,TSLA  ,2023-02-23,2024-06-21,370.0,3061,9,3070
1739,TSLA  ,2023-02-23,2024-06-21,373.33,559,115,674
1740,TSLA  ,2023-02-23,2024-06-21,376.67,798,0,798
1741,TSLA  ,2023-02-23,2024-06-21,380.0,1067,15,1082
1742,TSLA  ,2023-02-23,2024-06-21,383.33,1014,12,1026
1743,TSLA  ,2023-02-23,2024-06-21,386.67,302,7,309
1744,TSLA  ,2023-02-23,2024-06-21,390.0,435,3,438
1745,TSLA  ,2023-02-23,2024-06-21,393.33,920,2,922
1746,TSLA  ,2023-02-23,2024-06-21,396.67,800,2,802
1747,TSLA  ,2023-02-23,2024-06-21,400.0,38651,35,38686
1748,TSLA  ,2023-02-23,2024-06-21,416.67,3154,1,3155
1749,TSLA  ,2023-02-23,2024-06-21,433.33,3267,0,3267
1750,TSLA  ,2023-02-23,2024-06-21,450.0,3058,0,3058
1751,TSLA  ,2023-02-23,2024-06-21,466.67,5445,0,5445
1752,TSLA  ,2023-02-23,2024-06-21,483.33,1176,0,1176
1753,TSLA  ,2023-02-23,2024-06-21,500.0,11161,0,11161
1754,TSLA  ,2023-02-23,2024-06-21,516.67,2092,0,2092
1755,TSLA  ,2023-02-23,2024-06-21,533.33,3103,0,3103
1756,TSLA  ,2023-02-23,2024-06-21,550.0,2629,0,2629
1757,TSLA  ,2023-02-23,2024-06-21,566.67,1017,0,1017
1758,TSLA  ,2023-02-23,2024-06-21,583.33,1038,0,1038
1759,TSLA  ,2023-02-23,2024-06-21,600.0,17310,0,17310
1760,TSLA  ,2023-02-23,2024-06-21,616.67,14009,0,14009
1761,TSLA  ,2023-02-23,2024-06-21,633.33,4532,0,4532
1762,TSLA  ,2023-02-23,2024-06-21,650.0,620,0,620
1763,TSLA  ,2023-02-23,2024-06-21,666.67,6409,0,6409
1764,TSLA  ,2023-02-23,2024-06-21,683.33,1687,0,1687
1765,TSLA  ,2023-02-23,2024-06-21,700.0,3974,0,3974
1766,TSLA  ,2023-02-23,2024-06-21,716.67,902,0,902
1767,TSLA  ,2023-02-23,2024-06-21,733.33,2193,0,2193
1768,TSLA  ,2023-02-23,2024-06-21,750.0,5821,0,5821
1769,TSLA  ,2023-02-23,2024-06-21,758.33,13484,0,13484
1770,TSLA  ,2023-02-23,2024-09-20,50.0,45,917,962
1771,TSLA  ,2023-02-23,2024-09-20,55.0,29,175,204
1772,TSLA  ,2023-02-23,2024-09-20,60.0,11,146,157
1773,TSLA  ,2023-02-23,2024-09-20,65.0,39,79,118
1774,TSLA  ,2023-02-23,2024-09-20,70.0,11,126,137
1775,TSLA  ,2023-02-23,2024-09-20,75.0,10,2323,2333
1776,TSLA  ,2023-02-23,2024-09-20,80.0,66,143,209
1777,TSLA  ,2023-02-23,2024-09-20,85.0,987,454,1441
1778,TSLA  ,2023-02-23,2024-09-20,90.0,47,196,243
1779,TSLA  ,2023-02-23,2024-09-20,95.0,24,443,467
1780,TSLA  ,2023-02-23,2024-09-20,100.0,387,2229,2616
1781,TSLA  ,2023-02-23,2024-09-20,105.0,188,726,914
1782,TSLA  ,2023-02-23,2024-09-20,110.0,161,1098,1259
1783,TSLA  ,2023-02-23,2024-09-20,115.0,563,604,1167
1784,TSLA  ,2023-02-23,2024-09-20,120.0,717,558,1275
1785,TSLA  ,2023-02-23,2024-09-20,125.0,321,1201,1522
1786,TSLA  ,2023-02-23,2024-09-20,130.0,636,840,1476
1787,TSLA  ,2023-02-23,2024-09-20,135.0,580,282,862
1788,TSLA  ,2023-02-23,2024-09-20,140.0,1094,354,1448
1789,TSLA  ,2023-02-23,2024-09-20,145.0,1293,355,1648
1790,TSLA  ,2023-02-23,2024-09-20,150.0,1459,2750,4209
1791,TSLA  ,2023-02-23,2024-09-20,155.0,531,309,840
1792,TSLA  ,2023-02-23,2024-09-20,160.0,428,819,1247
1793,TSLA  ,2023-02-23,2024-09-20,165.0,277,109,386
1794,TSLA  ,2023-02-23,2024-09-20,170.0,203,305,508
1795,TSLA  ,2023-02-23,2024-09-20,175.0,236,126,362
1796,TSLA  ,2023-02-23,2024-09-20,180.0,733,106,839
1797,TSLA  ,2023-02-23,2024-09-20,185.0,835,933,1768
1798,TSLA  ,2023-02-23,2024-09-20,190.0,1608,128,1736
1799,TSLA  ,2023-02-23,2024-09-20,195.0,1422,122,1544
1800,TSLA  ,2023-02-23,2024-09-20,200.0,1781,1443,3224
1801,TSLA  ,2023-02-23,2024-09-20,210.0,771,269,1040
1802,TSLA  ,2023-02-23,2024-09-20,220.0,1398,412,1810
1803,TSLA  ,2023-02-23,2024-09-20,230.0,818,129,947
1804,TSLA  ,2023-02-23,2024-09-20,240.0,483,306,789
1805,TSLA  ,2023-02-23,2024-09-20,250.0,890,366,1256
1806,TSLA  ,2023-02-23,2024-09-20,260.0,906,70,976
1807,TSLA  ,2023-02-23,2024-09-20,270.0,626,534,1160
1808,TSLA  ,2023-02-23,2024-09-20,280.0,330,579,909
1809,TSLA  ,2023-02-23,2024-09-20,290.0,469,2811,3280
1810,TSLA  ,2023-02-23,2024-09-20,300.0,1083,1250,2333
1811,TSLA  ,2023-02-23,2024-09-20,310.0,179,788,967
1812,TSLA  ,2023-02-23,2024-09-20,320.0,112,261,373
1813,TSLA  ,2023-02-23,2024-09-20,330.0,108,118,226
1814,TSLA  ,2023-02-23,2024-09-20,340.0,705,141,846
1815,TSLA  ,2023-02-23,2024-09-20,350.0,1443,162,1605
1816,TSLA  ,2023-02-23,2024-09-20,360.0,58,85,143
1817,TSLA  ,2023-02-23,2024-09-20,370.0,80,24,104
1818,TSLA  ,2023-02-23,2024-09-20,380.0,94,4,98
1819,TSLA  ,2023-02-23,2024-09-20,390.0,257,17,274
1820,TSLA  ,2023-02-23,2024-09-20,400.0,7,25,32
1821,TSLA  ,2023-02-23,2024-09-20,410.0,55,40,95
1822,TSLA  ,2023-02-23,2025-01-17,5.0,659,11809,12468
1823,TSLA  ,2023-02-23,2025-01-17,10.0,139,932,1071
1824,TSLA  ,2023-02-23,2025-01-17,15.0,29,869,898
1825,TSLA  ,2023-02-23,2025-01-17,20.0,385,5809,6194
1826,TSLA  ,2023-02-23,2025-01-17,25.0,103,2616,2719
1827,TSLA  ,2023-02-23,2025-01-17,30.0,13821,16566,30387
1828,TSLA  ,2023-02-23,2025-01-17,35.0,265,1157,1422
1829,TSLA  ,2023-02-23,2025-01-17,40.0,14708,15787,30495
1830,TSLA  ,2023-02-23,2025-01-17,45.0,2979,3201,6180
1831,TSLA  ,2023-02-23,2025-01-17,50.0,2717,8577,11294
1832,TSLA  ,2023-02-23,2025-01-17,55.0,2003,4257,6260
1833,TSLA  ,2023-02-23,2025-01-17,60.0,592,1959,2551
1834,TSLA  ,2023-02-23,2025-01-17,65.0,1639,1573,3212
1835,TSLA  ,2023-02-23,2025-01-17,70.0,2496,2229,4725
1836,TSLA  ,2023-02-23,2025-01-17,75.0,177,4294,4471
1837,TSLA  ,2023-02-23,2025-01-17,80.0,1303,1872,3175
1838,TSLA  ,2023-02-23,2025-01-17,85.0,1825,1612,3437
1839,TSLA  ,2023-02-23,2025-01-17,90.0,1066,5531,6597
1840,TSLA  ,2023-02-23,2025-01-17,95.0,141,504,645
1841,TSLA  ,2023-02-23,2025-01-17,100.0,5365,17930,23295
1842,TSLA  ,2023-02-23,2025-01-17,105.0,323,1674,1997
1843,TSLA  ,2023-02-23,2025-01-17,110.0,5448,7107,12555
1844,TSLA  ,2023-02-23,2025-01-17,115.0,3213,3251,6464
1845,TSLA  ,2023-02-23,2025-01-17,120.0,8412,6113,14525
1846,TSLA  ,2023-02-23,2025-01-17,125.0,2138,1166,3304
1847,TSLA  ,2023-02-23,2025-01-17,130.0,5622,7217,12839
1848,TSLA  ,2023-02-23,2025-01-17,135.0,5700,720,6420
1849,TSLA  ,2023-02-23,2025-01-17,140.0,8628,4794,13422
1850,TSLA  ,2023-02-23,2025-01-17,145.0,768,684,1452
1851,TSLA  ,2023-02-23,2025-01-17,150.0,11878,12409,24287
1852,TSLA  ,2023-02-23,2025-01-17,155.0,418,501,919
1853,TSLA  ,2023-02-23,2025-01-17,160.0,4573,5532,10105
1854,TSLA  ,2023-02-23,2025-01-17,165.0,262,945,1207
1855,TSLA  ,2023-02-23,2025-01-17,170.0,35372,10347,45719
1856,TSLA  ,2023-02-23,2025-01-17,175.0,33429,4522,37951
1857,TSLA  ,2023-02-23,2025-01-17,180.0,3674,8099,11773
1858,TSLA  ,2023-02-23,2025-01-17,185.0,7124,4534,11658
1859,TSLA  ,2023-02-23,2025-01-17,190.0,5626,4777,10403
1860,TSLA  ,2023-02-23,2025-01-17,195.0,3233,1746,4979
1861,TSLA  ,2023-02-23,2025-01-17,200.0,29440,15169,44609
1862,TSLA  ,2023-02-23,2025-01-17,210.0,5318,2762,8080
1863,TSLA  ,2023-02-23,2025-01-17,220.0,2978,4099,7077
1864,TSLA  ,2023-02-23,2025-01-17,230.0,4214,3305,7519
1865,TSLA  ,2023-02-23,2025-01-17,240.0,4751,4835,9586
1866,TSLA  ,2023-02-23,2025-01-17,250.0,11886,5223,17109
1867,TSLA  ,2023-02-23,2025-01-17,260.0,5617,1944,7561
1868,TSLA  ,2023-02-23,2025-01-17,270.0,3112,1337,4449
1869,TSLA  ,2023-02-23,2025-01-17,280.0,2253,3357,5610
1870,TSLA  ,2023-02-23,2025-01-17,290.0,3441,2808,6249
1871,TSLA  ,2023-02-23,2025-01-17,300.0,30543,3099,33642
1872,TSLA  ,2023-02-23,2025-01-17,310.0,4379,711,5090
1873,TSLA  ,2023-02-23,2025-01-17,320.0,2147,794,2941
1874,TSLA  ,2023-02-23,2025-01-17,330.0,2298,1019,3317
1875,TSLA  ,2023-02-23,2025-01-17,340.0,1404,464,1868
1876,TSLA  ,2023-02-23,2025-01-17,350.0,7178,925,8103
1877,TSLA  ,2023-02-23,2025-01-17,360.0,1943,294,2237
1878,TSLA  ,2023-02-23,2025-01-17,370.0,1808,325,2133
1879,TSLA  ,2023-02-23,2025-01-17,380.0,1377,212,1589
1880,TSLA  ,2023-02-23,2025-01-17,390.0,1722,96,1818
1881,TSLA  ,2023-02-23,2025-01-17,400.0,19779,407,20186
1882,TSLA  ,2023-02-23,2025-01-17,410.0,4434,70,4504
1883,TSLA  ,2023-02-23,2025-01-17,420.0,4187,34,4221
1884,TSLA  ,2023-02-23,2025-01-17,430.0,617,3,620
1885,TSLA  ,2023-02-23,2025-01-17,440.0,1604,10,1614
1886,TSLA  ,2023-02-23,2025-01-17,450.0,5178,8,5186
1887,TSLA  ,2023-02-23,2025-01-17,460.0,1012,14,1026
1888,TSLA  ,2023-02-23,2025-01-17,470.0,1553,67,1620
1889,TSLA  ,2023-02-23,2025-01-17,480.0,1265,1,1266
1890,TSLA  ,2023-02-23,2025-01-17,490.0,798,0,798
1891,TSLA  ,2023-02-23,2025-01-17,500.0,11621,20,11641
1892,TSLA  ,2023-02-23,2025-01-17,510.0,1596,256,1852
1893,TSLA  ,2023-02-23,2025-01-17,520.0,8347,2,8349
1894,TSLA  ,2023-02-23,2025-01-17,530.0,605,0,605
1895,TSLA  ,2023-02-23,2025-01-17,540.0,647,0,647
1896,TSLA  ,2023-02-23,2025-01-17,550.0,3131,1,3132
1897,TSLA  ,2023-02-23,2025-01-17,560.0,632,1,633
1898,TSLA  ,2023-02-23,2025-01-17,570.0,678,0,678
1899,TSLA  ,2023-02-23,2025-01-17,580.0,885,0,885
1900,TSLA  ,2023-02-23,2025-01-17,590.0,759,0,759
1901,TSLA  ,2023-02-23,2025-01-17,600.0,15836,0,15836
1902,TSLA  ,2023-02-23,2025-01-17,610.0,18065,0,18065
1903,TSLA  ,2023-02-23,2025-06-20,5.0,232,1729,1961
1904,TSLA  ,2023-02-23,2025-06-20,10.0,5,66,71
1905,TSLA  ,2023-02-23,2025-06-20,15.0,8,5857,5865
1906,TSLA  ,2023-02-23,2025-06-20,20.0,59,438,497
1907,TSLA  ,2023-02-23,2025-06-20,25.0,9,170,179
1908,TSLA  ,2023-02-23,2025-06-20,30.0,86,386,472
1909,TSLA  ,2023-02-23,2025-06-20,35.0,11,196,207
1910,TSLA  ,2023-02-23,2025-06-20,40.0,10,421,431
1911,TSLA  ,2023-02-23,2025-06-20,45.0,17,53,70
1912,TSLA  ,2023-02-23,2025-06-20,50.0,162,752,914
1913,TSLA  ,2023-02-23,2025-06-20,55.0,13,54,67
1914,TSLA  ,2023-02-23,2025-06-20,60.0,15,398,413
1915,TSLA  ,2023-02-23,2025-06-20,65.0,18,576,594
1916,TSLA  ,2023-02-23,2025-06-20,70.0,179,130,309
1917,TSLA  ,2023-02-23,2025-06-20,75.0,134,1299,1433
1918,TSLA  ,2023-02-23,2025-06-20,80.0,808,741,1549
1919,TSLA  ,2023-02-23,2025-06-20,85.0,351,235,586
1920,TSLA  ,2023-02-23,2025-06-20,90.0,10317,543,10860
1921,TSLA  ,2023-02-23,2025-06-20,95.0,46517,561,47078
1922,TSLA  ,2023-02-23,2025-06-20,100.0,1035,4746,5781
1923,TSLA  ,2023-02-23,2025-06-20,105.0,165,495,660
1924,TSLA  ,2023-02-23,2025-06-20,110.0,307,1606,1913
1925,TSLA  ,2023-02-23,2025-06-20,115.0,434,371,805
1926,TSLA  ,2023-02-23,2025-06-20,120.0,555,1045,1600
1927,TSLA  ,2023-02-23,2025-06-20,125.0,482,379,861
1928,TSLA  ,2023-02-23,2025-06-20,130.0,2601,1588,4189
1929,TSLA  ,2023-02-23,2025-06-20,135.0,4672,273,4945
1930,TSLA  ,2023-02-23,2025-06-20,140.0,961,1864,2825
1931,TSLA  ,2023-02-23,2025-06-20,145.0,406,491,897
1932,TSLA  ,2023-02-23,2025-06-20,150.0,1423,1439,2862
1933,TSLA  ,2023-02-23,2025-06-20,155.0,404,206,610
1934,TSLA  ,2023-02-23,2025-06-20,160.0,2169,850,3019
1935,TSLA  ,2023-02-23,2025-06-20,165.0,929,360,1289
1936,TSLA  ,2023-02-23,2025-06-20,170.0,2807,691,3498
1937,TSLA  ,2023-02-23,2025-06-20,175.0,818,1233,2051
1938,TSLA  ,2023-02-23,2025-06-20,180.0,667,459,1126
1939,TSLA  ,2023-02-23,2025-06-20,185.0,2556,202,2758
1940,TSLA  ,2023-02-23,2025-06-20,190.0,538,254,792
1941,TSLA  ,2023-02-23,2025-06-20,195.0,327,280,607
1942,TSLA  ,2023-02-23,2025-06-20,200.0,4551,3401,7952
1943,TSLA  ,2023-02-23,2025-06-20,205.0,345,230,575
1944,TSLA  ,2023-02-23,2025-06-20,210.0,501,212,713
1945,TSLA  ,2023-02-23,2025-06-20,215.0,250,93,343
1946,TSLA  ,2023-02-23,2025-06-20,220.0,744,130,874
1947,TSLA  ,2023-02-23,2025-06-20,225.0,652,190,842
1948,TSLA  ,2023-02-23,2025-06-20,230.0,509,94,603
1949,TSLA  ,2023-02-23,2025-06-20,235.0,368,265,633
1950,TSLA  ,2023-02-23,2025-06-20,240.0,4242,1406,5648
1951,TSLA  ,2023-02-23,2025-06-20,250.0,2512,546,3058
1952,TSLA  ,2023-02-23,2025-06-20,260.0,1067,1351,2418
1953,TSLA  ,2023-02-23,2025-06-20,270.0,654,104,758
1954,TSLA  ,2023-02-23,2025-06-20,280.0,321,249,570
1955,TSLA  ,2023-02-23,2025-06-20,290.0,272,390,662
1956,TSLA  ,2023-02-23,2025-06-20,300.0,2999,676,3675
1957,TSLA  ,2023-02-23,2025-06-20,310.0,323,210,533
1958,TSLA  ,2023-02-23,2025-06-20,320.0,994,192,1186
1959,TSLA  ,2023-02-23,2025-06-20,330.0,304,290,594
1960,TSLA  ,2023-02-23,2025-06-20,340.0,473,460,933
1961,TSLA  ,2023-02-23,2025-06-20,350.0,2690,332,3022
1962,TSLA  ,2023-02-23,2025-06-20,360.0,679,389,1068
1963,TSLA  ,2023-02-23,2025-06-20,370.0,170,434,604
1964,TSLA  ,2023-02-23,2025-06-20,380.0,118,82,200
1965,TSLA  ,2023-02-23,2025-06-20,390.0,2579,130,2709
1966,TSLA  ,2023-02-23,2025-06-20,400.0,31,53,84
1967,TSLA  ,2023-02-23,2025-06-20,410.0,172,104,276
