index,ProductSymbol,DateGen,ExpDate,Strike,Call,Put,TotalOI
0,TSLA  ,2023-02-15,2023-02-17,15.0,171,311,482
1,TSLA  ,2023-02-15,2023-02-17,20.0,35,46,81
2,TSLA  ,2023-02-15,2023-02-17,25.0,4,99,103
3,TSLA  ,2023-02-15,2023-02-17,30.0,71,2723,2794
4,TSLA  ,2023-02-15,2023-02-17,35.0,0,5414,5414
5,TSLA  ,2023-02-15,2023-02-17,40.0,163,10382,10545
6,TSLA  ,2023-02-15,2023-02-17,45.0,0,1739,1739
7,TSLA  ,2023-02-15,2023-02-17,50.0,850,17127,17977
8,TSLA  ,2023-02-15,2023-02-17,55.0,43,5311,5354
9,TSLA  ,2023-02-15,2023-02-17,60.0,318,9057,9375
10,TSLA  ,2023-02-15,2023-02-17,65.0,28,6534,6562
11,TSLA  ,2023-02-15,2023-02-17,70.0,72,54688,54760
12,TSLA  ,2023-02-15,2023-02-17,75.0,124,7673,7797
13,TSLA  ,2023-02-15,2023-02-17,80.0,188,52816,53004
14,TSLA  ,2023-02-15,2023-02-17,85.0,222,14037,14259
15,TSLA  ,2023-02-15,2023-02-17,90.0,283,17202,17485
16,TSLA  ,2023-02-15,2023-02-17,95.0,822,20294,21116
17,TSLA  ,2023-02-15,2023-02-17,100.0,3230,39629,42859
18,TSLA  ,2023-02-15,2023-02-17,105.0,20714,29916,50630
19,TSLA  ,2023-02-15,2023-02-17,110.0,3343,26875,30218
20,TSLA  ,2023-02-15,2023-02-17,115.0,15292,29288,44580
21,TSLA  ,2023-02-15,2023-02-17,118.0,297,2550,2847
22,TSLA  ,2023-02-15,2023-02-17,119.0,22,5305,5327
23,TSLA  ,2023-02-15,2023-02-17,120.0,25636,64686,90322
24,TSLA  ,2023-02-15,2023-02-17,121.0,42,2015,2057
25,TSLA  ,2023-02-15,2023-02-17,122.0,184,1281,1465
26,TSLA  ,2023-02-15,2023-02-17,123.0,126,2416,2542
27,TSLA  ,2023-02-15,2023-02-17,124.0,48,3102,3150
28,TSLA  ,2023-02-15,2023-02-17,125.0,12157,17981,30138
29,TSLA  ,2023-02-15,2023-02-17,126.0,43,1289,1332
30,TSLA  ,2023-02-15,2023-02-17,127.0,78,1563,1641
31,TSLA  ,2023-02-15,2023-02-17,128.0,52,2771,2823
32,TSLA  ,2023-02-15,2023-02-17,129.0,93,2084,2177
33,TSLA  ,2023-02-15,2023-02-17,130.0,13403,15743,29146
34,TSLA  ,2023-02-15,2023-02-17,131.0,149,1398,1547
35,TSLA  ,2023-02-15,2023-02-17,132.0,227,2476,2703
36,TSLA  ,2023-02-15,2023-02-17,133.0,71,1933,2004
37,TSLA  ,2023-02-15,2023-02-17,134.0,430,3452,3882
38,TSLA  ,2023-02-15,2023-02-17,135.0,7600,11901,19501
39,TSLA  ,2023-02-15,2023-02-17,136.0,1443,4542,5985
40,TSLA  ,2023-02-15,2023-02-17,137.0,868,1969,2837
41,TSLA  ,2023-02-15,2023-02-17,138.0,1247,4464,5711
42,TSLA  ,2023-02-15,2023-02-17,139.0,978,1778,2756
43,TSLA  ,2023-02-15,2023-02-17,140.0,7831,16581,24412
44,TSLA  ,2023-02-15,2023-02-17,141.0,681,3623,4304
45,TSLA  ,2023-02-15,2023-02-17,142.0,1006,2683,3689
46,TSLA  ,2023-02-15,2023-02-17,143.0,385,1730,2115
47,TSLA  ,2023-02-15,2023-02-17,144.0,322,2827,3149
48,TSLA  ,2023-02-15,2023-02-17,145.0,11658,24111,35769
49,TSLA  ,2023-02-15,2023-02-17,146.0,1802,3023,4825
50,TSLA  ,2023-02-15,2023-02-17,147.0,549,5672,6221
51,TSLA  ,2023-02-15,2023-02-17,148.0,241,3703,3944
52,TSLA  ,2023-02-15,2023-02-17,149.0,446,4745,5191
53,TSLA  ,2023-02-15,2023-02-17,150.0,14995,37683,52678
54,TSLA  ,2023-02-15,2023-02-17,152.5,1023,4738,5761
55,TSLA  ,2023-02-15,2023-02-17,155.0,9003,14906,23909
56,TSLA  ,2023-02-15,2023-02-17,157.5,1648,6548,8196
57,TSLA  ,2023-02-15,2023-02-17,160.0,37138,40118,77256
58,TSLA  ,2023-02-15,2023-02-17,162.5,1495,6193,7688
59,TSLA  ,2023-02-15,2023-02-17,165.0,12583,19386,31969
60,TSLA  ,2023-02-15,2023-02-17,167.5,1073,5188,6261
61,TSLA  ,2023-02-15,2023-02-17,170.0,21237,36343,57580
62,TSLA  ,2023-02-15,2023-02-17,172.5,2239,7617,9856
63,TSLA  ,2023-02-15,2023-02-17,175.0,8769,17624,26393
64,TSLA  ,2023-02-15,2023-02-17,177.5,2621,7248,9869
65,TSLA  ,2023-02-15,2023-02-17,180.0,16447,36370,52817
66,TSLA  ,2023-02-15,2023-02-17,182.5,4854,5528,10382
67,TSLA  ,2023-02-15,2023-02-17,185.0,16785,24378,41163
68,TSLA  ,2023-02-15,2023-02-17,187.5,2918,10475,13393
69,TSLA  ,2023-02-15,2023-02-17,190.0,19223,45576,64799
70,TSLA  ,2023-02-15,2023-02-17,192.5,5261,9359,14620
71,TSLA  ,2023-02-15,2023-02-17,195.0,14379,16857,31236
72,TSLA  ,2023-02-15,2023-02-17,197.5,6177,6644,12821
73,TSLA  ,2023-02-15,2023-02-17,200.0,51279,22019,73298
74,TSLA  ,2023-02-15,2023-02-17,202.5,11145,8211,19356
75,TSLA  ,2023-02-15,2023-02-17,205.0,15931,7327,23258
76,TSLA  ,2023-02-15,2023-02-17,207.5,8573,3647,12220
77,TSLA  ,2023-02-15,2023-02-17,210.0,42814,5941,48755
78,TSLA  ,2023-02-15,2023-02-17,212.5,10482,2419,12901
79,TSLA  ,2023-02-15,2023-02-17,215.0,25663,3335,28998
80,TSLA  ,2023-02-15,2023-02-17,217.5,13899,977,14876
81,TSLA  ,2023-02-15,2023-02-17,220.0,46112,4284,50396
82,TSLA  ,2023-02-15,2023-02-17,222.5,6014,365,6379
83,TSLA  ,2023-02-15,2023-02-17,225.0,16089,1669,17758
84,TSLA  ,2023-02-15,2023-02-17,227.5,5651,182,5833
85,TSLA  ,2023-02-15,2023-02-17,230.0,22430,1553,23983
86,TSLA  ,2023-02-15,2023-02-17,232.5,7405,137,7542
87,TSLA  ,2023-02-15,2023-02-17,235.0,15030,659,15689
88,TSLA  ,2023-02-15,2023-02-17,237.5,3411,96,3507
89,TSLA  ,2023-02-15,2023-02-17,240.0,15441,1292,16733
90,TSLA  ,2023-02-15,2023-02-17,242.5,2863,22,2885
91,TSLA  ,2023-02-15,2023-02-17,245.0,7304,157,7461
92,TSLA  ,2023-02-15,2023-02-17,247.5,2129,50,2179
93,TSLA  ,2023-02-15,2023-02-17,250.0,44596,245,44841
94,TSLA  ,2023-02-15,2023-02-17,252.5,2496,18,2514
95,TSLA  ,2023-02-15,2023-02-17,255.0,13763,33,13796
96,TSLA  ,2023-02-15,2023-02-17,257.5,3129,0,3129
97,TSLA  ,2023-02-15,2023-02-17,260.0,12348,77,12425
98,TSLA  ,2023-02-15,2023-02-17,262.5,2935,1,2936
99,TSLA  ,2023-02-15,2023-02-17,265.0,9236,50,9286
100,TSLA  ,2023-02-15,2023-02-17,267.5,2174,0,2174
101,TSLA  ,2023-02-15,2023-02-17,270.0,13472,41,13513
102,TSLA  ,2023-02-15,2023-02-17,272.5,3628,0,3628
103,TSLA  ,2023-02-15,2023-02-17,275.0,9906,0,9906
104,TSLA  ,2023-02-15,2023-02-17,277.5,1237,0,1237
105,TSLA  ,2023-02-15,2023-02-17,280.0,5891,12,5903
106,TSLA  ,2023-02-15,2023-02-17,285.0,10568,0,10568
107,TSLA  ,2023-02-15,2023-02-17,290.0,7663,0,7663
108,TSLA  ,2023-02-15,2023-02-17,295.0,4268,0,4268
109,TSLA  ,2023-02-15,2023-02-17,300.0,15846,10,15856
110,TSLA  ,2023-02-15,2023-02-17,305.0,4625,0,4625
111,TSLA  ,2023-02-15,2023-02-17,310.0,3680,0,3680
112,TSLA  ,2023-02-15,2023-02-17,315.0,3743,0,3743
113,TSLA  ,2023-02-15,2023-02-17,320.0,11786,1,11787
114,TSLA  ,2023-02-15,2023-02-17,325.0,2040,0,2040
115,TSLA  ,2023-02-15,2023-02-17,330.0,1789,0,1789
116,TSLA  ,2023-02-15,2023-02-17,335.0,4078,0,4078
117,TSLA  ,2023-02-15,2023-02-17,340.0,3188,0,3188
118,TSLA  ,2023-02-15,2023-02-17,345.0,2801,7,2808
119,TSLA  ,2023-02-15,2023-02-17,350.0,4073,0,4073
120,TSLA  ,2023-02-15,2023-02-17,355.0,1318,0,1318
121,TSLA  ,2023-02-15,2023-02-17,360.0,2051,0,2051
122,TSLA  ,2023-02-15,2023-02-17,365.0,2038,0,2038
123,TSLA  ,2023-02-15,2023-02-17,370.0,1373,0,1373
124,TSLA  ,2023-02-15,2023-02-17,375.0,4634,0,4634
125,TSLA  ,2023-02-15,2023-02-17,380.0,2162,0,2162
126,TSLA  ,2023-02-15,2023-02-17,385.0,963,0,963
127,TSLA  ,2023-02-15,2023-02-17,390.0,1494,0,1494
128,TSLA  ,2023-02-15,2023-02-17,395.0,2035,0,2035
129,TSLA  ,2023-02-15,2023-02-17,400.0,4208,0,4208
130,TSLA  ,2023-02-15,2023-02-17,405.0,560,0,560
131,TSLA  ,2023-02-15,2023-02-17,410.0,801,0,801
132,TSLA  ,2023-02-15,2023-02-17,415.0,755,0,755
133,TSLA  ,2023-02-15,2023-02-17,420.0,794,0,794
134,TSLA  ,2023-02-15,2023-02-17,425.0,674,0,674
135,TSLA  ,2023-02-15,2023-02-17,430.0,728,0,728
136,TSLA  ,2023-02-15,2023-02-17,435.0,358,0,358
137,TSLA  ,2023-02-15,2023-02-17,440.0,822,0,822
138,TSLA  ,2023-02-15,2023-02-17,445.0,235,0,235
139,TSLA  ,2023-02-15,2023-02-17,450.0,753,0,753
140,TSLA  ,2023-02-15,2023-02-17,455.0,1720,0,1720
141,TSLA  ,2023-02-15,2023-02-17,460.0,350,0,350
142,TSLA  ,2023-02-15,2023-02-17,465.0,1039,0,1039
143,TSLA  ,2023-02-15,2023-02-17,470.0,1347,0,1347
144,TSLA  ,2023-02-15,2023-02-17,475.0,589,0,589
145,TSLA  ,2023-02-15,2023-02-17,480.0,347,0,347
146,TSLA  ,2023-02-15,2023-02-17,485.0,689,0,689
147,TSLA  ,2023-02-15,2023-02-17,490.0,242,0,242
148,TSLA  ,2023-02-15,2023-02-17,495.0,400,0,400
149,TSLA  ,2023-02-15,2023-02-17,500.0,3739,0,3739
150,TSLA  ,2023-02-15,2023-02-17,505.0,357,0,357
151,TSLA  ,2023-02-15,2023-02-17,510.0,356,0,356
152,TSLA  ,2023-02-15,2023-02-17,515.0,58,0,58
153,TSLA  ,2023-02-15,2023-02-17,520.0,327,0,327
154,TSLA  ,2023-02-15,2023-02-17,525.0,150,0,150
155,TSLA  ,2023-02-15,2023-02-17,530.0,391,0,391
156,TSLA  ,2023-02-15,2023-02-17,535.0,171,0,171
157,TSLA  ,2023-02-15,2023-02-17,540.0,219,0,219
158,TSLA  ,2023-02-15,2023-02-17,545.0,110,0,110
159,TSLA  ,2023-02-15,2023-02-17,550.0,799,0,799
160,TSLA  ,2023-02-15,2023-02-17,555.0,837,0,837
161,TSLA  ,2023-02-15,2023-02-17,560.0,573,0,573
162,TSLA  ,2023-02-15,2023-02-17,565.0,661,0,661
163,TSLA  ,2023-02-15,2023-02-17,570.0,317,0,317
164,TSLA  ,2023-02-15,2023-02-17,575.0,278,0,278
165,TSLA  ,2023-02-15,2023-02-17,580.0,1203,0,1203
166,TSLA  ,2023-02-15,2023-02-17,585.0,956,0,956
167,TSLA  ,2023-02-15,2023-02-17,590.0,297,0,297
168,TSLA  ,2023-02-15,2023-02-17,595.0,2011,0,2011
169,TSLA  ,2023-02-15,2023-02-17,600.0,2974,7,2981
170,TSLA  ,2023-02-15,2023-02-24,15.0,3,9,12
171,TSLA  ,2023-02-15,2023-02-24,20.0,3,1,4
172,TSLA  ,2023-02-15,2023-02-24,25.0,3,3,6
173,TSLA  ,2023-02-15,2023-02-24,30.0,3,748,751
174,TSLA  ,2023-02-15,2023-02-24,35.0,0,20,20
175,TSLA  ,2023-02-15,2023-02-24,40.0,0,439,439
176,TSLA  ,2023-02-15,2023-02-24,45.0,0,2046,2046
177,TSLA  ,2023-02-15,2023-02-24,50.0,0,1898,1898
178,TSLA  ,2023-02-15,2023-02-24,55.0,3,806,809
179,TSLA  ,2023-02-15,2023-02-24,60.0,14,1451,1465
180,TSLA  ,2023-02-15,2023-02-24,65.0,6,698,704
181,TSLA  ,2023-02-15,2023-02-24,70.0,6,599,605
182,TSLA  ,2023-02-15,2023-02-24,75.0,1,851,852
183,TSLA  ,2023-02-15,2023-02-24,80.0,7,1111,1118
184,TSLA  ,2023-02-15,2023-02-24,85.0,38,639,677
185,TSLA  ,2023-02-15,2023-02-24,90.0,43,1412,1455
186,TSLA  ,2023-02-15,2023-02-24,95.0,19,1849,1868
187,TSLA  ,2023-02-15,2023-02-24,98.0,14,466,480
188,TSLA  ,2023-02-15,2023-02-24,99.0,17,624,641
189,TSLA  ,2023-02-15,2023-02-24,100.0,70,2496,2566
190,TSLA  ,2023-02-15,2023-02-24,101.0,18,336,354
191,TSLA  ,2023-02-15,2023-02-24,102.0,12,241,253
192,TSLA  ,2023-02-15,2023-02-24,103.0,8,207,215
193,TSLA  ,2023-02-15,2023-02-24,104.0,16,335,351
194,TSLA  ,2023-02-15,2023-02-24,105.0,53,1937,1990
195,TSLA  ,2023-02-15,2023-02-24,106.0,16,545,561
196,TSLA  ,2023-02-15,2023-02-24,107.0,8,664,672
197,TSLA  ,2023-02-15,2023-02-24,108.0,9,411,420
198,TSLA  ,2023-02-15,2023-02-24,109.0,9,488,497
199,TSLA  ,2023-02-15,2023-02-24,110.0,330,1590,1920
200,TSLA  ,2023-02-15,2023-02-24,111.0,47,490,537
201,TSLA  ,2023-02-15,2023-02-24,112.0,52,527,579
202,TSLA  ,2023-02-15,2023-02-24,113.0,46,677,723
203,TSLA  ,2023-02-15,2023-02-24,114.0,355,937,1292
204,TSLA  ,2023-02-15,2023-02-24,115.0,354,1195,1549
205,TSLA  ,2023-02-15,2023-02-24,116.0,311,739,1050
206,TSLA  ,2023-02-15,2023-02-24,117.0,271,548,819
207,TSLA  ,2023-02-15,2023-02-24,118.0,195,596,791
208,TSLA  ,2023-02-15,2023-02-24,119.0,207,647,854
209,TSLA  ,2023-02-15,2023-02-24,120.0,469,2787,3256
210,TSLA  ,2023-02-15,2023-02-24,121.0,315,740,1055
211,TSLA  ,2023-02-15,2023-02-24,122.0,297,2503,2800
212,TSLA  ,2023-02-15,2023-02-24,123.0,434,704,1138
213,TSLA  ,2023-02-15,2023-02-24,124.0,167,483,650
214,TSLA  ,2023-02-15,2023-02-24,125.0,538,2622,3160
215,TSLA  ,2023-02-15,2023-02-24,126.0,166,563,729
216,TSLA  ,2023-02-15,2023-02-24,127.0,101,1133,1234
217,TSLA  ,2023-02-15,2023-02-24,128.0,160,763,923
218,TSLA  ,2023-02-15,2023-02-24,129.0,238,1304,1542
219,TSLA  ,2023-02-15,2023-02-24,130.0,2688,2669,5357
220,TSLA  ,2023-02-15,2023-02-24,131.0,418,502,920
221,TSLA  ,2023-02-15,2023-02-24,132.0,252,866,1118
222,TSLA  ,2023-02-15,2023-02-24,133.0,145,480,625
223,TSLA  ,2023-02-15,2023-02-24,134.0,273,758,1031
224,TSLA  ,2023-02-15,2023-02-24,135.0,1894,1848,3742
225,TSLA  ,2023-02-15,2023-02-24,136.0,79,485,564
226,TSLA  ,2023-02-15,2023-02-24,137.0,65,515,580
227,TSLA  ,2023-02-15,2023-02-24,138.0,66,492,558
228,TSLA  ,2023-02-15,2023-02-24,139.0,471,354,825
229,TSLA  ,2023-02-15,2023-02-24,140.0,1749,2902,4651
230,TSLA  ,2023-02-15,2023-02-24,141.0,341,1304,1645
231,TSLA  ,2023-02-15,2023-02-24,142.0,441,904,1345
232,TSLA  ,2023-02-15,2023-02-24,143.0,88,347,435
233,TSLA  ,2023-02-15,2023-02-24,144.0,68,1412,1480
234,TSLA  ,2023-02-15,2023-02-24,145.0,1587,4617,6204
235,TSLA  ,2023-02-15,2023-02-24,146.0,69,886,955
236,TSLA  ,2023-02-15,2023-02-24,147.0,48,472,520
237,TSLA  ,2023-02-15,2023-02-24,148.0,146,919,1065
238,TSLA  ,2023-02-15,2023-02-24,149.0,106,1252,1358
239,TSLA  ,2023-02-15,2023-02-24,150.0,3314,6900,10214
240,TSLA  ,2023-02-15,2023-02-24,152.5,106,1535,1641
241,TSLA  ,2023-02-15,2023-02-24,155.0,3096,6223,9319
242,TSLA  ,2023-02-15,2023-02-24,157.5,856,918,1774
243,TSLA  ,2023-02-15,2023-02-24,160.0,2997,5870,8867
244,TSLA  ,2023-02-15,2023-02-24,162.5,429,1274,1703
245,TSLA  ,2023-02-15,2023-02-24,165.0,2293,2520,4813
246,TSLA  ,2023-02-15,2023-02-24,167.5,973,2106,3079
247,TSLA  ,2023-02-15,2023-02-24,170.0,6330,6231,12561
248,TSLA  ,2023-02-15,2023-02-24,172.5,723,1027,1750
249,TSLA  ,2023-02-15,2023-02-24,175.0,3968,5224,9192
250,TSLA  ,2023-02-15,2023-02-24,177.5,392,4674,5066
251,TSLA  ,2023-02-15,2023-02-24,180.0,4832,7047,11879
252,TSLA  ,2023-02-15,2023-02-24,182.5,514,2101,2615
253,TSLA  ,2023-02-15,2023-02-24,185.0,1676,3602,5278
254,TSLA  ,2023-02-15,2023-02-24,187.5,768,1621,2389
255,TSLA  ,2023-02-15,2023-02-24,190.0,9239,8128,17367
256,TSLA  ,2023-02-15,2023-02-24,192.5,1936,5253,7189
257,TSLA  ,2023-02-15,2023-02-24,195.0,6028,4754,10782
258,TSLA  ,2023-02-15,2023-02-24,197.5,1972,2854,4826
259,TSLA  ,2023-02-15,2023-02-24,200.0,36430,6514,42944
260,TSLA  ,2023-02-15,2023-02-24,202.5,2441,1408,3849
261,TSLA  ,2023-02-15,2023-02-24,205.0,4416,2503,6919
262,TSLA  ,2023-02-15,2023-02-24,207.5,2714,1269,3983
263,TSLA  ,2023-02-15,2023-02-24,210.0,17285,1564,18849
264,TSLA  ,2023-02-15,2023-02-24,212.5,1596,756,2352
265,TSLA  ,2023-02-15,2023-02-24,215.0,4573,647,5220
266,TSLA  ,2023-02-15,2023-02-24,217.5,1379,388,1767
267,TSLA  ,2023-02-15,2023-02-24,220.0,10249,654,10903
268,TSLA  ,2023-02-15,2023-02-24,222.5,1076,147,1223
269,TSLA  ,2023-02-15,2023-02-24,225.0,6066,216,6282
270,TSLA  ,2023-02-15,2023-02-24,227.5,3330,48,3378
271,TSLA  ,2023-02-15,2023-02-24,230.0,6223,547,6770
272,TSLA  ,2023-02-15,2023-02-24,232.5,1223,35,1258
273,TSLA  ,2023-02-15,2023-02-24,235.0,2661,55,2716
274,TSLA  ,2023-02-15,2023-02-24,237.5,554,41,595
275,TSLA  ,2023-02-15,2023-02-24,240.0,12024,684,12708
276,TSLA  ,2023-02-15,2023-02-24,242.5,596,14,610
277,TSLA  ,2023-02-15,2023-02-24,245.0,3813,15,3828
278,TSLA  ,2023-02-15,2023-02-24,247.5,289,1,290
279,TSLA  ,2023-02-15,2023-02-24,250.0,7743,195,7938
280,TSLA  ,2023-02-15,2023-02-24,252.5,257,4,261
281,TSLA  ,2023-02-15,2023-02-24,255.0,1374,6,1380
282,TSLA  ,2023-02-15,2023-02-24,257.5,270,3,273
283,TSLA  ,2023-02-15,2023-02-24,260.0,6608,6,6614
284,TSLA  ,2023-02-15,2023-02-24,262.5,208,1,209
285,TSLA  ,2023-02-15,2023-02-24,265.0,2699,2,2701
286,TSLA  ,2023-02-15,2023-02-24,270.0,2525,46,2571
287,TSLA  ,2023-02-15,2023-02-24,275.0,3493,3,3496
288,TSLA  ,2023-02-15,2023-02-24,280.0,3564,4,3568
289,TSLA  ,2023-02-15,2023-02-24,285.0,4375,0,4375
290,TSLA  ,2023-02-15,2023-02-24,290.0,2436,0,2436
291,TSLA  ,2023-02-15,2023-02-24,295.0,925,0,925
292,TSLA  ,2023-02-15,2023-02-24,300.0,2858,0,2858
293,TSLA  ,2023-02-15,2023-02-24,310.0,1971,0,1971
294,TSLA  ,2023-02-15,2023-02-24,320.0,1529,0,1529
295,TSLA  ,2023-02-15,2023-02-24,330.0,901,0,901
296,TSLA  ,2023-02-15,2023-02-24,340.0,1461,0,1461
297,TSLA  ,2023-02-15,2023-02-24,350.0,2926,0,2926
298,TSLA  ,2023-02-15,2023-02-24,360.0,9407,0,9407
299,TSLA  ,2023-02-15,2023-03-03,15.0,11,256,267
300,TSLA  ,2023-02-15,2023-03-03,20.0,1,0,1
301,TSLA  ,2023-02-15,2023-03-03,25.0,4,47,51
302,TSLA  ,2023-02-15,2023-03-03,30.0,3,340,343
303,TSLA  ,2023-02-15,2023-03-03,35.0,3,1,4
304,TSLA  ,2023-02-15,2023-03-03,40.0,0,10,10
305,TSLA  ,2023-02-15,2023-03-03,45.0,0,2457,2457
306,TSLA  ,2023-02-15,2023-03-03,50.0,1,886,887
307,TSLA  ,2023-02-15,2023-03-03,55.0,0,156,156
308,TSLA  ,2023-02-15,2023-03-03,60.0,2,1118,1120
309,TSLA  ,2023-02-15,2023-03-03,65.0,1,99,100
310,TSLA  ,2023-02-15,2023-03-03,70.0,2,692,694
311,TSLA  ,2023-02-15,2023-03-03,75.0,1,276,277
312,TSLA  ,2023-02-15,2023-03-03,80.0,112,1363,1475
313,TSLA  ,2023-02-15,2023-03-03,85.0,4,579,583
314,TSLA  ,2023-02-15,2023-03-03,90.0,7,1020,1027
315,TSLA  ,2023-02-15,2023-03-03,95.0,7,1944,1951
316,TSLA  ,2023-02-15,2023-03-03,100.0,111,2063,2174
317,TSLA  ,2023-02-15,2023-03-03,105.0,19,762,781
318,TSLA  ,2023-02-15,2023-03-03,108.0,51,491,542
319,TSLA  ,2023-02-15,2023-03-03,109.0,34,323,357
320,TSLA  ,2023-02-15,2023-03-03,110.0,110,3072,3182
321,TSLA  ,2023-02-15,2023-03-03,111.0,7,557,564
322,TSLA  ,2023-02-15,2023-03-03,112.0,43,592,635
323,TSLA  ,2023-02-15,2023-03-03,113.0,33,793,826
324,TSLA  ,2023-02-15,2023-03-03,114.0,154,511,665
325,TSLA  ,2023-02-15,2023-03-03,115.0,186,900,1086
326,TSLA  ,2023-02-15,2023-03-03,116.0,158,425,583
327,TSLA  ,2023-02-15,2023-03-03,117.0,472,750,1222
328,TSLA  ,2023-02-15,2023-03-03,118.0,309,376,685
329,TSLA  ,2023-02-15,2023-03-03,119.0,318,528,846
330,TSLA  ,2023-02-15,2023-03-03,120.0,902,2778,3680
331,TSLA  ,2023-02-15,2023-03-03,121.0,96,548,644
332,TSLA  ,2023-02-15,2023-03-03,122.0,121,927,1048
333,TSLA  ,2023-02-15,2023-03-03,123.0,264,604,868
334,TSLA  ,2023-02-15,2023-03-03,124.0,447,827,1274
335,TSLA  ,2023-02-15,2023-03-03,125.0,300,893,1193
336,TSLA  ,2023-02-15,2023-03-03,126.0,669,382,1051
337,TSLA  ,2023-02-15,2023-03-03,127.0,428,263,691
338,TSLA  ,2023-02-15,2023-03-03,128.0,455,767,1222
339,TSLA  ,2023-02-15,2023-03-03,129.0,646,610,1256
340,TSLA  ,2023-02-15,2023-03-03,130.0,679,1771,2450
341,TSLA  ,2023-02-15,2023-03-03,131.0,305,759,1064
342,TSLA  ,2023-02-15,2023-03-03,132.0,806,608,1414
343,TSLA  ,2023-02-15,2023-03-03,133.0,538,112,650
344,TSLA  ,2023-02-15,2023-03-03,134.0,569,1250,1819
345,TSLA  ,2023-02-15,2023-03-03,135.0,871,1158,2029
346,TSLA  ,2023-02-15,2023-03-03,136.0,94,71,165
347,TSLA  ,2023-02-15,2023-03-03,137.0,74,150,224
348,TSLA  ,2023-02-15,2023-03-03,138.0,149,428,577
349,TSLA  ,2023-02-15,2023-03-03,139.0,109,184,293
350,TSLA  ,2023-02-15,2023-03-03,140.0,647,1791,2438
351,TSLA  ,2023-02-15,2023-03-03,141.0,60,546,606
352,TSLA  ,2023-02-15,2023-03-03,142.0,295,313,608
353,TSLA  ,2023-02-15,2023-03-03,143.0,49,147,196
354,TSLA  ,2023-02-15,2023-03-03,144.0,22,3163,3185
355,TSLA  ,2023-02-15,2023-03-03,145.0,634,2110,2744
356,TSLA  ,2023-02-15,2023-03-03,146.0,37,613,650
357,TSLA  ,2023-02-15,2023-03-03,147.0,42,295,337
358,TSLA  ,2023-02-15,2023-03-03,148.0,39,461,500
359,TSLA  ,2023-02-15,2023-03-03,149.0,300,1692,1992
360,TSLA  ,2023-02-15,2023-03-03,150.0,1036,9347,10383
361,TSLA  ,2023-02-15,2023-03-03,152.5,189,1364,1553
362,TSLA  ,2023-02-15,2023-03-03,155.0,1285,1227,2512
363,TSLA  ,2023-02-15,2023-03-03,157.5,144,2068,2212
364,TSLA  ,2023-02-15,2023-03-03,160.0,1153,11433,12586
365,TSLA  ,2023-02-15,2023-03-03,162.5,359,2728,3087
366,TSLA  ,2023-02-15,2023-03-03,165.0,1833,1855,3688
367,TSLA  ,2023-02-15,2023-03-03,167.5,267,930,1197
368,TSLA  ,2023-02-15,2023-03-03,170.0,2402,4703,7105
369,TSLA  ,2023-02-15,2023-03-03,172.5,1182,801,1983
370,TSLA  ,2023-02-15,2023-03-03,175.0,1238,2128,3366
371,TSLA  ,2023-02-15,2023-03-03,177.5,495,375,870
372,TSLA  ,2023-02-15,2023-03-03,180.0,2391,2928,5319
373,TSLA  ,2023-02-15,2023-03-03,182.5,331,820,1151
374,TSLA  ,2023-02-15,2023-03-03,185.0,1677,2069,3746
375,TSLA  ,2023-02-15,2023-03-03,187.5,1449,813,2262
376,TSLA  ,2023-02-15,2023-03-03,190.0,2765,2263,5028
377,TSLA  ,2023-02-15,2023-03-03,192.5,1051,1171,2222
378,TSLA  ,2023-02-15,2023-03-03,195.0,4072,2442,6514
379,TSLA  ,2023-02-15,2023-03-03,197.5,2948,994,3942
380,TSLA  ,2023-02-15,2023-03-03,200.0,8113,3098,11211
381,TSLA  ,2023-02-15,2023-03-03,202.5,2436,1596,4032
382,TSLA  ,2023-02-15,2023-03-03,205.0,3799,1282,5081
383,TSLA  ,2023-02-15,2023-03-03,207.5,2421,1109,3530
384,TSLA  ,2023-02-15,2023-03-03,210.0,4442,834,5276
385,TSLA  ,2023-02-15,2023-03-03,212.5,1185,442,1627
386,TSLA  ,2023-02-15,2023-03-03,215.0,4575,381,4956
387,TSLA  ,2023-02-15,2023-03-03,217.5,823,315,1138
388,TSLA  ,2023-02-15,2023-03-03,220.0,7500,492,7992
389,TSLA  ,2023-02-15,2023-03-03,222.5,605,56,661
390,TSLA  ,2023-02-15,2023-03-03,225.0,3296,33,3329
391,TSLA  ,2023-02-15,2023-03-03,227.5,451,8,459
392,TSLA  ,2023-02-15,2023-03-03,230.0,8457,287,8744
393,TSLA  ,2023-02-15,2023-03-03,235.0,1765,48,1813
394,TSLA  ,2023-02-15,2023-03-03,240.0,4830,416,5246
395,TSLA  ,2023-02-15,2023-03-03,245.0,3205,142,3347
396,TSLA  ,2023-02-15,2023-03-03,250.0,5225,109,5334
397,TSLA  ,2023-02-15,2023-03-03,255.0,1390,8,1398
398,TSLA  ,2023-02-15,2023-03-03,260.0,1853,13,1866
399,TSLA  ,2023-02-15,2023-03-03,265.0,677,1,678
400,TSLA  ,2023-02-15,2023-03-03,270.0,2572,54,2626
401,TSLA  ,2023-02-15,2023-03-03,275.0,1677,10,1687
402,TSLA  ,2023-02-15,2023-03-03,280.0,1344,29,1373
403,TSLA  ,2023-02-15,2023-03-03,285.0,701,24,725
404,TSLA  ,2023-02-15,2023-03-03,290.0,1742,2,1744
405,TSLA  ,2023-02-15,2023-03-03,295.0,550,22,572
406,TSLA  ,2023-02-15,2023-03-03,300.0,6005,48,6053
407,TSLA  ,2023-02-15,2023-03-03,310.0,1353,0,1353
408,TSLA  ,2023-02-15,2023-03-03,320.0,1486,5,1491
409,TSLA  ,2023-02-15,2023-03-03,330.0,373,0,373
410,TSLA  ,2023-02-15,2023-03-03,340.0,564,0,564
411,TSLA  ,2023-02-15,2023-03-03,350.0,855,2,857
412,TSLA  ,2023-02-15,2023-03-03,360.0,1898,0,1898
413,TSLA  ,2023-02-15,2023-03-10,15.0,3,100,103
414,TSLA  ,2023-02-15,2023-03-10,20.0,3,0,3
415,TSLA  ,2023-02-15,2023-03-10,25.0,0,0,0
416,TSLA  ,2023-02-15,2023-03-10,30.0,3,2,5
417,TSLA  ,2023-02-15,2023-03-10,35.0,0,0,0
418,TSLA  ,2023-02-15,2023-03-10,40.0,0,10,10
419,TSLA  ,2023-02-15,2023-03-10,45.0,0,0,0
420,TSLA  ,2023-02-15,2023-03-10,50.0,5,636,641
421,TSLA  ,2023-02-15,2023-03-10,55.0,0,1209,1209
422,TSLA  ,2023-02-15,2023-03-10,60.0,0,23,23
423,TSLA  ,2023-02-15,2023-03-10,65.0,50,14,64
424,TSLA  ,2023-02-15,2023-03-10,70.0,0,30,30
425,TSLA  ,2023-02-15,2023-03-10,75.0,0,438,438
426,TSLA  ,2023-02-15,2023-03-10,80.0,0,84,84
427,TSLA  ,2023-02-15,2023-03-10,85.0,0,62,62
428,TSLA  ,2023-02-15,2023-03-10,90.0,0,96,96
429,TSLA  ,2023-02-15,2023-03-10,95.0,11,437,448
430,TSLA  ,2023-02-15,2023-03-10,100.0,23,778,801
431,TSLA  ,2023-02-15,2023-03-10,105.0,4,343,347
432,TSLA  ,2023-02-15,2023-03-10,110.0,14,787,801
433,TSLA  ,2023-02-15,2023-03-10,115.0,5,661,666
434,TSLA  ,2023-02-15,2023-03-10,120.0,22,1314,1336
435,TSLA  ,2023-02-15,2023-03-10,125.0,14,676,690
436,TSLA  ,2023-02-15,2023-03-10,130.0,80,361,441
437,TSLA  ,2023-02-15,2023-03-10,134.0,5,157,162
438,TSLA  ,2023-02-15,2023-03-10,135.0,33,582,615
439,TSLA  ,2023-02-15,2023-03-10,136.0,28,167,195
440,TSLA  ,2023-02-15,2023-03-10,137.0,8,81,89
441,TSLA  ,2023-02-15,2023-03-10,138.0,14,104,118
442,TSLA  ,2023-02-15,2023-03-10,139.0,4,110,114
443,TSLA  ,2023-02-15,2023-03-10,140.0,53,1081,1134
444,TSLA  ,2023-02-15,2023-03-10,141.0,143,456,599
445,TSLA  ,2023-02-15,2023-03-10,142.0,23,239,262
446,TSLA  ,2023-02-15,2023-03-10,143.0,11,488,499
447,TSLA  ,2023-02-15,2023-03-10,144.0,12,49,61
448,TSLA  ,2023-02-15,2023-03-10,145.0,105,380,485
449,TSLA  ,2023-02-15,2023-03-10,146.0,38,59,97
450,TSLA  ,2023-02-15,2023-03-10,147.0,81,144,225
451,TSLA  ,2023-02-15,2023-03-10,148.0,98,824,922
452,TSLA  ,2023-02-15,2023-03-10,149.0,3,194,197
453,TSLA  ,2023-02-15,2023-03-10,150.0,248,954,1202
454,TSLA  ,2023-02-15,2023-03-10,152.5,117,247,364
455,TSLA  ,2023-02-15,2023-03-10,155.0,288,745,1033
456,TSLA  ,2023-02-15,2023-03-10,157.5,93,365,458
457,TSLA  ,2023-02-15,2023-03-10,160.0,243,810,1053
458,TSLA  ,2023-02-15,2023-03-10,162.5,114,560,674
459,TSLA  ,2023-02-15,2023-03-10,165.0,270,1133,1403
460,TSLA  ,2023-02-15,2023-03-10,167.5,275,483,758
461,TSLA  ,2023-02-15,2023-03-10,170.0,393,1519,1912
462,TSLA  ,2023-02-15,2023-03-10,172.5,234,371,605
463,TSLA  ,2023-02-15,2023-03-10,175.0,426,1449,1875
464,TSLA  ,2023-02-15,2023-03-10,177.5,1890,288,2178
465,TSLA  ,2023-02-15,2023-03-10,180.0,639,1907,2546
466,TSLA  ,2023-02-15,2023-03-10,182.5,166,419,585
467,TSLA  ,2023-02-15,2023-03-10,185.0,443,868,1311
468,TSLA  ,2023-02-15,2023-03-10,187.5,1217,289,1506
469,TSLA  ,2023-02-15,2023-03-10,190.0,1345,1422,2767
470,TSLA  ,2023-02-15,2023-03-10,192.5,614,515,1129
471,TSLA  ,2023-02-15,2023-03-10,195.0,701,952,1653
472,TSLA  ,2023-02-15,2023-03-10,197.5,471,914,1385
473,TSLA  ,2023-02-15,2023-03-10,200.0,2393,1469,3862
474,TSLA  ,2023-02-15,2023-03-10,202.5,1388,1028,2416
475,TSLA  ,2023-02-15,2023-03-10,205.0,1110,1123,2233
476,TSLA  ,2023-02-15,2023-03-10,207.5,680,389,1069
477,TSLA  ,2023-02-15,2023-03-10,210.0,1915,622,2537
478,TSLA  ,2023-02-15,2023-03-10,212.5,432,427,859
479,TSLA  ,2023-02-15,2023-03-10,215.0,634,195,829
480,TSLA  ,2023-02-15,2023-03-10,217.5,253,104,357
481,TSLA  ,2023-02-15,2023-03-10,220.0,1746,39,1785
482,TSLA  ,2023-02-15,2023-03-10,222.5,318,40,358
483,TSLA  ,2023-02-15,2023-03-10,225.0,804,125,929
484,TSLA  ,2023-02-15,2023-03-10,230.0,1121,41,1162
485,TSLA  ,2023-02-15,2023-03-10,235.0,501,4,505
486,TSLA  ,2023-02-15,2023-03-10,240.0,1215,15,1230
487,TSLA  ,2023-02-15,2023-03-10,245.0,596,53,649
488,TSLA  ,2023-02-15,2023-03-10,250.0,2289,152,2441
489,TSLA  ,2023-02-15,2023-03-10,255.0,417,2,419
490,TSLA  ,2023-02-15,2023-03-10,260.0,1048,63,1111
491,TSLA  ,2023-02-15,2023-03-10,265.0,3328,0,3328
492,TSLA  ,2023-02-15,2023-03-10,270.0,462,0,462
493,TSLA  ,2023-02-15,2023-03-10,275.0,450,0,450
494,TSLA  ,2023-02-15,2023-03-10,280.0,1661,6,1667
495,TSLA  ,2023-02-15,2023-03-10,285.0,618,0,618
496,TSLA  ,2023-02-15,2023-03-10,290.0,355,3,358
497,TSLA  ,2023-02-15,2023-03-10,295.0,438,0,438
498,TSLA  ,2023-02-15,2023-03-10,300.0,1973,0,1973
499,TSLA  ,2023-02-15,2023-03-10,310.0,2904,11,2915
500,TSLA  ,2023-02-15,2023-03-10,320.0,469,1,470
501,TSLA  ,2023-02-15,2023-03-10,330.0,334,0,334
502,TSLA  ,2023-02-15,2023-03-10,340.0,521,0,521
503,TSLA  ,2023-02-15,2023-03-10,350.0,591,0,591
504,TSLA  ,2023-02-15,2023-03-10,360.0,848,0,848
505,TSLA  ,2023-02-15,2023-03-17,1.67,50,24711,24761
506,TSLA  ,2023-02-15,2023-03-17,3.33,29,6941,6970
507,TSLA  ,2023-02-15,2023-03-17,5.0,2,8008,8010
508,TSLA  ,2023-02-15,2023-03-17,6.67,52,4669,4721
509,TSLA  ,2023-02-15,2023-03-17,8.33,15,1379,1394
510,TSLA  ,2023-02-15,2023-03-17,10.0,842,4105,4947
511,TSLA  ,2023-02-15,2023-03-17,11.67,1711,5414,7125
512,TSLA  ,2023-02-15,2023-03-17,13.33,1657,2125,3782
513,TSLA  ,2023-02-15,2023-03-17,15.0,987,5169,6156
514,TSLA  ,2023-02-15,2023-03-17,16.67,875,15329,16204
515,TSLA  ,2023-02-15,2023-03-17,18.33,467,12018,12485
516,TSLA  ,2023-02-15,2023-03-17,33.33,406,33639,34045
517,TSLA  ,2023-02-15,2023-03-17,50.0,503,21465,21968
518,TSLA  ,2023-02-15,2023-03-17,55.0,34,4706,4740
519,TSLA  ,2023-02-15,2023-03-17,60.0,201,6716,6917
520,TSLA  ,2023-02-15,2023-03-17,65.0,25,2866,2891
521,TSLA  ,2023-02-15,2023-03-17,66.67,888,17898,18786
522,TSLA  ,2023-02-15,2023-03-17,70.0,49,8122,8171
523,TSLA  ,2023-02-15,2023-03-17,75.0,54,5456,5510
524,TSLA  ,2023-02-15,2023-03-17,80.0,244,11952,12196
525,TSLA  ,2023-02-15,2023-03-17,83.33,886,5140,6026
526,TSLA  ,2023-02-15,2023-03-17,85.0,87,3486,3573
527,TSLA  ,2023-02-15,2023-03-17,90.0,664,16131,16795
528,TSLA  ,2023-02-15,2023-03-17,95.0,334,3453,3787
529,TSLA  ,2023-02-15,2023-03-17,100.0,1757,39125,40882
530,TSLA  ,2023-02-15,2023-03-17,105.0,1414,4348,5762
531,TSLA  ,2023-02-15,2023-03-17,110.0,2896,14100,16996
532,TSLA  ,2023-02-15,2023-03-17,115.0,3393,9280,12673
533,TSLA  ,2023-02-15,2023-03-17,116.67,1372,10916,12288
534,TSLA  ,2023-02-15,2023-03-17,120.0,12425,26286,38711
535,TSLA  ,2023-02-15,2023-03-17,123.33,2744,6326,9070
536,TSLA  ,2023-02-15,2023-03-17,125.0,3544,11058,14602
537,TSLA  ,2023-02-15,2023-03-17,126.67,1683,4701,6384
538,TSLA  ,2023-02-15,2023-03-17,130.0,7358,11435,18793
539,TSLA  ,2023-02-15,2023-03-17,133.33,3431,9719,13150
540,TSLA  ,2023-02-15,2023-03-17,135.0,27640,33877,61517
541,TSLA  ,2023-02-15,2023-03-17,136.67,2866,3575,6441
542,TSLA  ,2023-02-15,2023-03-17,140.0,7046,31349,38395
543,TSLA  ,2023-02-15,2023-03-17,143.33,2435,4867,7302
544,TSLA  ,2023-02-15,2023-03-17,145.0,2814,8896,11710
545,TSLA  ,2023-02-15,2023-03-17,146.67,1863,4210,6073
546,TSLA  ,2023-02-15,2023-03-17,150.0,13614,24766,38380
547,TSLA  ,2023-02-15,2023-03-17,153.33,1661,2978,4639
548,TSLA  ,2023-02-15,2023-03-17,155.0,3660,6383,10043
549,TSLA  ,2023-02-15,2023-03-17,156.67,2229,3411,5640
550,TSLA  ,2023-02-15,2023-03-17,160.0,7829,24232,32061
551,TSLA  ,2023-02-15,2023-03-17,163.33,3018,5763,8781
552,TSLA  ,2023-02-15,2023-03-17,165.0,6981,6782,13763
553,TSLA  ,2023-02-15,2023-03-17,166.67,6333,11970,18303
554,TSLA  ,2023-02-15,2023-03-17,170.0,11286,22326,33612
555,TSLA  ,2023-02-15,2023-03-17,173.33,3138,12228,15366
556,TSLA  ,2023-02-15,2023-03-17,175.0,4969,10545,15514
557,TSLA  ,2023-02-15,2023-03-17,176.67,5213,3560,8773
558,TSLA  ,2023-02-15,2023-03-17,180.0,20279,23697,43976
559,TSLA  ,2023-02-15,2023-03-17,183.33,3375,8178,11553
560,TSLA  ,2023-02-15,2023-03-17,185.0,3722,4544,8266
561,TSLA  ,2023-02-15,2023-03-17,186.67,2662,4505,7167
562,TSLA  ,2023-02-15,2023-03-17,190.0,15059,17751,32810
563,TSLA  ,2023-02-15,2023-03-17,193.33,2207,2525,4732
564,TSLA  ,2023-02-15,2023-03-17,195.0,11463,10381,21844
565,TSLA  ,2023-02-15,2023-03-17,196.67,2755,1947,4702
566,TSLA  ,2023-02-15,2023-03-17,198.33,3888,2320,6208
567,TSLA  ,2023-02-15,2023-03-17,200.0,40928,36493,77421
568,TSLA  ,2023-02-15,2023-03-17,201.67,2080,1691,3771
569,TSLA  ,2023-02-15,2023-03-17,203.33,3199,2451,5650
570,TSLA  ,2023-02-15,2023-03-17,205.0,4480,2716,7196
571,TSLA  ,2023-02-15,2023-03-17,206.67,2715,2416,5131
572,TSLA  ,2023-02-15,2023-03-17,208.33,2490,928,3418
573,TSLA  ,2023-02-15,2023-03-17,210.0,10985,4915,15900
574,TSLA  ,2023-02-15,2023-03-17,211.67,2189,708,2897
575,TSLA  ,2023-02-15,2023-03-17,213.33,1821,633,2454
576,TSLA  ,2023-02-15,2023-03-17,215.0,9285,867,10152
577,TSLA  ,2023-02-15,2023-03-17,216.67,4821,2923,7744
578,TSLA  ,2023-02-15,2023-03-17,218.33,1513,200,1713
579,TSLA  ,2023-02-15,2023-03-17,220.0,12760,1423,14183
580,TSLA  ,2023-02-15,2023-03-17,221.67,1433,221,1654
581,TSLA  ,2023-02-15,2023-03-17,223.33,1081,195,1276
582,TSLA  ,2023-02-15,2023-03-17,225.0,5435,1648,7083
583,TSLA  ,2023-02-15,2023-03-17,226.67,2165,212,2377
584,TSLA  ,2023-02-15,2023-03-17,228.33,4963,69,5032
585,TSLA  ,2023-02-15,2023-03-17,230.0,8600,1756,10356
586,TSLA  ,2023-02-15,2023-03-17,231.67,1494,67,1561
587,TSLA  ,2023-02-15,2023-03-17,233.33,6853,421,7274
588,TSLA  ,2023-02-15,2023-03-17,235.0,8955,105,9060
589,TSLA  ,2023-02-15,2023-03-17,236.67,1105,68,1173
590,TSLA  ,2023-02-15,2023-03-17,238.33,1063,84,1147
591,TSLA  ,2023-02-15,2023-03-17,240.0,7108,356,7464
592,TSLA  ,2023-02-15,2023-03-17,241.67,1133,71,1204
593,TSLA  ,2023-02-15,2023-03-17,243.33,1344,412,1756
594,TSLA  ,2023-02-15,2023-03-17,245.0,2322,71,2393
595,TSLA  ,2023-02-15,2023-03-17,246.67,1094,33,1127
596,TSLA  ,2023-02-15,2023-03-17,248.33,1186,29,1215
597,TSLA  ,2023-02-15,2023-03-17,250.0,24411,831,25242
598,TSLA  ,2023-02-15,2023-03-17,251.67,1433,67,1500
599,TSLA  ,2023-02-15,2023-03-17,253.33,662,28,690
600,TSLA  ,2023-02-15,2023-03-17,255.0,4363,74,4437
601,TSLA  ,2023-02-15,2023-03-17,256.67,692,16,708
602,TSLA  ,2023-02-15,2023-03-17,258.33,892,28,920
603,TSLA  ,2023-02-15,2023-03-17,260.0,6931,43,6974
604,TSLA  ,2023-02-15,2023-03-17,261.67,1587,12,1599
605,TSLA  ,2023-02-15,2023-03-17,263.33,1054,73,1127
606,TSLA  ,2023-02-15,2023-03-17,265.0,2688,16,2704
607,TSLA  ,2023-02-15,2023-03-17,266.67,10908,376,11284
608,TSLA  ,2023-02-15,2023-03-17,270.0,4929,34,4963
609,TSLA  ,2023-02-15,2023-03-17,273.33,3875,80,3955
610,TSLA  ,2023-02-15,2023-03-17,275.0,632,13,645
611,TSLA  ,2023-02-15,2023-03-17,276.67,1428,38,1466
612,TSLA  ,2023-02-15,2023-03-17,280.0,3103,140,3243
613,TSLA  ,2023-02-15,2023-03-17,283.33,6921,54,6975
614,TSLA  ,2023-02-15,2023-03-17,285.0,302,1,303
615,TSLA  ,2023-02-15,2023-03-17,286.67,2029,17,2046
616,TSLA  ,2023-02-15,2023-03-17,290.0,3636,65,3701
617,TSLA  ,2023-02-15,2023-03-17,293.33,7282,343,7625
618,TSLA  ,2023-02-15,2023-03-17,295.0,2954,11,2965
619,TSLA  ,2023-02-15,2023-03-17,296.67,970,16,986
620,TSLA  ,2023-02-15,2023-03-17,298.33,1144,2,1146
621,TSLA  ,2023-02-15,2023-03-17,300.0,71664,459,72123
622,TSLA  ,2023-02-15,2023-03-17,301.67,1478,17,1495
623,TSLA  ,2023-02-15,2023-03-17,303.33,1470,3,1473
624,TSLA  ,2023-02-15,2023-03-17,305.0,2660,26,2686
625,TSLA  ,2023-02-15,2023-03-17,306.67,1918,3,1921
626,TSLA  ,2023-02-15,2023-03-17,308.33,3835,2,3837
627,TSLA  ,2023-02-15,2023-03-17,310.0,4421,36,4457
628,TSLA  ,2023-02-15,2023-03-17,311.67,2042,5,2047
629,TSLA  ,2023-02-15,2023-03-17,313.33,2541,1,2542
630,TSLA  ,2023-02-15,2023-03-17,316.67,29537,11,29548
631,TSLA  ,2023-02-15,2023-03-17,320.0,15717,205,15922
632,TSLA  ,2023-02-15,2023-03-17,323.33,466,0,466
633,TSLA  ,2023-02-15,2023-03-17,326.67,506,1,507
634,TSLA  ,2023-02-15,2023-03-17,330.0,3427,8,3435
635,TSLA  ,2023-02-15,2023-03-17,333.33,20561,29,20590
636,TSLA  ,2023-02-15,2023-03-17,336.67,633,0,633
637,TSLA  ,2023-02-15,2023-03-17,340.0,5216,0,5216
638,TSLA  ,2023-02-15,2023-03-17,343.33,1876,0,1876
639,TSLA  ,2023-02-15,2023-03-17,346.67,625,0,625
640,TSLA  ,2023-02-15,2023-03-17,350.0,11117,18,11135
641,TSLA  ,2023-02-15,2023-03-17,353.33,950,0,950
642,TSLA  ,2023-02-15,2023-03-17,356.67,526,0,526
643,TSLA  ,2023-02-15,2023-03-17,360.0,2172,0,2172
644,TSLA  ,2023-02-15,2023-03-17,363.33,572,0,572
645,TSLA  ,2023-02-15,2023-03-17,366.67,7768,0,7768
646,TSLA  ,2023-02-15,2023-03-17,370.0,1373,0,1373
647,TSLA  ,2023-02-15,2023-03-17,373.33,674,0,674
648,TSLA  ,2023-02-15,2023-03-17,383.33,12661,0,12661
649,TSLA  ,2023-02-15,2023-03-17,400.0,25561,0,25561
650,TSLA  ,2023-02-15,2023-03-17,416.67,13244,0,13244
651,TSLA  ,2023-02-15,2023-03-17,433.33,19375,0,19375
652,TSLA  ,2023-02-15,2023-03-17,441.67,2012,0,2012
653,TSLA  ,2023-02-15,2023-03-17,450.0,5509,0,5509
654,TSLA  ,2023-02-15,2023-03-17,458.33,2458,0,2458
655,TSLA  ,2023-02-15,2023-03-17,466.67,2878,4,2882
656,TSLA  ,2023-02-15,2023-03-17,475.0,3938,0,3938
657,TSLA  ,2023-02-15,2023-03-17,483.33,1989,0,1989
658,TSLA  ,2023-02-15,2023-03-17,491.67,2479,0,2479
659,TSLA  ,2023-02-15,2023-03-17,500.0,13642,10,13652
660,TSLA  ,2023-02-15,2023-03-17,508.33,3509,0,3509
661,TSLA  ,2023-02-15,2023-03-17,516.67,1118,0,1118
662,TSLA  ,2023-02-15,2023-03-17,525.0,4654,0,4654
663,TSLA  ,2023-02-15,2023-03-17,533.33,4709,0,4709
664,TSLA  ,2023-02-15,2023-03-17,541.67,1032,0,1032
665,TSLA  ,2023-02-15,2023-03-17,550.0,5035,0,5035
666,TSLA  ,2023-02-15,2023-03-17,558.33,3779,0,3779
667,TSLA  ,2023-02-15,2023-03-17,566.67,7724,0,7724
668,TSLA  ,2023-02-15,2023-03-17,575.0,11904,0,11904
669,TSLA  ,2023-02-15,2023-03-17,583.33,2651,0,2651
670,TSLA  ,2023-02-15,2023-03-17,591.67,1098,0,1098
671,TSLA  ,2023-02-15,2023-03-17,600.0,5408,0,5408
672,TSLA  ,2023-02-15,2023-03-17,608.33,530,0,530
673,TSLA  ,2023-02-15,2023-03-17,616.67,3996,0,3996
674,TSLA  ,2023-02-15,2023-03-17,625.0,1021,0,1021
675,TSLA  ,2023-02-15,2023-03-17,633.33,2365,0,2365
676,TSLA  ,2023-02-15,2023-03-17,641.67,1509,0,1509
677,TSLA  ,2023-02-15,2023-03-17,650.0,8462,0,8462
678,TSLA  ,2023-02-15,2023-03-17,666.67,70229,0,70229
679,TSLA  ,2023-02-15,2023-03-17,675.0,21623,0,21623
680,TSLA  ,2023-02-15,2023-03-17,683.33,3829,0,3829
681,TSLA  ,2023-02-15,2023-03-17,691.67,1299,0,1299
682,TSLA  ,2023-02-15,2023-03-17,700.0,4710,0,4710
683,TSLA  ,2023-02-15,2023-03-17,708.33,587,0,587
684,TSLA  ,2023-02-15,2023-03-17,716.67,783,0,783
685,TSLA  ,2023-02-15,2023-03-17,725.0,1042,0,1042
686,TSLA  ,2023-02-15,2023-03-17,733.33,1723,0,1723
687,TSLA  ,2023-02-15,2023-03-17,741.67,754,0,754
688,TSLA  ,2023-02-15,2023-03-17,750.0,754,0,754
689,TSLA  ,2023-02-15,2023-03-17,758.33,1235,0,1235
690,TSLA  ,2023-02-15,2023-03-17,766.67,1260,0,1260
691,TSLA  ,2023-02-15,2023-03-17,775.0,849,0,849
692,TSLA  ,2023-02-15,2023-03-17,783.33,1306,0,1306
693,TSLA  ,2023-02-15,2023-03-17,791.67,1447,0,1447
694,TSLA  ,2023-02-15,2023-03-17,800.0,5379,0,5379
695,TSLA  ,2023-02-15,2023-03-17,808.33,1842,0,1842
696,TSLA  ,2023-02-15,2023-03-17,816.67,2608,0,2608
697,TSLA  ,2023-02-15,2023-03-17,825.0,60220,0,60220
698,TSLA  ,2023-02-15,2023-03-24,20.0,6,122,128
699,TSLA  ,2023-02-15,2023-03-24,25.0,0,0,0
700,TSLA  ,2023-02-15,2023-03-24,30.0,0,0,0
701,TSLA  ,2023-02-15,2023-03-24,35.0,0,0,0
702,TSLA  ,2023-02-15,2023-03-24,40.0,0,0,0
703,TSLA  ,2023-02-15,2023-03-24,45.0,0,1,1
704,TSLA  ,2023-02-15,2023-03-24,50.0,11,1543,1554
705,TSLA  ,2023-02-15,2023-03-24,55.0,3,0,3
706,TSLA  ,2023-02-15,2023-03-24,60.0,0,13,13
707,TSLA  ,2023-02-15,2023-03-24,65.0,0,0,0
708,TSLA  ,2023-02-15,2023-03-24,70.0,0,20,20
709,TSLA  ,2023-02-15,2023-03-24,75.0,0,37,37
710,TSLA  ,2023-02-15,2023-03-24,80.0,0,62,62
711,TSLA  ,2023-02-15,2023-03-24,85.0,1,25,26
712,TSLA  ,2023-02-15,2023-03-24,90.0,0,34,34
713,TSLA  ,2023-02-15,2023-03-24,95.0,0,68,68
714,TSLA  ,2023-02-15,2023-03-24,100.0,12,298,310
715,TSLA  ,2023-02-15,2023-03-24,105.0,10,100,110
716,TSLA  ,2023-02-15,2023-03-24,110.0,6,91,97
717,TSLA  ,2023-02-15,2023-03-24,115.0,1,61,62
718,TSLA  ,2023-02-15,2023-03-24,120.0,2,213,215
719,TSLA  ,2023-02-15,2023-03-24,125.0,5,265,270
720,TSLA  ,2023-02-15,2023-03-24,130.0,138,341,479
721,TSLA  ,2023-02-15,2023-03-24,135.0,16,375,391
722,TSLA  ,2023-02-15,2023-03-24,140.0,29,387,416
723,TSLA  ,2023-02-15,2023-03-24,145.0,57,265,322
724,TSLA  ,2023-02-15,2023-03-24,146.0,7,30,37
725,TSLA  ,2023-02-15,2023-03-24,147.0,87,27,114
726,TSLA  ,2023-02-15,2023-03-24,148.0,76,91,167
727,TSLA  ,2023-02-15,2023-03-24,149.0,59,84,143
728,TSLA  ,2023-02-15,2023-03-24,150.0,72,770,842
729,TSLA  ,2023-02-15,2023-03-24,152.5,14,118,132
730,TSLA  ,2023-02-15,2023-03-24,155.0,473,645,1118
731,TSLA  ,2023-02-15,2023-03-24,157.5,51,426,477
732,TSLA  ,2023-02-15,2023-03-24,160.0,99,492,591
733,TSLA  ,2023-02-15,2023-03-24,162.5,34,116,150
734,TSLA  ,2023-02-15,2023-03-24,165.0,69,564,633
735,TSLA  ,2023-02-15,2023-03-24,167.5,21,542,563
736,TSLA  ,2023-02-15,2023-03-24,170.0,172,877,1049
737,TSLA  ,2023-02-15,2023-03-24,172.5,33,245,278
738,TSLA  ,2023-02-15,2023-03-24,175.0,143,428,571
739,TSLA  ,2023-02-15,2023-03-24,177.5,34,464,498
740,TSLA  ,2023-02-15,2023-03-24,180.0,190,967,1157
741,TSLA  ,2023-02-15,2023-03-24,182.5,8,131,139
742,TSLA  ,2023-02-15,2023-03-24,185.0,107,310,417
743,TSLA  ,2023-02-15,2023-03-24,187.5,130,53,183
744,TSLA  ,2023-02-15,2023-03-24,190.0,413,640,1053
745,TSLA  ,2023-02-15,2023-03-24,192.5,67,178,245
746,TSLA  ,2023-02-15,2023-03-24,195.0,491,247,738
747,TSLA  ,2023-02-15,2023-03-24,197.5,733,114,847
748,TSLA  ,2023-02-15,2023-03-24,200.0,1880,1672,3552
749,TSLA  ,2023-02-15,2023-03-24,202.5,233,104,337
750,TSLA  ,2023-02-15,2023-03-24,205.0,1403,136,1539
751,TSLA  ,2023-02-15,2023-03-24,207.5,153,104,257
752,TSLA  ,2023-02-15,2023-03-24,210.0,2435,166,2601
753,TSLA  ,2023-02-15,2023-03-24,212.5,187,92,279
754,TSLA  ,2023-02-15,2023-03-24,215.0,795,435,1230
755,TSLA  ,2023-02-15,2023-03-24,217.5,203,67,270
756,TSLA  ,2023-02-15,2023-03-24,220.0,2824,580,3404
757,TSLA  ,2023-02-15,2023-03-24,222.5,253,15,268
758,TSLA  ,2023-02-15,2023-03-24,225.0,395,112,507
759,TSLA  ,2023-02-15,2023-03-24,230.0,700,197,897
760,TSLA  ,2023-02-15,2023-03-24,235.0,467,64,531
761,TSLA  ,2023-02-15,2023-03-24,240.0,181,136,317
762,TSLA  ,2023-02-15,2023-03-24,245.0,542,20,562
763,TSLA  ,2023-02-15,2023-03-24,250.0,1245,38,1283
764,TSLA  ,2023-02-15,2023-03-24,255.0,238,21,259
765,TSLA  ,2023-02-15,2023-03-24,260.0,723,3,726
766,TSLA  ,2023-02-15,2023-03-24,265.0,255,1,256
767,TSLA  ,2023-02-15,2023-03-24,270.0,105,1,106
768,TSLA  ,2023-02-15,2023-03-24,275.0,202,3,205
769,TSLA  ,2023-02-15,2023-03-24,280.0,299,0,299
770,TSLA  ,2023-02-15,2023-03-24,285.0,298,0,298
771,TSLA  ,2023-02-15,2023-03-24,290.0,224,0,224
772,TSLA  ,2023-02-15,2023-03-24,295.0,83,0,83
773,TSLA  ,2023-02-15,2023-03-24,300.0,762,1,763
774,TSLA  ,2023-02-15,2023-03-24,310.0,255,0,255
775,TSLA  ,2023-02-15,2023-03-24,320.0,317,0,317
776,TSLA  ,2023-02-15,2023-03-24,330.0,173,0,173
777,TSLA  ,2023-02-15,2023-03-24,340.0,342,0,342
778,TSLA  ,2023-02-15,2023-03-24,350.0,143,0,143
779,TSLA  ,2023-02-15,2023-03-24,360.0,467,0,467
780,TSLA  ,2023-02-15,2023-03-31,25.0,0,0,0
781,TSLA  ,2023-02-15,2023-03-31,30.0,0,0,0
782,TSLA  ,2023-02-15,2023-03-31,35.0,0,0,0
783,TSLA  ,2023-02-15,2023-03-31,40.0,0,0,0
784,TSLA  ,2023-02-15,2023-03-31,45.0,0,0,0
785,TSLA  ,2023-02-15,2023-03-31,50.0,0,2,2
786,TSLA  ,2023-02-15,2023-03-31,55.0,0,0,0
787,TSLA  ,2023-02-15,2023-03-31,60.0,0,12,12
788,TSLA  ,2023-02-15,2023-03-31,65.0,0,1,1
789,TSLA  ,2023-02-15,2023-03-31,70.0,0,9,9
790,TSLA  ,2023-02-15,2023-03-31,75.0,0,52,52
791,TSLA  ,2023-02-15,2023-03-31,80.0,4,15,19
792,TSLA  ,2023-02-15,2023-03-31,85.0,0,2,2
793,TSLA  ,2023-02-15,2023-03-31,90.0,0,25,25
794,TSLA  ,2023-02-15,2023-03-31,95.0,0,122,122
795,TSLA  ,2023-02-15,2023-03-31,100.0,3,63,66
796,TSLA  ,2023-02-15,2023-03-31,105.0,0,165,165
797,TSLA  ,2023-02-15,2023-03-31,110.0,0,61,61
798,TSLA  ,2023-02-15,2023-03-31,115.0,11,124,135
799,TSLA  ,2023-02-15,2023-03-31,120.0,1,141,142
800,TSLA  ,2023-02-15,2023-03-31,125.0,1,35,36
801,TSLA  ,2023-02-15,2023-03-31,130.0,8,102,110
802,TSLA  ,2023-02-15,2023-03-31,135.0,4,216,220
803,TSLA  ,2023-02-15,2023-03-31,140.0,12,134,146
804,TSLA  ,2023-02-15,2023-03-31,145.0,16,150,166
805,TSLA  ,2023-02-15,2023-03-31,150.0,111,447,558
806,TSLA  ,2023-02-15,2023-03-31,155.0,300,101,401
807,TSLA  ,2023-02-15,2023-03-31,160.0,33,150,183
808,TSLA  ,2023-02-15,2023-03-31,165.0,39,243,282
809,TSLA  ,2023-02-15,2023-03-31,170.0,5,669,674
810,TSLA  ,2023-02-15,2023-03-31,172.5,5,133,138
811,TSLA  ,2023-02-15,2023-03-31,175.0,28,230,258
812,TSLA  ,2023-02-15,2023-03-31,177.5,3,56,59
813,TSLA  ,2023-02-15,2023-03-31,180.0,45,266,311
814,TSLA  ,2023-02-15,2023-03-31,182.5,9,34,43
815,TSLA  ,2023-02-15,2023-03-31,185.0,34,53,87
816,TSLA  ,2023-02-15,2023-03-31,187.5,22,35,57
817,TSLA  ,2023-02-15,2023-03-31,190.0,54,144,198
818,TSLA  ,2023-02-15,2023-03-31,192.5,28,53,81
819,TSLA  ,2023-02-15,2023-03-31,195.0,108,119,227
820,TSLA  ,2023-02-15,2023-03-31,197.5,121,26,147
821,TSLA  ,2023-02-15,2023-03-31,200.0,237,238,475
822,TSLA  ,2023-02-15,2023-03-31,202.5,68,70,138
823,TSLA  ,2023-02-15,2023-03-31,205.0,317,94,411
824,TSLA  ,2023-02-15,2023-03-31,207.5,102,98,200
825,TSLA  ,2023-02-15,2023-03-31,210.0,388,58,446
826,TSLA  ,2023-02-15,2023-03-31,212.5,125,23,148
827,TSLA  ,2023-02-15,2023-03-31,215.0,258,14,272
828,TSLA  ,2023-02-15,2023-03-31,217.5,68,1,69
829,TSLA  ,2023-02-15,2023-03-31,220.0,421,10,431
830,TSLA  ,2023-02-15,2023-03-31,222.5,69,5,74
831,TSLA  ,2023-02-15,2023-03-31,225.0,149,2,151
832,TSLA  ,2023-02-15,2023-03-31,230.0,117,13,130
833,TSLA  ,2023-02-15,2023-03-31,235.0,206,22,228
834,TSLA  ,2023-02-15,2023-03-31,240.0,81,2,83
835,TSLA  ,2023-02-15,2023-03-31,245.0,112,2,114
836,TSLA  ,2023-02-15,2023-03-31,250.0,444,2,446
837,TSLA  ,2023-02-15,2023-03-31,255.0,275,1,276
838,TSLA  ,2023-02-15,2023-03-31,260.0,321,22,343
839,TSLA  ,2023-02-15,2023-03-31,265.0,128,0,128
840,TSLA  ,2023-02-15,2023-03-31,270.0,214,11,225
841,TSLA  ,2023-02-15,2023-03-31,275.0,302,1,303
842,TSLA  ,2023-02-15,2023-03-31,280.0,359,1,360
843,TSLA  ,2023-02-15,2023-03-31,285.0,172,0,172
844,TSLA  ,2023-02-15,2023-03-31,290.0,54,0,54
845,TSLA  ,2023-02-15,2023-03-31,295.0,90,0,90
846,TSLA  ,2023-02-15,2023-03-31,300.0,240,0,240
847,TSLA  ,2023-02-15,2023-03-31,310.0,45,0,45
848,TSLA  ,2023-02-15,2023-03-31,320.0,18,0,18
849,TSLA  ,2023-02-15,2023-03-31,330.0,39,0,39
850,TSLA  ,2023-02-15,2023-03-31,340.0,12,0,12
851,TSLA  ,2023-02-15,2023-03-31,350.0,13,0,13
852,TSLA  ,2023-02-15,2023-03-31,360.0,90,1,91
853,TSLA  ,2023-02-15,2023-04-21,5.0,14,101,115
854,TSLA  ,2023-02-15,2023-04-21,10.0,0,8,8
855,TSLA  ,2023-02-15,2023-04-21,15.0,0,41,41
856,TSLA  ,2023-02-15,2023-04-21,20.0,4,320,324
857,TSLA  ,2023-02-15,2023-04-21,25.0,8,2491,2499
858,TSLA  ,2023-02-15,2023-04-21,30.0,0,3037,3037
859,TSLA  ,2023-02-15,2023-04-21,35.0,5,440,445
860,TSLA  ,2023-02-15,2023-04-21,40.0,6,526,532
861,TSLA  ,2023-02-15,2023-04-21,45.0,2,796,798
862,TSLA  ,2023-02-15,2023-04-21,50.0,128,5068,5196
863,TSLA  ,2023-02-15,2023-04-21,55.0,15,2772,2787
864,TSLA  ,2023-02-15,2023-04-21,60.0,19,1973,1992
865,TSLA  ,2023-02-15,2023-04-21,65.0,65,5213,5278
866,TSLA  ,2023-02-15,2023-04-21,70.0,65,4439,4504
867,TSLA  ,2023-02-15,2023-04-21,75.0,123,13205,13328
868,TSLA  ,2023-02-15,2023-04-21,80.0,25226,4556,29782
869,TSLA  ,2023-02-15,2023-04-21,85.0,90,3307,3397
870,TSLA  ,2023-02-15,2023-04-21,90.0,266,2186,2452
871,TSLA  ,2023-02-15,2023-04-21,95.0,151,6119,6270
872,TSLA  ,2023-02-15,2023-04-21,100.0,1565,24803,26368
873,TSLA  ,2023-02-15,2023-04-21,105.0,359,2758,3117
874,TSLA  ,2023-02-15,2023-04-21,108.33,900,4782,5682
875,TSLA  ,2023-02-15,2023-04-21,110.0,1079,7500,8579
876,TSLA  ,2023-02-15,2023-04-21,115.0,1444,3278,4722
877,TSLA  ,2023-02-15,2023-04-21,116.67,2539,9626,12165
878,TSLA  ,2023-02-15,2023-04-21,120.0,7420,11441,18861
879,TSLA  ,2023-02-15,2023-04-21,125.0,11083,12282,23365
880,TSLA  ,2023-02-15,2023-04-21,130.0,1808,7578,9386
881,TSLA  ,2023-02-15,2023-04-21,133.33,4580,3691,8271
882,TSLA  ,2023-02-15,2023-04-21,135.0,1854,2277,4131
883,TSLA  ,2023-02-15,2023-04-21,140.0,2971,7288,10259
884,TSLA  ,2023-02-15,2023-04-21,141.67,6321,3542,9863
885,TSLA  ,2023-02-15,2023-04-21,145.0,1929,2458,4387
886,TSLA  ,2023-02-15,2023-04-21,150.0,7733,17984,25717
887,TSLA  ,2023-02-15,2023-04-21,155.0,1405,1696,3101
888,TSLA  ,2023-02-15,2023-04-21,158.33,2998,4085,7083
889,TSLA  ,2023-02-15,2023-04-21,160.0,2725,4768,7493
890,TSLA  ,2023-02-15,2023-04-21,165.0,1631,1567,3198
891,TSLA  ,2023-02-15,2023-04-21,166.67,2672,5427,8099
892,TSLA  ,2023-02-15,2023-04-21,170.0,1869,3430,5299
893,TSLA  ,2023-02-15,2023-04-21,175.0,10753,7809,18562
894,TSLA  ,2023-02-15,2023-04-21,180.0,2921,4912,7833
895,TSLA  ,2023-02-15,2023-04-21,183.33,2686,4006,6692
896,TSLA  ,2023-02-15,2023-04-21,185.0,2150,3828,5978
897,TSLA  ,2023-02-15,2023-04-21,190.0,2307,7376,9683
898,TSLA  ,2023-02-15,2023-04-21,191.67,3151,13928,17079
899,TSLA  ,2023-02-15,2023-04-21,195.0,3136,2467,5603
900,TSLA  ,2023-02-15,2023-04-21,200.0,12937,9492,22429
901,TSLA  ,2023-02-15,2023-04-21,205.0,3951,2355,6306
902,TSLA  ,2023-02-15,2023-04-21,208.33,6076,2848,8924
903,TSLA  ,2023-02-15,2023-04-21,210.0,5683,2387,8070
904,TSLA  ,2023-02-15,2023-04-21,215.0,2355,1258,3613
905,TSLA  ,2023-02-15,2023-04-21,216.67,1758,2376,4134
906,TSLA  ,2023-02-15,2023-04-21,220.0,7068,818,7886
907,TSLA  ,2023-02-15,2023-04-21,225.0,8668,1914,10582
908,TSLA  ,2023-02-15,2023-04-21,230.0,1929,498,2427
909,TSLA  ,2023-02-15,2023-04-21,233.33,1623,769,2392
910,TSLA  ,2023-02-15,2023-04-21,235.0,1114,287,1401
911,TSLA  ,2023-02-15,2023-04-21,240.0,13301,545,13846
912,TSLA  ,2023-02-15,2023-04-21,241.67,1148,86,1234
913,TSLA  ,2023-02-15,2023-04-21,243.33,1279,49,1328
914,TSLA  ,2023-02-15,2023-04-21,245.0,1422,149,1571
915,TSLA  ,2023-02-15,2023-04-21,246.67,1370,76,1446
916,TSLA  ,2023-02-15,2023-04-21,248.33,963,330,1293
917,TSLA  ,2023-02-15,2023-04-21,250.0,9048,819,9867
918,TSLA  ,2023-02-15,2023-04-21,251.67,1654,58,1712
919,TSLA  ,2023-02-15,2023-04-21,253.33,407,37,444
920,TSLA  ,2023-02-15,2023-04-21,255.0,1435,36,1471
921,TSLA  ,2023-02-15,2023-04-21,258.33,1098,894,1992
922,TSLA  ,2023-02-15,2023-04-21,260.0,2055,6,2061
923,TSLA  ,2023-02-15,2023-04-21,265.0,501,1,502
924,TSLA  ,2023-02-15,2023-04-21,266.67,1519,189,1708
925,TSLA  ,2023-02-15,2023-04-21,270.0,803,2,805
926,TSLA  ,2023-02-15,2023-04-21,275.0,2209,91,2300
927,TSLA  ,2023-02-15,2023-04-21,280.0,2157,206,2363
928,TSLA  ,2023-02-15,2023-04-21,283.33,1333,213,1546
929,TSLA  ,2023-02-15,2023-04-21,285.0,209,15,224
930,TSLA  ,2023-02-15,2023-04-21,290.0,352,0,352
931,TSLA  ,2023-02-15,2023-04-21,291.67,3079,30,3109
932,TSLA  ,2023-02-15,2023-04-21,295.0,91,0,91
933,TSLA  ,2023-02-15,2023-04-21,300.0,9294,93,9387
934,TSLA  ,2023-02-15,2023-04-21,305.0,130,0,130
935,TSLA  ,2023-02-15,2023-04-21,308.33,4424,26,4450
936,TSLA  ,2023-02-15,2023-04-21,310.0,742,0,742
937,TSLA  ,2023-02-15,2023-04-21,316.67,22110,2,22112
938,TSLA  ,2023-02-15,2023-04-21,325.0,2607,11,2618
939,TSLA  ,2023-02-15,2023-04-21,333.33,4528,0,4528
940,TSLA  ,2023-02-15,2023-04-21,341.67,762,8,770
941,TSLA  ,2023-02-15,2023-04-21,350.0,3276,0,3276
942,TSLA  ,2023-02-15,2023-04-21,358.33,923,0,923
943,TSLA  ,2023-02-15,2023-04-21,366.67,1156,4,1160
944,TSLA  ,2023-02-15,2023-04-21,375.0,1589,16,1605
945,TSLA  ,2023-02-15,2023-04-21,383.33,681,0,681
946,TSLA  ,2023-02-15,2023-04-21,391.67,422,0,422
947,TSLA  ,2023-02-15,2023-04-21,400.0,2913,0,2913
948,TSLA  ,2023-02-15,2023-04-21,408.33,383,0,383
949,TSLA  ,2023-02-15,2023-04-21,416.67,1126,0,1126
950,TSLA  ,2023-02-15,2023-04-21,425.0,4916,0,4916
951,TSLA  ,2023-02-15,2023-04-21,433.33,12432,0,12432
952,TSLA  ,2023-02-15,2023-04-21,441.67,783,0,783
953,TSLA  ,2023-02-15,2023-04-21,450.0,1322,0,1322
954,TSLA  ,2023-02-15,2023-04-21,458.33,3214,0,3214
955,TSLA  ,2023-02-15,2023-04-21,466.67,433,0,433
956,TSLA  ,2023-02-15,2023-04-21,475.0,932,0,932
957,TSLA  ,2023-02-15,2023-04-21,483.33,819,0,819
958,TSLA  ,2023-02-15,2023-04-21,491.67,176,0,176
959,TSLA  ,2023-02-15,2023-04-21,500.0,3577,0,3577
960,TSLA  ,2023-02-15,2023-04-21,508.33,901,0,901
961,TSLA  ,2023-02-15,2023-04-21,516.67,505,0,505
962,TSLA  ,2023-02-15,2023-04-21,525.0,456,0,456
963,TSLA  ,2023-02-15,2023-04-21,533.33,495,0,495
964,TSLA  ,2023-02-15,2023-04-21,541.67,555,0,555
965,TSLA  ,2023-02-15,2023-04-21,550.0,11220,0,11220
966,TSLA  ,2023-02-15,2023-04-21,558.33,317,0,317
967,TSLA  ,2023-02-15,2023-04-21,566.67,626,0,626
968,TSLA  ,2023-02-15,2023-04-21,575.0,1599,0,1599
969,TSLA  ,2023-02-15,2023-04-21,583.33,994,0,994
970,TSLA  ,2023-02-15,2023-04-21,600.0,20942,0,20942
971,TSLA  ,2023-02-15,2023-05-19,50.0,62,2864,2926
972,TSLA  ,2023-02-15,2023-05-19,55.0,51,601,652
973,TSLA  ,2023-02-15,2023-05-19,60.0,159,945,1104
974,TSLA  ,2023-02-15,2023-05-19,65.0,64,438,502
975,TSLA  ,2023-02-15,2023-05-19,70.0,178,1430,1608
976,TSLA  ,2023-02-15,2023-05-19,75.0,135,1683,1818
977,TSLA  ,2023-02-15,2023-05-19,80.0,85,1571,1656
978,TSLA  ,2023-02-15,2023-05-19,85.0,63,1779,1842
979,TSLA  ,2023-02-15,2023-05-19,90.0,243,2750,2993
980,TSLA  ,2023-02-15,2023-05-19,95.0,132,1725,1857
981,TSLA  ,2023-02-15,2023-05-19,100.0,1081,19583,20664
982,TSLA  ,2023-02-15,2023-05-19,105.0,275,6135,6410
983,TSLA  ,2023-02-15,2023-05-19,110.0,16001,7219,23220
984,TSLA  ,2023-02-15,2023-05-19,115.0,1366,1923,3289
985,TSLA  ,2023-02-15,2023-05-19,120.0,2136,7955,10091
986,TSLA  ,2023-02-15,2023-05-19,125.0,3719,2548,6267
987,TSLA  ,2023-02-15,2023-05-19,130.0,2691,5024,7715
988,TSLA  ,2023-02-15,2023-05-19,135.0,2011,2127,4138
989,TSLA  ,2023-02-15,2023-05-19,140.0,1885,11598,13483
990,TSLA  ,2023-02-15,2023-05-19,145.0,2347,2209,4556
991,TSLA  ,2023-02-15,2023-05-19,150.0,3948,4806,8754
992,TSLA  ,2023-02-15,2023-05-19,155.0,1470,1673,3143
993,TSLA  ,2023-02-15,2023-05-19,160.0,3131,4700,7831
994,TSLA  ,2023-02-15,2023-05-19,165.0,1389,1500,2889
995,TSLA  ,2023-02-15,2023-05-19,170.0,2783,4952,7735
996,TSLA  ,2023-02-15,2023-05-19,175.0,2048,1860,3908
997,TSLA  ,2023-02-15,2023-05-19,180.0,8035,4083,12118
998,TSLA  ,2023-02-15,2023-05-19,185.0,1746,1511,3257
999,TSLA  ,2023-02-15,2023-05-19,190.0,2807,3165,5972
1000,TSLA  ,2023-02-15,2023-05-19,195.0,2862,2294,5156
1001,TSLA  ,2023-02-15,2023-05-19,200.0,7992,2496,10488
1002,TSLA  ,2023-02-15,2023-05-19,205.0,3562,1395,4957
1003,TSLA  ,2023-02-15,2023-05-19,210.0,9917,914,10831
1004,TSLA  ,2023-02-15,2023-05-19,215.0,25408,1342,26750
1005,TSLA  ,2023-02-15,2023-05-19,220.0,7425,1146,8571
1006,TSLA  ,2023-02-15,2023-05-19,225.0,1522,499,2021
1007,TSLA  ,2023-02-15,2023-05-19,230.0,2474,406,2880
1008,TSLA  ,2023-02-15,2023-05-19,235.0,1184,160,1344
1009,TSLA  ,2023-02-15,2023-05-19,240.0,2191,102,2293
1010,TSLA  ,2023-02-15,2023-05-19,245.0,663,135,798
1011,TSLA  ,2023-02-15,2023-05-19,250.0,2658,41,2699
1012,TSLA  ,2023-02-15,2023-05-19,260.0,714,117,831
1013,TSLA  ,2023-02-15,2023-05-19,270.0,2404,132,2536
1014,TSLA  ,2023-02-15,2023-05-19,280.0,614,22,636
1015,TSLA  ,2023-02-15,2023-05-19,290.0,397,367,764
1016,TSLA  ,2023-02-15,2023-05-19,300.0,1364,543,1907
1017,TSLA  ,2023-02-15,2023-05-19,310.0,517,5252,5769
1018,TSLA  ,2023-02-15,2023-05-19,320.0,850,1169,2019
1019,TSLA  ,2023-02-15,2023-05-19,330.0,468,26,494
1020,TSLA  ,2023-02-15,2023-05-19,340.0,396,3,399
1021,TSLA  ,2023-02-15,2023-05-19,350.0,315,5,320
1022,TSLA  ,2023-02-15,2023-05-19,360.0,752,1,753
1023,TSLA  ,2023-02-15,2023-05-19,370.0,108,0,108
1024,TSLA  ,2023-02-15,2023-05-19,380.0,113,0,113
1025,TSLA  ,2023-02-15,2023-05-19,390.0,861,0,861
1026,TSLA  ,2023-02-15,2023-06-16,1.67,106,41911,42017
1027,TSLA  ,2023-02-15,2023-06-16,3.33,399,5010,5409
1028,TSLA  ,2023-02-15,2023-06-16,5.0,108,1684,1792
1029,TSLA  ,2023-02-15,2023-06-16,6.67,75,1309,1384
1030,TSLA  ,2023-02-15,2023-06-16,8.33,425,2371,2796
1031,TSLA  ,2023-02-15,2023-06-16,10.0,3233,3746,6979
1032,TSLA  ,2023-02-15,2023-06-16,11.67,155,8573,8728
1033,TSLA  ,2023-02-15,2023-06-16,13.33,1234,5645,6879
1034,TSLA  ,2023-02-15,2023-06-16,15.0,168,4103,4271
1035,TSLA  ,2023-02-15,2023-06-16,16.67,489,9827,10316
1036,TSLA  ,2023-02-15,2023-06-16,18.33,93,4965,5058
1037,TSLA  ,2023-02-15,2023-06-16,33.33,862,16804,17666
1038,TSLA  ,2023-02-15,2023-06-16,50.0,1110,17420,18530
1039,TSLA  ,2023-02-15,2023-06-16,55.0,31,7343,7374
1040,TSLA  ,2023-02-15,2023-06-16,60.0,15,2294,2309
1041,TSLA  ,2023-02-15,2023-06-16,65.0,4,625,629
1042,TSLA  ,2023-02-15,2023-06-16,66.67,1012,14262,15274
1043,TSLA  ,2023-02-15,2023-06-16,70.0,51,4057,4108
1044,TSLA  ,2023-02-15,2023-06-16,75.0,89,6633,6722
1045,TSLA  ,2023-02-15,2023-06-16,80.0,184,3782,3966
1046,TSLA  ,2023-02-15,2023-06-16,83.33,712,5056,5768
1047,TSLA  ,2023-02-15,2023-06-16,85.0,86,4267,4353
1048,TSLA  ,2023-02-15,2023-06-16,90.0,202,3714,3916
1049,TSLA  ,2023-02-15,2023-06-16,95.0,123,1587,1710
1050,TSLA  ,2023-02-15,2023-06-16,100.0,3481,27939,31420
1051,TSLA  ,2023-02-15,2023-06-16,105.0,362,5350,5712
1052,TSLA  ,2023-02-15,2023-06-16,110.0,1181,5646,6827
1053,TSLA  ,2023-02-15,2023-06-16,115.0,595,2736,3331
1054,TSLA  ,2023-02-15,2023-06-16,116.67,1786,5308,7094
1055,TSLA  ,2023-02-15,2023-06-16,120.0,3436,9886,13322
1056,TSLA  ,2023-02-15,2023-06-16,123.33,456,1140,1596
1057,TSLA  ,2023-02-15,2023-06-16,125.0,4156,6982,11138
1058,TSLA  ,2023-02-15,2023-06-16,126.67,866,1313,2179
1059,TSLA  ,2023-02-15,2023-06-16,130.0,3687,9268,12955
1060,TSLA  ,2023-02-15,2023-06-16,133.33,2532,8743,11275
1061,TSLA  ,2023-02-15,2023-06-16,135.0,2740,2696,5436
1062,TSLA  ,2023-02-15,2023-06-16,136.67,1080,2573,3653
1063,TSLA  ,2023-02-15,2023-06-16,140.0,7788,6515,14303
1064,TSLA  ,2023-02-15,2023-06-16,143.33,1237,3303,4540
1065,TSLA  ,2023-02-15,2023-06-16,145.0,2164,3434,5598
1066,TSLA  ,2023-02-15,2023-06-16,146.67,1586,1944,3530
1067,TSLA  ,2023-02-15,2023-06-16,150.0,12754,13556,26310
1068,TSLA  ,2023-02-15,2023-06-16,153.33,2435,3254,5689
1069,TSLA  ,2023-02-15,2023-06-16,155.0,1230,3116,4346
1070,TSLA  ,2023-02-15,2023-06-16,156.67,1643,794,2437
1071,TSLA  ,2023-02-15,2023-06-16,160.0,6588,7183,13771
1072,TSLA  ,2023-02-15,2023-06-16,163.33,976,1215,2191
1073,TSLA  ,2023-02-15,2023-06-16,165.0,1818,2934,4752
1074,TSLA  ,2023-02-15,2023-06-16,166.67,3662,12974,16636
1075,TSLA  ,2023-02-15,2023-06-16,170.0,2745,4355,7100
1076,TSLA  ,2023-02-15,2023-06-16,173.33,1453,6324,7777
1077,TSLA  ,2023-02-15,2023-06-16,175.0,2766,5562,8328
1078,TSLA  ,2023-02-15,2023-06-16,180.0,8333,8822,17155
1079,TSLA  ,2023-02-15,2023-06-16,183.33,9939,10318,20257
1080,TSLA  ,2023-02-15,2023-06-16,185.0,8015,7030,15045
1081,TSLA  ,2023-02-15,2023-06-16,186.67,963,1950,2913
1082,TSLA  ,2023-02-15,2023-06-16,190.0,5876,4732,10608
1083,TSLA  ,2023-02-15,2023-06-16,193.33,1859,7783,9642
1084,TSLA  ,2023-02-15,2023-06-16,195.0,2693,2702,5395
1085,TSLA  ,2023-02-15,2023-06-16,200.0,25968,24411,50379
1086,TSLA  ,2023-02-15,2023-06-16,205.0,2617,1163,3780
1087,TSLA  ,2023-02-15,2023-06-16,206.67,2370,3078,5448
1088,TSLA  ,2023-02-15,2023-06-16,210.0,4757,3308,8065
1089,TSLA  ,2023-02-15,2023-06-16,213.33,1900,2625,4525
1090,TSLA  ,2023-02-15,2023-06-16,215.0,3401,1196,4597
1091,TSLA  ,2023-02-15,2023-06-16,216.67,6651,6150,12801
1092,TSLA  ,2023-02-15,2023-06-16,220.0,7757,6942,14699
1093,TSLA  ,2023-02-15,2023-06-16,225.0,2323,1251,3574
1094,TSLA  ,2023-02-15,2023-06-16,226.67,2685,2104,4789
1095,TSLA  ,2023-02-15,2023-06-16,230.0,7147,3016,10163
1096,TSLA  ,2023-02-15,2023-06-16,233.33,11371,7541,18912
1097,TSLA  ,2023-02-15,2023-06-16,235.0,3578,701,4279
1098,TSLA  ,2023-02-15,2023-06-16,240.0,7886,2894,10780
1099,TSLA  ,2023-02-15,2023-06-16,243.33,1309,1694,3003
1100,TSLA  ,2023-02-15,2023-06-16,245.0,1862,65,1927
1101,TSLA  ,2023-02-15,2023-06-16,246.67,3028,90,3118
1102,TSLA  ,2023-02-15,2023-06-16,250.0,15171,3421,18592
1103,TSLA  ,2023-02-15,2023-06-16,253.33,1385,195,1580
1104,TSLA  ,2023-02-15,2023-06-16,255.0,1198,73,1271
1105,TSLA  ,2023-02-15,2023-06-16,260.0,5136,80,5216
1106,TSLA  ,2023-02-15,2023-06-16,265.0,2412,56,2468
1107,TSLA  ,2023-02-15,2023-06-16,266.67,7288,408,7696
1108,TSLA  ,2023-02-15,2023-06-16,270.0,1363,6,1369
1109,TSLA  ,2023-02-15,2023-06-16,273.33,1331,1051,2382
1110,TSLA  ,2023-02-15,2023-06-16,275.0,2335,5,2340
1111,TSLA  ,2023-02-15,2023-06-16,280.0,3920,61,3981
1112,TSLA  ,2023-02-15,2023-06-16,283.33,4643,51,4694
1113,TSLA  ,2023-02-15,2023-06-16,285.0,1022,2,1024
1114,TSLA  ,2023-02-15,2023-06-16,286.67,756,30,786
1115,TSLA  ,2023-02-15,2023-06-16,290.0,723,828,1551
1116,TSLA  ,2023-02-15,2023-06-16,293.33,1623,62,1685
1117,TSLA  ,2023-02-15,2023-06-16,295.0,289,258,547
1118,TSLA  ,2023-02-15,2023-06-16,300.0,18119,181,18300
1119,TSLA  ,2023-02-15,2023-06-16,305.0,927,5,932
1120,TSLA  ,2023-02-15,2023-06-16,306.67,1437,30,1467
1121,TSLA  ,2023-02-15,2023-06-16,310.0,1686,44,1730
1122,TSLA  ,2023-02-15,2023-06-16,313.33,537,33,570
1123,TSLA  ,2023-02-15,2023-06-16,315.0,341,82,423
1124,TSLA  ,2023-02-15,2023-06-16,316.67,7180,241,7421
1125,TSLA  ,2023-02-15,2023-06-16,320.0,2456,3,2459
1126,TSLA  ,2023-02-15,2023-06-16,326.67,9725,6,9731
1127,TSLA  ,2023-02-15,2023-06-16,330.0,1474,49,1523
1128,TSLA  ,2023-02-15,2023-06-16,333.33,33894,231,34125
1129,TSLA  ,2023-02-15,2023-06-16,340.0,1643,3,1646
1130,TSLA  ,2023-02-15,2023-06-16,346.67,1321,0,1321
1131,TSLA  ,2023-02-15,2023-06-16,350.0,8552,334,8886
1132,TSLA  ,2023-02-15,2023-06-16,353.33,982,0,982
1133,TSLA  ,2023-02-15,2023-06-16,360.0,1869,1,1870
1134,TSLA  ,2023-02-15,2023-06-16,366.67,10952,450,11402
1135,TSLA  ,2023-02-15,2023-06-16,370.0,939,0,939
1136,TSLA  ,2023-02-15,2023-06-16,383.33,10914,0,10914
1137,TSLA  ,2023-02-15,2023-06-16,400.0,18510,919,19429
1138,TSLA  ,2023-02-15,2023-06-16,416.67,3620,0,3620
1139,TSLA  ,2023-02-15,2023-06-16,433.33,9680,0,9680
1140,TSLA  ,2023-02-15,2023-06-16,450.0,8238,1,8239
1141,TSLA  ,2023-02-15,2023-06-16,466.67,20895,0,20895
1142,TSLA  ,2023-02-15,2023-06-16,483.33,8286,0,8286
1143,TSLA  ,2023-02-15,2023-06-16,500.0,21300,0,21300
1144,TSLA  ,2023-02-15,2023-06-16,516.67,2697,0,2697
1145,TSLA  ,2023-02-15,2023-06-16,533.33,4869,0,4869
1146,TSLA  ,2023-02-15,2023-06-16,550.0,6105,0,6105
1147,TSLA  ,2023-02-15,2023-06-16,558.33,1699,0,1699
1148,TSLA  ,2023-02-15,2023-06-16,566.67,1264,0,1264
1149,TSLA  ,2023-02-15,2023-06-16,575.0,692,0,692
1150,TSLA  ,2023-02-15,2023-06-16,583.33,1200,0,1200
1151,TSLA  ,2023-02-15,2023-06-16,591.67,391,0,391
1152,TSLA  ,2023-02-15,2023-06-16,600.0,6745,0,6745
1153,TSLA  ,2023-02-15,2023-06-16,608.33,1140,0,1140
1154,TSLA  ,2023-02-15,2023-06-16,616.67,598,0,598
1155,TSLA  ,2023-02-15,2023-06-16,625.0,2170,0,2170
1156,TSLA  ,2023-02-15,2023-06-16,633.33,5396,0,5396
1157,TSLA  ,2023-02-15,2023-06-16,641.67,436,0,436
1158,TSLA  ,2023-02-15,2023-06-16,650.0,591,0,591
1159,TSLA  ,2023-02-15,2023-06-16,666.67,18094,0,18094
1160,TSLA  ,2023-02-15,2023-06-16,675.0,921,0,921
1161,TSLA  ,2023-02-15,2023-06-16,683.33,605,0,605
1162,TSLA  ,2023-02-15,2023-06-16,691.67,886,0,886
1163,TSLA  ,2023-02-15,2023-06-16,700.0,2723,0,2723
1164,TSLA  ,2023-02-15,2023-06-16,708.33,547,0,547
1165,TSLA  ,2023-02-15,2023-06-16,716.67,715,0,715
1166,TSLA  ,2023-02-15,2023-06-16,725.0,1170,0,1170
1167,TSLA  ,2023-02-15,2023-06-16,733.33,2256,0,2256
1168,TSLA  ,2023-02-15,2023-06-16,741.67,772,0,772
1169,TSLA  ,2023-02-15,2023-06-16,750.0,11840,0,11840
1170,TSLA  ,2023-02-15,2023-06-16,758.33,1298,0,1298
1171,TSLA  ,2023-02-15,2023-06-16,766.67,1263,0,1263
1172,TSLA  ,2023-02-15,2023-06-16,775.0,1129,0,1129
1173,TSLA  ,2023-02-15,2023-06-16,783.33,2176,0,2176
1174,TSLA  ,2023-02-15,2023-06-16,791.67,1881,0,1881
1175,TSLA  ,2023-02-15,2023-06-16,800.0,9998,0,9998
1176,TSLA  ,2023-02-15,2023-06-16,808.33,1233,0,1233
1177,TSLA  ,2023-02-15,2023-06-16,816.67,1799,0,1799
1178,TSLA  ,2023-02-15,2023-06-16,825.0,43100,0,43100
1179,TSLA  ,2023-02-15,2023-07-21,5.0,32,721,753
1180,TSLA  ,2023-02-15,2023-07-21,10.0,5,906,911
1181,TSLA  ,2023-02-15,2023-07-21,15.0,4,383,387
1182,TSLA  ,2023-02-15,2023-07-21,20.0,12,1205,1217
1183,TSLA  ,2023-02-15,2023-07-21,25.0,25,1090,1115
1184,TSLA  ,2023-02-15,2023-07-21,30.0,111,1375,1486
1185,TSLA  ,2023-02-15,2023-07-21,35.0,45,837,882
1186,TSLA  ,2023-02-15,2023-07-21,40.0,21,1135,1156
1187,TSLA  ,2023-02-15,2023-07-21,45.0,38,630,668
1188,TSLA  ,2023-02-15,2023-07-21,50.0,70,5075,5145
1189,TSLA  ,2023-02-15,2023-07-21,55.0,86,1856,1942
1190,TSLA  ,2023-02-15,2023-07-21,60.0,94,3345,3439
1191,TSLA  ,2023-02-15,2023-07-21,65.0,89,406,495
1192,TSLA  ,2023-02-15,2023-07-21,70.0,25,2404,2429
1193,TSLA  ,2023-02-15,2023-07-21,75.0,63,4197,4260
1194,TSLA  ,2023-02-15,2023-07-21,80.0,79,3655,3734
1195,TSLA  ,2023-02-15,2023-07-21,85.0,54,1391,1445
1196,TSLA  ,2023-02-15,2023-07-21,90.0,121,3419,3540
1197,TSLA  ,2023-02-15,2023-07-21,95.0,66,1618,1684
1198,TSLA  ,2023-02-15,2023-07-21,100.0,296,5710,6006
1199,TSLA  ,2023-02-15,2023-07-21,105.0,377,2494,2871
1200,TSLA  ,2023-02-15,2023-07-21,110.0,1128,3033,4161
1201,TSLA  ,2023-02-15,2023-07-21,115.0,467,1023,1490
1202,TSLA  ,2023-02-15,2023-07-21,120.0,1241,4570,5811
1203,TSLA  ,2023-02-15,2023-07-21,125.0,1417,2186,3603
1204,TSLA  ,2023-02-15,2023-07-21,130.0,1499,1780,3279
1205,TSLA  ,2023-02-15,2023-07-21,135.0,1149,2860,4009
1206,TSLA  ,2023-02-15,2023-07-21,140.0,1470,3219,4689
1207,TSLA  ,2023-02-15,2023-07-21,145.0,1059,2294,3353
1208,TSLA  ,2023-02-15,2023-07-21,150.0,3173,3834,7007
1209,TSLA  ,2023-02-15,2023-07-21,155.0,1684,2875,4559
1210,TSLA  ,2023-02-15,2023-07-21,160.0,1764,1505,3269
1211,TSLA  ,2023-02-15,2023-07-21,165.0,671,1418,2089
1212,TSLA  ,2023-02-15,2023-07-21,170.0,1769,2211,3980
1213,TSLA  ,2023-02-15,2023-07-21,175.0,1636,1477,3113
1214,TSLA  ,2023-02-15,2023-07-21,180.0,2118,1924,4042
1215,TSLA  ,2023-02-15,2023-07-21,185.0,3948,13288,17236
1216,TSLA  ,2023-02-15,2023-07-21,190.0,2840,2284,5124
1217,TSLA  ,2023-02-15,2023-07-21,195.0,1449,1929,3378
1218,TSLA  ,2023-02-15,2023-07-21,200.0,4342,2540,6882
1219,TSLA  ,2023-02-15,2023-07-21,205.0,2237,1026,3263
1220,TSLA  ,2023-02-15,2023-07-21,210.0,4571,1764,6335
1221,TSLA  ,2023-02-15,2023-07-21,215.0,3494,1273,4767
1222,TSLA  ,2023-02-15,2023-07-21,220.0,2899,1845,4744
1223,TSLA  ,2023-02-15,2023-07-21,225.0,5154,2173,7327
1224,TSLA  ,2023-02-15,2023-07-21,230.0,2041,1306,3347
1225,TSLA  ,2023-02-15,2023-07-21,235.0,1451,661,2112
1226,TSLA  ,2023-02-15,2023-07-21,240.0,2494,1738,4232
1227,TSLA  ,2023-02-15,2023-07-21,245.0,2468,678,3146
1228,TSLA  ,2023-02-15,2023-07-21,250.0,24419,1577,25996
1229,TSLA  ,2023-02-15,2023-07-21,255.0,935,644,1579
1230,TSLA  ,2023-02-15,2023-07-21,260.0,1473,83,1556
1231,TSLA  ,2023-02-15,2023-07-21,265.0,592,9,601
1232,TSLA  ,2023-02-15,2023-07-21,270.0,747,126,873
1233,TSLA  ,2023-02-15,2023-07-21,275.0,375,82,457
1234,TSLA  ,2023-02-15,2023-07-21,280.0,1163,147,1310
1235,TSLA  ,2023-02-15,2023-07-21,285.0,1047,147,1194
1236,TSLA  ,2023-02-15,2023-07-21,290.0,437,35,472
1237,TSLA  ,2023-02-15,2023-07-21,295.0,340,11,351
1238,TSLA  ,2023-02-15,2023-07-21,300.0,2316,9,2325
1239,TSLA  ,2023-02-15,2023-07-21,305.0,240,6,246
1240,TSLA  ,2023-02-15,2023-07-21,310.0,1375,6,1381
1241,TSLA  ,2023-02-15,2023-07-21,315.0,395,1,396
1242,TSLA  ,2023-02-15,2023-07-21,320.0,578,0,578
1243,TSLA  ,2023-02-15,2023-07-21,325.0,680,0,680
1244,TSLA  ,2023-02-15,2023-07-21,330.0,428,25,453
1245,TSLA  ,2023-02-15,2023-07-21,335.0,164,7,171
1246,TSLA  ,2023-02-15,2023-07-21,340.0,437,16,453
1247,TSLA  ,2023-02-15,2023-07-21,345.0,186,0,186
1248,TSLA  ,2023-02-15,2023-07-21,350.0,741,1,742
1249,TSLA  ,2023-02-15,2023-07-21,355.0,266,1,267
1250,TSLA  ,2023-02-15,2023-07-21,360.0,558,0,558
1251,TSLA  ,2023-02-15,2023-07-21,365.0,875,0,875
1252,TSLA  ,2023-02-15,2023-07-21,370.0,1053,0,1053
1253,TSLA  ,2023-02-15,2023-07-21,375.0,3152,0,3152
1254,TSLA  ,2023-02-15,2023-07-21,380.0,169,0,169
1255,TSLA  ,2023-02-15,2023-07-21,390.0,633,0,633
1256,TSLA  ,2023-02-15,2023-09-15,1.67,861,20022,20883
1257,TSLA  ,2023-02-15,2023-09-15,3.33,1085,2849,3934
1258,TSLA  ,2023-02-15,2023-09-15,5.0,25,942,967
1259,TSLA  ,2023-02-15,2023-09-15,6.67,29,3367,3396
1260,TSLA  ,2023-02-15,2023-09-15,8.33,32,1178,1210
1261,TSLA  ,2023-02-15,2023-09-15,10.0,26,2496,2522
1262,TSLA  ,2023-02-15,2023-09-15,11.67,49,617,666
1263,TSLA  ,2023-02-15,2023-09-15,13.33,83,230,313
1264,TSLA  ,2023-02-15,2023-09-15,15.0,0,116,116
1265,TSLA  ,2023-02-15,2023-09-15,16.67,143,4197,4340
1266,TSLA  ,2023-02-15,2023-09-15,30.0,0,74,74
1267,TSLA  ,2023-02-15,2023-09-15,33.33,3118,11362,14480
1268,TSLA  ,2023-02-15,2023-09-15,35.0,5,36,41
1269,TSLA  ,2023-02-15,2023-09-15,40.0,6,272,278
1270,TSLA  ,2023-02-15,2023-09-15,45.0,9,49,58
1271,TSLA  ,2023-02-15,2023-09-15,50.0,418,7547,7965
1272,TSLA  ,2023-02-15,2023-09-15,55.0,23,2374,2397
1273,TSLA  ,2023-02-15,2023-09-15,60.0,30,4722,4752
1274,TSLA  ,2023-02-15,2023-09-15,65.0,4,2122,2126
1275,TSLA  ,2023-02-15,2023-09-15,66.67,434,5681,6115
1276,TSLA  ,2023-02-15,2023-09-15,70.0,86,613,699
1277,TSLA  ,2023-02-15,2023-09-15,75.0,26,636,662
1278,TSLA  ,2023-02-15,2023-09-15,80.0,260,844,1104
1279,TSLA  ,2023-02-15,2023-09-15,83.33,407,4464,4871
1280,TSLA  ,2023-02-15,2023-09-15,85.0,52,322,374
1281,TSLA  ,2023-02-15,2023-09-15,90.0,485,2679,3164
1282,TSLA  ,2023-02-15,2023-09-15,95.0,70,2476,2546
1283,TSLA  ,2023-02-15,2023-09-15,100.0,2364,11889,14253
1284,TSLA  ,2023-02-15,2023-09-15,105.0,88,2152,2240
1285,TSLA  ,2023-02-15,2023-09-15,108.33,397,2143,2540
1286,TSLA  ,2023-02-15,2023-09-15,110.0,1243,1506,2749
1287,TSLA  ,2023-02-15,2023-09-15,115.0,184,2720,2904
1288,TSLA  ,2023-02-15,2023-09-15,116.67,569,12229,12798
1289,TSLA  ,2023-02-15,2023-09-15,120.0,1648,2051,3699
1290,TSLA  ,2023-02-15,2023-09-15,123.33,543,1353,1896
1291,TSLA  ,2023-02-15,2023-09-15,125.0,1731,7620,9351
1292,TSLA  ,2023-02-15,2023-09-15,126.67,130,1071,1201
1293,TSLA  ,2023-02-15,2023-09-15,130.0,1407,4930,6337
1294,TSLA  ,2023-02-15,2023-09-15,133.33,213,2369,2582
1295,TSLA  ,2023-02-15,2023-09-15,135.0,206,1220,1426
1296,TSLA  ,2023-02-15,2023-09-15,136.67,285,954,1239
1297,TSLA  ,2023-02-15,2023-09-15,140.0,1762,2191,3953
1298,TSLA  ,2023-02-15,2023-09-15,141.67,763,1679,2442
1299,TSLA  ,2023-02-15,2023-09-15,143.33,283,1539,1822
1300,TSLA  ,2023-02-15,2023-09-15,145.0,365,2607,2972
1301,TSLA  ,2023-02-15,2023-09-15,146.67,1372,1084,2456
1302,TSLA  ,2023-02-15,2023-09-15,150.0,33798,9229,43027
1303,TSLA  ,2023-02-15,2023-09-15,153.33,30477,1844,32321
1304,TSLA  ,2023-02-15,2023-09-15,155.0,419,386,805
1305,TSLA  ,2023-02-15,2023-09-15,156.67,394,605,999
1306,TSLA  ,2023-02-15,2023-09-15,158.33,314,556,870
1307,TSLA  ,2023-02-15,2023-09-15,160.0,3719,7149,10868
1308,TSLA  ,2023-02-15,2023-09-15,163.33,414,1492,1906
1309,TSLA  ,2023-02-15,2023-09-15,165.0,1290,854,2144
1310,TSLA  ,2023-02-15,2023-09-15,166.67,1395,3079,4474
1311,TSLA  ,2023-02-15,2023-09-15,170.0,656,707,1363
1312,TSLA  ,2023-02-15,2023-09-15,173.33,10314,2962,13276
1313,TSLA  ,2023-02-15,2023-09-15,175.0,10933,7566,18499
1314,TSLA  ,2023-02-15,2023-09-15,180.0,33730,6699,40429
1315,TSLA  ,2023-02-15,2023-09-15,183.33,32299,5242,37541
1316,TSLA  ,2023-02-15,2023-09-15,185.0,337,800,1137
1317,TSLA  ,2023-02-15,2023-09-15,186.67,515,3460,3975
1318,TSLA  ,2023-02-15,2023-09-15,190.0,708,2911,3619
1319,TSLA  ,2023-02-15,2023-09-15,191.67,484,1161,1645
1320,TSLA  ,2023-02-15,2023-09-15,193.33,880,2931,3811
1321,TSLA  ,2023-02-15,2023-09-15,195.0,433,783,1216
1322,TSLA  ,2023-02-15,2023-09-15,200.0,11998,17179,29177
1323,TSLA  ,2023-02-15,2023-09-15,205.0,447,400,847
1324,TSLA  ,2023-02-15,2023-09-15,206.67,1061,657,1718
1325,TSLA  ,2023-02-15,2023-09-15,208.33,560,1991,2551
1326,TSLA  ,2023-02-15,2023-09-15,210.0,2413,370,2783
1327,TSLA  ,2023-02-15,2023-09-15,213.33,646,1292,1938
1328,TSLA  ,2023-02-15,2023-09-15,215.0,725,195,920
1329,TSLA  ,2023-02-15,2023-09-15,216.67,1821,4089,5910
1330,TSLA  ,2023-02-15,2023-09-15,220.0,7431,4168,11599
1331,TSLA  ,2023-02-15,2023-09-15,225.0,2720,3306,6026
1332,TSLA  ,2023-02-15,2023-09-15,226.67,2243,1500,3743
1333,TSLA  ,2023-02-15,2023-09-15,230.0,3459,887,4346
1334,TSLA  ,2023-02-15,2023-09-15,233.33,2796,3437,6233
1335,TSLA  ,2023-02-15,2023-09-15,235.0,774,744,1518
1336,TSLA  ,2023-02-15,2023-09-15,240.0,1394,2524,3918
1337,TSLA  ,2023-02-15,2023-09-15,241.67,1367,829,2196
1338,TSLA  ,2023-02-15,2023-09-15,245.0,174,211,385
1339,TSLA  ,2023-02-15,2023-09-15,246.67,483,488,971
1340,TSLA  ,2023-02-15,2023-09-15,250.0,10688,4568,15256
1341,TSLA  ,2023-02-15,2023-09-15,253.33,793,542,1335
1342,TSLA  ,2023-02-15,2023-09-15,255.0,289,12,301
1343,TSLA  ,2023-02-15,2023-09-15,258.33,946,2408,3354
1344,TSLA  ,2023-02-15,2023-09-15,260.0,11915,1419,13334
1345,TSLA  ,2023-02-15,2023-09-15,265.0,299,150,449
1346,TSLA  ,2023-02-15,2023-09-15,266.67,2381,319,2700
1347,TSLA  ,2023-02-15,2023-09-15,270.0,440,162,602
1348,TSLA  ,2023-02-15,2023-09-15,273.33,716,354,1070
1349,TSLA  ,2023-02-15,2023-09-15,275.0,2805,342,3147
1350,TSLA  ,2023-02-15,2023-09-15,280.0,2136,575,2711
1351,TSLA  ,2023-02-15,2023-09-15,283.33,1263,315,1578
1352,TSLA  ,2023-02-15,2023-09-15,286.67,604,97,701
1353,TSLA  ,2023-02-15,2023-09-15,290.0,1343,65,1408
1354,TSLA  ,2023-02-15,2023-09-15,291.67,991,376,1367
1355,TSLA  ,2023-02-15,2023-09-15,293.33,1350,402,1752
1356,TSLA  ,2023-02-15,2023-09-15,300.0,7536,965,8501
1357,TSLA  ,2023-02-15,2023-09-15,306.67,2706,327,3033
1358,TSLA  ,2023-02-15,2023-09-15,308.33,846,335,1181
1359,TSLA  ,2023-02-15,2023-09-15,310.0,107,0,107
1360,TSLA  ,2023-02-15,2023-09-15,313.33,796,286,1082
1361,TSLA  ,2023-02-15,2023-09-15,316.67,1591,161,1752
1362,TSLA  ,2023-02-15,2023-09-15,320.0,1806,169,1975
1363,TSLA  ,2023-02-15,2023-09-15,325.0,2755,75,2830
1364,TSLA  ,2023-02-15,2023-09-15,326.67,1070,5,1075
1365,TSLA  ,2023-02-15,2023-09-15,333.33,6443,83,6526
1366,TSLA  ,2023-02-15,2023-09-15,340.0,23328,147,23475
1367,TSLA  ,2023-02-15,2023-09-15,341.67,179,187,366
1368,TSLA  ,2023-02-15,2023-09-15,346.67,549,135,684
1369,TSLA  ,2023-02-15,2023-09-15,350.0,21051,328,21379
1370,TSLA  ,2023-02-15,2023-09-15,353.33,22646,149,22795
1371,TSLA  ,2023-02-15,2023-09-15,358.33,470,287,757
1372,TSLA  ,2023-02-15,2023-09-15,360.0,3247,305,3552
1373,TSLA  ,2023-02-15,2023-09-15,366.67,2814,561,3375
1374,TSLA  ,2023-02-15,2023-09-15,375.0,3277,160,3437
1375,TSLA  ,2023-02-15,2023-09-15,383.33,4642,17,4659
1376,TSLA  ,2023-02-15,2023-09-15,391.67,838,14,852
1377,TSLA  ,2023-02-15,2023-09-15,400.0,5671,69,5740
1378,TSLA  ,2023-02-15,2023-09-15,408.33,1570,1,1571
1379,TSLA  ,2023-02-15,2023-09-15,416.67,975,0,975
1380,TSLA  ,2023-02-15,2023-09-15,425.0,3225,0,3225
1381,TSLA  ,2023-02-15,2023-09-15,433.33,4937,8,4945
1382,TSLA  ,2023-02-15,2023-09-15,441.67,1035,0,1035
1383,TSLA  ,2023-02-15,2023-09-15,450.0,2445,0,2445
1384,TSLA  ,2023-02-15,2023-09-15,458.33,402,0,402
1385,TSLA  ,2023-02-15,2023-09-15,466.67,2696,0,2696
1386,TSLA  ,2023-02-15,2023-09-15,475.0,340,0,340
1387,TSLA  ,2023-02-15,2023-09-15,483.33,669,0,669
1388,TSLA  ,2023-02-15,2023-09-15,491.67,1097,0,1097
1389,TSLA  ,2023-02-15,2023-09-15,500.0,5479,0,5479
1390,TSLA  ,2023-02-15,2023-09-15,508.33,811,0,811
1391,TSLA  ,2023-02-15,2023-09-15,516.67,1277,0,1277
1392,TSLA  ,2023-02-15,2023-09-15,525.0,1190,0,1190
1393,TSLA  ,2023-02-15,2023-09-15,533.33,1594,0,1594
1394,TSLA  ,2023-02-15,2023-09-15,541.67,1161,0,1161
1395,TSLA  ,2023-02-15,2023-09-15,550.0,11717,0,11717
1396,TSLA  ,2023-02-15,2023-09-15,558.33,188,0,188
1397,TSLA  ,2023-02-15,2023-09-15,566.67,4041,0,4041
1398,TSLA  ,2023-02-15,2023-09-15,575.0,378,0,378
1399,TSLA  ,2023-02-15,2023-09-15,583.33,512,0,512
1400,TSLA  ,2023-02-15,2023-09-15,591.67,2112,0,2112
1401,TSLA  ,2023-02-15,2023-09-15,600.0,8625,0,8625
1402,TSLA  ,2023-02-15,2023-09-15,608.33,672,0,672
1403,TSLA  ,2023-02-15,2023-09-15,616.67,1021,0,1021
1404,TSLA  ,2023-02-15,2023-09-15,625.0,1066,0,1066
1405,TSLA  ,2023-02-15,2023-09-15,633.33,694,0,694
1406,TSLA  ,2023-02-15,2023-09-15,641.67,416,0,416
1407,TSLA  ,2023-02-15,2023-09-15,650.0,27477,0,27477
1408,TSLA  ,2023-02-15,2023-09-15,658.33,1207,0,1207
1409,TSLA  ,2023-02-15,2023-09-15,666.67,1351,0,1351
1410,TSLA  ,2023-02-15,2023-09-15,675.0,493,0,493
1411,TSLA  ,2023-02-15,2023-09-15,683.33,454,0,454
1412,TSLA  ,2023-02-15,2023-09-15,700.0,1519,0,1519
1413,TSLA  ,2023-02-15,2023-09-15,716.67,1062,0,1062
1414,TSLA  ,2023-02-15,2023-09-15,733.33,2321,0,2321
1415,TSLA  ,2023-02-15,2023-09-15,750.0,8185,0,8185
1416,TSLA  ,2023-02-15,2023-09-15,758.33,71850,0,71850
1417,TSLA  ,2023-02-15,2023-12-15,50.0,1279,13795,15074
1418,TSLA  ,2023-02-15,2023-12-15,55.0,63,1161,1224
1419,TSLA  ,2023-02-15,2023-12-15,60.0,40,1224,1264
1420,TSLA  ,2023-02-15,2023-12-15,65.0,4,372,376
1421,TSLA  ,2023-02-15,2023-12-15,70.0,27,3806,3833
1422,TSLA  ,2023-02-15,2023-12-15,75.0,19,4151,4170
1423,TSLA  ,2023-02-15,2023-12-15,80.0,156,820,976
1424,TSLA  ,2023-02-15,2023-12-15,85.0,2574,2378,4952
1425,TSLA  ,2023-02-15,2023-12-15,90.0,1648,6035,7683
1426,TSLA  ,2023-02-15,2023-12-15,95.0,831,498,1329
1427,TSLA  ,2023-02-15,2023-12-15,100.0,1919,6385,8304
1428,TSLA  ,2023-02-15,2023-12-15,105.0,323,2286,2609
1429,TSLA  ,2023-02-15,2023-12-15,110.0,680,2168,2848
1430,TSLA  ,2023-02-15,2023-12-15,115.0,1716,962,2678
1431,TSLA  ,2023-02-15,2023-12-15,120.0,1024,1295,2319
1432,TSLA  ,2023-02-15,2023-12-15,125.0,492,1466,1958
1433,TSLA  ,2023-02-15,2023-12-15,130.0,769,11061,11830
1434,TSLA  ,2023-02-15,2023-12-15,135.0,790,6062,6852
1435,TSLA  ,2023-02-15,2023-12-15,140.0,927,1738,2665
1436,TSLA  ,2023-02-15,2023-12-15,145.0,629,942,1571
1437,TSLA  ,2023-02-15,2023-12-15,150.0,1493,12374,13867
1438,TSLA  ,2023-02-15,2023-12-15,155.0,405,1030,1435
1439,TSLA  ,2023-02-15,2023-12-15,160.0,2841,10978,13819
1440,TSLA  ,2023-02-15,2023-12-15,165.0,1452,506,1958
1441,TSLA  ,2023-02-15,2023-12-15,170.0,729,4496,5225
1442,TSLA  ,2023-02-15,2023-12-15,175.0,2182,432,2614
1443,TSLA  ,2023-02-15,2023-12-15,180.0,1613,1217,2830
1444,TSLA  ,2023-02-15,2023-12-15,185.0,565,647,1212
1445,TSLA  ,2023-02-15,2023-12-15,190.0,1112,561,1673
1446,TSLA  ,2023-02-15,2023-12-15,195.0,737,589,1326
1447,TSLA  ,2023-02-15,2023-12-15,200.0,8406,1579,9985
1448,TSLA  ,2023-02-15,2023-12-15,205.0,6473,759,7232
1449,TSLA  ,2023-02-15,2023-12-15,210.0,2713,732,3445
1450,TSLA  ,2023-02-15,2023-12-15,215.0,1284,661,1945
1451,TSLA  ,2023-02-15,2023-12-15,220.0,1649,1165,2814
1452,TSLA  ,2023-02-15,2023-12-15,225.0,1887,296,2183
1453,TSLA  ,2023-02-15,2023-12-15,230.0,1665,717,2382
1454,TSLA  ,2023-02-15,2023-12-15,235.0,514,437,951
1455,TSLA  ,2023-02-15,2023-12-15,240.0,5751,711,6462
1456,TSLA  ,2023-02-15,2023-12-15,245.0,2358,513,2871
1457,TSLA  ,2023-02-15,2023-12-15,250.0,15807,3656,19463
1458,TSLA  ,2023-02-15,2023-12-15,260.0,10133,753,10886
1459,TSLA  ,2023-02-15,2023-12-15,270.0,3999,517,4516
1460,TSLA  ,2023-02-15,2023-12-15,280.0,1453,676,2129
1461,TSLA  ,2023-02-15,2023-12-15,290.0,556,491,1047
1462,TSLA  ,2023-02-15,2023-12-15,300.0,1705,1027,2732
1463,TSLA  ,2023-02-15,2023-12-15,310.0,764,620,1384
1464,TSLA  ,2023-02-15,2023-12-15,320.0,1175,537,1712
1465,TSLA  ,2023-02-15,2023-12-15,330.0,436,232,668
1466,TSLA  ,2023-02-15,2023-12-15,340.0,327,120,447
1467,TSLA  ,2023-02-15,2023-12-15,350.0,1091,183,1274
1468,TSLA  ,2023-02-15,2023-12-15,360.0,532,117,649
1469,TSLA  ,2023-02-15,2023-12-15,370.0,52,243,295
1470,TSLA  ,2023-02-15,2023-12-15,380.0,468,321,789
1471,TSLA  ,2023-02-15,2023-12-15,390.0,1287,146,1433
1472,TSLA  ,2023-02-15,2024-01-19,1.67,2498,29605,32103
1473,TSLA  ,2023-02-15,2024-01-19,3.33,967,5942,6909
1474,TSLA  ,2023-02-15,2024-01-19,5.0,256,10191,10447
1475,TSLA  ,2023-02-15,2024-01-19,6.67,76,3335,3411
1476,TSLA  ,2023-02-15,2024-01-19,8.33,3902,2843,6745
1477,TSLA  ,2023-02-15,2024-01-19,10.0,294,4649,4943
1478,TSLA  ,2023-02-15,2024-01-19,11.67,253,3218,3471
1479,TSLA  ,2023-02-15,2024-01-19,13.33,819,507,1326
1480,TSLA  ,2023-02-15,2024-01-19,15.0,279,2065,2344
1481,TSLA  ,2023-02-15,2024-01-19,16.67,486,4566,5052
1482,TSLA  ,2023-02-15,2024-01-19,18.33,393,6124,6517
1483,TSLA  ,2023-02-15,2024-01-19,20.0,258,7599,7857
1484,TSLA  ,2023-02-15,2024-01-19,21.67,118,837,955
1485,TSLA  ,2023-02-15,2024-01-19,23.33,382,3839,4221
1486,TSLA  ,2023-02-15,2024-01-19,25.0,369,2760,3129
1487,TSLA  ,2023-02-15,2024-01-19,26.67,833,1193,2026
1488,TSLA  ,2023-02-15,2024-01-19,28.33,341,846,1187
1489,TSLA  ,2023-02-15,2024-01-19,30.0,228,8930,9158
1490,TSLA  ,2023-02-15,2024-01-19,31.67,1327,1353,2680
1491,TSLA  ,2023-02-15,2024-01-19,33.33,4315,32818,37133
1492,TSLA  ,2023-02-15,2024-01-19,50.0,2165,30752,32917
1493,TSLA  ,2023-02-15,2024-01-19,55.0,80,1342,1422
1494,TSLA  ,2023-02-15,2024-01-19,60.0,249,2616,2865
1495,TSLA  ,2023-02-15,2024-01-19,65.0,266,770,1036
1496,TSLA  ,2023-02-15,2024-01-19,66.67,4704,14823,19527
1497,TSLA  ,2023-02-15,2024-01-19,70.0,143,851,994
1498,TSLA  ,2023-02-15,2024-01-19,75.0,92,1183,1275
1499,TSLA  ,2023-02-15,2024-01-19,80.0,405,1928,2333
1500,TSLA  ,2023-02-15,2024-01-19,83.33,1064,8095,9159
1501,TSLA  ,2023-02-15,2024-01-19,85.0,511,413,924
1502,TSLA  ,2023-02-15,2024-01-19,90.0,3549,1323,4872
1503,TSLA  ,2023-02-15,2024-01-19,95.0,2971,1439,4410
1504,TSLA  ,2023-02-15,2024-01-19,100.0,13963,40116,54079
1505,TSLA  ,2023-02-15,2024-01-19,105.0,1289,2094,3383
1506,TSLA  ,2023-02-15,2024-01-19,110.0,4819,7042,11861
1507,TSLA  ,2023-02-15,2024-01-19,115.0,4696,5618,10314
1508,TSLA  ,2023-02-15,2024-01-19,116.67,1933,8359,10292
1509,TSLA  ,2023-02-15,2024-01-19,120.0,3437,6193,9630
1510,TSLA  ,2023-02-15,2024-01-19,123.33,1962,2316,4278
1511,TSLA  ,2023-02-15,2024-01-19,125.0,2394,13258,15652
1512,TSLA  ,2023-02-15,2024-01-19,126.67,1744,6599,8343
1513,TSLA  ,2023-02-15,2024-01-19,130.0,5083,11794,16877
1514,TSLA  ,2023-02-15,2024-01-19,133.33,2431,11061,13492
1515,TSLA  ,2023-02-15,2024-01-19,135.0,1328,1292,2620
1516,TSLA  ,2023-02-15,2024-01-19,136.67,2432,2314,4746
1517,TSLA  ,2023-02-15,2024-01-19,140.0,5114,4313,9427
1518,TSLA  ,2023-02-15,2024-01-19,143.33,1673,2275,3948
1519,TSLA  ,2023-02-15,2024-01-19,145.0,783,845,1628
1520,TSLA  ,2023-02-15,2024-01-19,146.67,1043,971,2014
1521,TSLA  ,2023-02-15,2024-01-19,150.0,17741,22385,40126
1522,TSLA  ,2023-02-15,2024-01-19,153.33,10511,1067,11578
1523,TSLA  ,2023-02-15,2024-01-19,155.0,534,1420,1954
1524,TSLA  ,2023-02-15,2024-01-19,156.67,1726,844,2570
1525,TSLA  ,2023-02-15,2024-01-19,160.0,3552,12303,15855
1526,TSLA  ,2023-02-15,2024-01-19,163.33,475,7408,7883
1527,TSLA  ,2023-02-15,2024-01-19,165.0,695,557,1252
1528,TSLA  ,2023-02-15,2024-01-19,166.67,6757,6868,13625
1529,TSLA  ,2023-02-15,2024-01-19,170.0,2800,6162,8962
1530,TSLA  ,2023-02-15,2024-01-19,173.33,855,2569,3424
1531,TSLA  ,2023-02-15,2024-01-19,175.0,1728,2687,4415
1532,TSLA  ,2023-02-15,2024-01-19,176.67,1020,1275,2295
1533,TSLA  ,2023-02-15,2024-01-19,180.0,39031,11153,50184
1534,TSLA  ,2023-02-15,2024-01-19,183.33,34448,7428,41876
1535,TSLA  ,2023-02-15,2024-01-19,185.0,1344,757,2101
1536,TSLA  ,2023-02-15,2024-01-19,186.67,1265,2281,3546
1537,TSLA  ,2023-02-15,2024-01-19,190.0,1680,729,2409
1538,TSLA  ,2023-02-15,2024-01-19,193.33,2289,9827,12116
1539,TSLA  ,2023-02-15,2024-01-19,195.0,683,1735,2418
1540,TSLA  ,2023-02-15,2024-01-19,200.0,32423,24005,56428
1541,TSLA  ,2023-02-15,2024-01-19,203.33,6303,2367,8670
1542,TSLA  ,2023-02-15,2024-01-19,206.67,1660,1225,2885
1543,TSLA  ,2023-02-15,2024-01-19,210.0,10875,6638,17513
1544,TSLA  ,2023-02-15,2024-01-19,213.33,1583,2691,4274
1545,TSLA  ,2023-02-15,2024-01-19,216.67,8869,6720,15589
1546,TSLA  ,2023-02-15,2024-01-19,220.0,6692,7076,13768
1547,TSLA  ,2023-02-15,2024-01-19,223.33,6073,1629,7702
1548,TSLA  ,2023-02-15,2024-01-19,226.67,20014,3145,23159
1549,TSLA  ,2023-02-15,2024-01-19,230.0,15156,18983,34139
1550,TSLA  ,2023-02-15,2024-01-19,233.33,37037,13472,50509
1551,TSLA  ,2023-02-15,2024-01-19,236.67,2004,1680,3684
1552,TSLA  ,2023-02-15,2024-01-19,240.0,4506,3865,8371
1553,TSLA  ,2023-02-15,2024-01-19,243.33,1267,1996,3263
1554,TSLA  ,2023-02-15,2024-01-19,246.67,1163,2111,3274
1555,TSLA  ,2023-02-15,2024-01-19,250.0,23172,5330,28502
1556,TSLA  ,2023-02-15,2024-01-19,253.33,2848,2096,4944
1557,TSLA  ,2023-02-15,2024-01-19,256.67,2824,1640,4464
1558,TSLA  ,2023-02-15,2024-01-19,260.0,7525,3168,10693
1559,TSLA  ,2023-02-15,2024-01-19,263.33,7757,2146,9903
1560,TSLA  ,2023-02-15,2024-01-19,266.67,10257,8817,19074
1561,TSLA  ,2023-02-15,2024-01-19,270.0,4586,5199,9785
1562,TSLA  ,2023-02-15,2024-01-19,273.33,3247,3091,6338
1563,TSLA  ,2023-02-15,2024-01-19,276.67,1897,1762,3659
1564,TSLA  ,2023-02-15,2024-01-19,280.0,9172,6499,15671
1565,TSLA  ,2023-02-15,2024-01-19,283.33,3144,3089,6233
1566,TSLA  ,2023-02-15,2024-01-19,286.67,2485,1507,3992
1567,TSLA  ,2023-02-15,2024-01-19,290.0,9309,557,9866
1568,TSLA  ,2023-02-15,2024-01-19,293.33,2893,1990,4883
1569,TSLA  ,2023-02-15,2024-01-19,296.67,2129,1688,3817
1570,TSLA  ,2023-02-15,2024-01-19,300.0,26201,6288,32489
1571,TSLA  ,2023-02-15,2024-01-19,303.33,3444,277,3721
1572,TSLA  ,2023-02-15,2024-01-19,306.67,6579,132,6711
1573,TSLA  ,2023-02-15,2024-01-19,310.0,3728,1013,4741
1574,TSLA  ,2023-02-15,2024-01-19,313.33,1201,22,1223
1575,TSLA  ,2023-02-15,2024-01-19,316.67,4036,306,4342
1576,TSLA  ,2023-02-15,2024-01-19,320.0,6206,321,6527
1577,TSLA  ,2023-02-15,2024-01-19,323.33,455,268,723
1578,TSLA  ,2023-02-15,2024-01-19,325.0,10256,134,10390
1579,TSLA  ,2023-02-15,2024-01-19,326.67,1370,630,2000
1580,TSLA  ,2023-02-15,2024-01-19,330.0,7128,11,7139
1581,TSLA  ,2023-02-15,2024-01-19,333.33,30394,2055,32449
1582,TSLA  ,2023-02-15,2024-01-19,336.67,1469,7,1476
1583,TSLA  ,2023-02-15,2024-01-19,340.0,3815,5,3820
1584,TSLA  ,2023-02-15,2024-01-19,341.67,905,10,915
1585,TSLA  ,2023-02-15,2024-01-19,343.33,552,0,552
1586,TSLA  ,2023-02-15,2024-01-19,346.67,2398,3,2401
1587,TSLA  ,2023-02-15,2024-01-19,350.0,15565,728,16293
1588,TSLA  ,2023-02-15,2024-01-19,353.33,1162,0,1162
1589,TSLA  ,2023-02-15,2024-01-19,356.67,888,0,888
1590,TSLA  ,2023-02-15,2024-01-19,358.33,1241,3,1244
1591,TSLA  ,2023-02-15,2024-01-19,360.0,9303,600,9903
1592,TSLA  ,2023-02-15,2024-01-19,363.33,491,7,498
1593,TSLA  ,2023-02-15,2024-01-19,366.67,38786,2807,41593
1594,TSLA  ,2023-02-15,2024-01-19,370.0,6072,4,6076
1595,TSLA  ,2023-02-15,2024-01-19,373.33,1054,12,1066
1596,TSLA  ,2023-02-15,2024-01-19,375.0,11430,8,11438
1597,TSLA  ,2023-02-15,2024-01-19,376.67,573,106,679
1598,TSLA  ,2023-02-15,2024-01-19,380.0,1056,2,1058
1599,TSLA  ,2023-02-15,2024-01-19,383.33,3082,2,3084
1600,TSLA  ,2023-02-15,2024-01-19,386.67,409,203,612
1601,TSLA  ,2023-02-15,2024-01-19,390.0,920,1,921
1602,TSLA  ,2023-02-15,2024-01-19,391.67,2318,1,2319
1603,TSLA  ,2023-02-15,2024-01-19,393.33,518,4,522
1604,TSLA  ,2023-02-15,2024-01-19,396.67,2713,0,2713
1605,TSLA  ,2023-02-15,2024-01-19,400.0,38988,992,39980
1606,TSLA  ,2023-02-15,2024-01-19,408.33,5169,21,5190
1607,TSLA  ,2023-02-15,2024-01-19,416.67,4033,2142,6175
1608,TSLA  ,2023-02-15,2024-01-19,425.0,4502,18,4520
1609,TSLA  ,2023-02-15,2024-01-19,433.33,5739,3,5742
1610,TSLA  ,2023-02-15,2024-01-19,441.67,1196,0,1196
1611,TSLA  ,2023-02-15,2024-01-19,450.0,8173,2427,10600
1612,TSLA  ,2023-02-15,2024-01-19,458.33,2003,0,2003
1613,TSLA  ,2023-02-15,2024-01-19,466.67,28821,0,28821
1614,TSLA  ,2023-02-15,2024-01-19,475.0,5170,195,5365
1615,TSLA  ,2023-02-15,2024-01-19,483.33,1586,20,1606
1616,TSLA  ,2023-02-15,2024-01-19,491.67,2143,0,2143
1617,TSLA  ,2023-02-15,2024-01-19,500.0,36009,170,36179
1618,TSLA  ,2023-02-15,2024-01-19,516.67,4807,0,4807
1619,TSLA  ,2023-02-15,2024-01-19,533.33,20784,0,20784
1620,TSLA  ,2023-02-15,2024-01-19,550.0,16407,0,16407
1621,TSLA  ,2023-02-15,2024-01-19,558.33,1182,0,1182
1622,TSLA  ,2023-02-15,2024-01-19,566.67,11405,0,11405
1623,TSLA  ,2023-02-15,2024-01-19,575.0,13907,0,13907
1624,TSLA  ,2023-02-15,2024-01-19,583.33,13822,0,13822
1625,TSLA  ,2023-02-15,2024-01-19,591.67,2277,0,2277
1626,TSLA  ,2023-02-15,2024-01-19,600.0,18572,0,18572
1627,TSLA  ,2023-02-15,2024-01-19,608.33,2279,0,2279
1628,TSLA  ,2023-02-15,2024-01-19,616.67,11852,0,11852
1629,TSLA  ,2023-02-15,2024-01-19,625.0,2423,0,2423
1630,TSLA  ,2023-02-15,2024-01-19,633.33,5750,0,5750
1631,TSLA  ,2023-02-15,2024-01-19,641.67,930,0,930
1632,TSLA  ,2023-02-15,2024-01-19,650.0,3197,0,3197
1633,TSLA  ,2023-02-15,2024-01-19,666.67,40732,0,40732
1634,TSLA  ,2023-02-15,2024-01-19,675.0,4357,0,4357
1635,TSLA  ,2023-02-15,2024-01-19,683.33,7132,0,7132
1636,TSLA  ,2023-02-15,2024-01-19,691.67,1564,0,1564
1637,TSLA  ,2023-02-15,2024-01-19,700.0,5370,0,5370
1638,TSLA  ,2023-02-15,2024-01-19,708.33,761,0,761
1639,TSLA  ,2023-02-15,2024-01-19,716.67,6059,0,6059
1640,TSLA  ,2023-02-15,2024-01-19,725.0,2693,3,2696
1641,TSLA  ,2023-02-15,2024-01-19,733.33,3399,0,3399
1642,TSLA  ,2023-02-15,2024-01-19,741.67,805,0,805
1643,TSLA  ,2023-02-15,2024-01-19,750.0,2348,0,2348
1644,TSLA  ,2023-02-15,2024-01-19,758.33,932,0,932
1645,TSLA  ,2023-02-15,2024-01-19,766.67,2124,0,2124
1646,TSLA  ,2023-02-15,2024-01-19,775.0,2798,0,2798
1647,TSLA  ,2023-02-15,2024-01-19,783.33,692,0,692
1648,TSLA  ,2023-02-15,2024-01-19,791.67,3182,0,3182
1649,TSLA  ,2023-02-15,2024-01-19,800.0,13840,0,13840
1650,TSLA  ,2023-02-15,2024-01-19,808.33,3927,0,3927
1651,TSLA  ,2023-02-15,2024-01-19,816.67,5805,0,5805
1652,TSLA  ,2023-02-15,2024-01-19,825.0,75351,0,75351
1653,TSLA  ,2023-02-15,2024-03-15,1.67,108,1894,2002
1654,TSLA  ,2023-02-15,2024-03-15,3.33,22,769,791
1655,TSLA  ,2023-02-15,2024-03-15,5.0,64,894,958
1656,TSLA  ,2023-02-15,2024-03-15,6.67,6,93,99
1657,TSLA  ,2023-02-15,2024-03-15,8.33,16,42,58
1658,TSLA  ,2023-02-15,2024-03-15,10.0,6,313,319
1659,TSLA  ,2023-02-15,2024-03-15,11.67,11,409,420
1660,TSLA  ,2023-02-15,2024-03-15,13.33,18,45,63
1661,TSLA  ,2023-02-15,2024-03-15,15.0,24,380,404
1662,TSLA  ,2023-02-15,2024-03-15,16.67,124,230,354
1663,TSLA  ,2023-02-15,2024-03-15,33.33,809,1999,2808
1664,TSLA  ,2023-02-15,2024-03-15,50.0,449,5654,6103
1665,TSLA  ,2023-02-15,2024-03-15,55.0,30,300,330
1666,TSLA  ,2023-02-15,2024-03-15,60.0,45,851,896
1667,TSLA  ,2023-02-15,2024-03-15,65.0,31,828,859
1668,TSLA  ,2023-02-15,2024-03-15,66.67,2035,1007,3042
1669,TSLA  ,2023-02-15,2024-03-15,70.0,50,238,288
1670,TSLA  ,2023-02-15,2024-03-15,75.0,20,399,419
1671,TSLA  ,2023-02-15,2024-03-15,80.0,191,552,743
1672,TSLA  ,2023-02-15,2024-03-15,83.33,999,4508,5507
1673,TSLA  ,2023-02-15,2024-03-15,85.0,291,214,505
1674,TSLA  ,2023-02-15,2024-03-15,90.0,744,766,1510
1675,TSLA  ,2023-02-15,2024-03-15,95.0,1559,401,1960
1676,TSLA  ,2023-02-15,2024-03-15,100.0,3355,3191,6546
1677,TSLA  ,2023-02-15,2024-03-15,105.0,818,722,1540
1678,TSLA  ,2023-02-15,2024-03-15,110.0,912,2517,3429
1679,TSLA  ,2023-02-15,2024-03-15,115.0,2044,197,2241
1680,TSLA  ,2023-02-15,2024-03-15,116.67,609,950,1559
1681,TSLA  ,2023-02-15,2024-03-15,120.0,327,606,933
1682,TSLA  ,2023-02-15,2024-03-15,125.0,793,742,1535
1683,TSLA  ,2023-02-15,2024-03-15,130.0,1551,529,2080
1684,TSLA  ,2023-02-15,2024-03-15,133.33,590,5693,6283
1685,TSLA  ,2023-02-15,2024-03-15,135.0,207,231,438
1686,TSLA  ,2023-02-15,2024-03-15,140.0,209,270,479
1687,TSLA  ,2023-02-15,2024-03-15,141.67,560,325,885
1688,TSLA  ,2023-02-15,2024-03-15,145.0,296,383,679
1689,TSLA  ,2023-02-15,2024-03-15,150.0,1304,4412,5716
1690,TSLA  ,2023-02-15,2024-03-15,155.0,86,205,291
1691,TSLA  ,2023-02-15,2024-03-15,158.33,172,583,755
1692,TSLA  ,2023-02-15,2024-03-15,160.0,237,4380,4617
1693,TSLA  ,2023-02-15,2024-03-15,165.0,151,3903,4054
1694,TSLA  ,2023-02-15,2024-03-15,166.67,581,1181,1762
1695,TSLA  ,2023-02-15,2024-03-15,170.0,285,8894,9179
1696,TSLA  ,2023-02-15,2024-03-15,175.0,720,1944,2664
1697,TSLA  ,2023-02-15,2024-03-15,180.0,300,642,942
1698,TSLA  ,2023-02-15,2024-03-15,183.33,515,1146,1661
1699,TSLA  ,2023-02-15,2024-03-15,185.0,251,151,402
1700,TSLA  ,2023-02-15,2024-03-15,190.0,218,272,490
1701,TSLA  ,2023-02-15,2024-03-15,191.67,679,1383,2062
1702,TSLA  ,2023-02-15,2024-03-15,195.0,577,131,708
1703,TSLA  ,2023-02-15,2024-03-15,200.0,5227,4711,9938
1704,TSLA  ,2023-02-15,2024-03-15,208.33,1197,728,1925
1705,TSLA  ,2023-02-15,2024-03-15,210.0,462,188,650
1706,TSLA  ,2023-02-15,2024-03-15,216.67,1495,838,2333
1707,TSLA  ,2023-02-15,2024-03-15,220.0,553,62,615
1708,TSLA  ,2023-02-15,2024-03-15,225.0,2208,2419,4627
1709,TSLA  ,2023-02-15,2024-03-15,230.0,242,54,296
1710,TSLA  ,2023-02-15,2024-03-15,233.33,1620,996,2616
1711,TSLA  ,2023-02-15,2024-03-15,240.0,179,50,229
1712,TSLA  ,2023-02-15,2024-03-15,241.67,1124,955,2079
1713,TSLA  ,2023-02-15,2024-03-15,250.0,2182,1447,3629
1714,TSLA  ,2023-02-15,2024-03-15,258.33,4133,1036,5169
1715,TSLA  ,2023-02-15,2024-03-15,260.0,562,96,658
1716,TSLA  ,2023-02-15,2024-03-15,266.67,4461,810,5271
1717,TSLA  ,2023-02-15,2024-03-15,270.0,308,3,311
1718,TSLA  ,2023-02-15,2024-03-15,275.0,8958,1011,9969
1719,TSLA  ,2023-02-15,2024-03-15,280.0,112,58,170
1720,TSLA  ,2023-02-15,2024-03-15,283.33,1144,710,1854
1721,TSLA  ,2023-02-15,2024-03-15,290.0,13,4,17
1722,TSLA  ,2023-02-15,2024-03-15,291.67,1289,129,1418
1723,TSLA  ,2023-02-15,2024-03-15,300.0,4932,665,5597
1724,TSLA  ,2023-02-15,2024-03-15,308.33,406,40,446
1725,TSLA  ,2023-02-15,2024-03-15,310.0,9,0,9
1726,TSLA  ,2023-02-15,2024-03-15,316.67,936,390,1326
1727,TSLA  ,2023-02-15,2024-03-15,325.0,1533,16,1549
1728,TSLA  ,2023-02-15,2024-03-15,333.33,1039,24,1063
1729,TSLA  ,2023-02-15,2024-03-15,341.67,299,24,323
1730,TSLA  ,2023-02-15,2024-03-15,350.0,888,82,970
1731,TSLA  ,2023-02-15,2024-03-15,358.33,449,68,517
1732,TSLA  ,2023-02-15,2024-03-15,366.67,535,250,785
1733,TSLA  ,2023-02-15,2024-03-15,375.0,763,2,765
1734,TSLA  ,2023-02-15,2024-03-15,383.33,194,1337,1531
1735,TSLA  ,2023-02-15,2024-03-15,391.67,319,8,327
1736,TSLA  ,2023-02-15,2024-03-15,400.0,1193,221,1414
1737,TSLA  ,2023-02-15,2024-03-15,408.33,612,53,665
1738,TSLA  ,2023-02-15,2024-03-15,416.67,368,366,734
1739,TSLA  ,2023-02-15,2024-03-15,425.0,890,8,898
1740,TSLA  ,2023-02-15,2024-03-15,433.33,574,0,574
1741,TSLA  ,2023-02-15,2024-03-15,441.67,170,0,170
1742,TSLA  ,2023-02-15,2024-03-15,450.0,1468,0,1468
1743,TSLA  ,2023-02-15,2024-03-15,458.33,243,0,243
1744,TSLA  ,2023-02-15,2024-03-15,466.67,822,0,822
1745,TSLA  ,2023-02-15,2024-03-15,475.0,423,0,423
1746,TSLA  ,2023-02-15,2024-03-15,483.33,487,0,487
1747,TSLA  ,2023-02-15,2024-03-15,491.67,319,0,319
1748,TSLA  ,2023-02-15,2024-03-15,500.0,2920,0,2920
1749,TSLA  ,2023-02-15,2024-03-15,508.33,227,0,227
1750,TSLA  ,2023-02-15,2024-03-15,516.67,692,0,692
1751,TSLA  ,2023-02-15,2024-03-15,525.0,118,0,118
1752,TSLA  ,2023-02-15,2024-03-15,533.33,221,0,221
1753,TSLA  ,2023-02-15,2024-03-15,541.67,165,0,165
1754,TSLA  ,2023-02-15,2024-03-15,550.0,510,0,510
1755,TSLA  ,2023-02-15,2024-03-15,558.33,264,0,264
1756,TSLA  ,2023-02-15,2024-03-15,566.67,385,0,385
1757,TSLA  ,2023-02-15,2024-03-15,575.0,667,0,667
1758,TSLA  ,2023-02-15,2024-03-15,583.33,476,0,476
1759,TSLA  ,2023-02-15,2024-03-15,600.0,3825,1,3826
1760,TSLA  ,2023-02-15,2024-06-21,1.67,630,16447,17077
1761,TSLA  ,2023-02-15,2024-06-21,3.33,149,3279,3428
1762,TSLA  ,2023-02-15,2024-06-21,5.0,20,1516,1536
1763,TSLA  ,2023-02-15,2024-06-21,6.67,219,1218,1437
1764,TSLA  ,2023-02-15,2024-06-21,8.33,121,368,489
1765,TSLA  ,2023-02-15,2024-06-21,10.0,275,1827,2102
1766,TSLA  ,2023-02-15,2024-06-21,11.67,540,336,876
1767,TSLA  ,2023-02-15,2024-06-21,13.33,39,219,258
1768,TSLA  ,2023-02-15,2024-06-21,16.67,1407,3539,4946
1769,TSLA  ,2023-02-15,2024-06-21,33.33,7802,5379,13181
1770,TSLA  ,2023-02-15,2024-06-21,50.0,1916,3798,5714
1771,TSLA  ,2023-02-15,2024-06-21,55.0,6,383,389
1772,TSLA  ,2023-02-15,2024-06-21,60.0,57,491,548
1773,TSLA  ,2023-02-15,2024-06-21,65.0,111,2103,2214
1774,TSLA  ,2023-02-15,2024-06-21,66.67,1877,4359,6236
1775,TSLA  ,2023-02-15,2024-06-21,70.0,49,250,299
1776,TSLA  ,2023-02-15,2024-06-21,75.0,74,194,268
1777,TSLA  ,2023-02-15,2024-06-21,80.0,111,1405,1516
1778,TSLA  ,2023-02-15,2024-06-21,83.33,30601,4178,34779
1779,TSLA  ,2023-02-15,2024-06-21,85.0,60,861,921
1780,TSLA  ,2023-02-15,2024-06-21,90.0,532,1154,1686
1781,TSLA  ,2023-02-15,2024-06-21,95.0,363,425,788
1782,TSLA  ,2023-02-15,2024-06-21,100.0,5361,9725,15086
1783,TSLA  ,2023-02-15,2024-06-21,105.0,798,803,1601
1784,TSLA  ,2023-02-15,2024-06-21,110.0,497,2221,2718
1785,TSLA  ,2023-02-15,2024-06-21,115.0,414,252,666
1786,TSLA  ,2023-02-15,2024-06-21,116.67,2478,1020,3498
1787,TSLA  ,2023-02-15,2024-06-21,120.0,559,1193,1752
1788,TSLA  ,2023-02-15,2024-06-21,123.33,643,3524,4167
1789,TSLA  ,2023-02-15,2024-06-21,125.0,162,2239,2401
1790,TSLA  ,2023-02-15,2024-06-21,126.67,668,1272,1940
1791,TSLA  ,2023-02-15,2024-06-21,130.0,838,1780,2618
1792,TSLA  ,2023-02-15,2024-06-21,133.33,1922,2859,4781
1793,TSLA  ,2023-02-15,2024-06-21,135.0,64,363,427
1794,TSLA  ,2023-02-15,2024-06-21,136.67,426,1838,2264
1795,TSLA  ,2023-02-15,2024-06-21,140.0,1491,2590,4081
1796,TSLA  ,2023-02-15,2024-06-21,143.33,1404,1686,3090
1797,TSLA  ,2023-02-15,2024-06-21,145.0,599,211,810
1798,TSLA  ,2023-02-15,2024-06-21,146.67,1642,564,2206
1799,TSLA  ,2023-02-15,2024-06-21,150.0,4375,9868,14243
1800,TSLA  ,2023-02-15,2024-06-21,153.33,289,816,1105
1801,TSLA  ,2023-02-15,2024-06-21,155.0,86,437,523
1802,TSLA  ,2023-02-15,2024-06-21,156.67,383,223,606
1803,TSLA  ,2023-02-15,2024-06-21,160.0,879,2707,3586
1804,TSLA  ,2023-02-15,2024-06-21,163.33,185,1412,1597
1805,TSLA  ,2023-02-15,2024-06-21,165.0,347,896,1243
1806,TSLA  ,2023-02-15,2024-06-21,166.67,1733,5513,7246
1807,TSLA  ,2023-02-15,2024-06-21,170.0,301,840,1141
1808,TSLA  ,2023-02-15,2024-06-21,173.33,596,5871,6467
1809,TSLA  ,2023-02-15,2024-06-21,175.0,934,392,1326
1810,TSLA  ,2023-02-15,2024-06-21,180.0,1367,6668,8035
1811,TSLA  ,2023-02-15,2024-06-21,183.33,931,3704,4635
1812,TSLA  ,2023-02-15,2024-06-21,185.0,290,237,527
1813,TSLA  ,2023-02-15,2024-06-21,186.67,1322,1656,2978
1814,TSLA  ,2023-02-15,2024-06-21,190.0,343,117,460
1815,TSLA  ,2023-02-15,2024-06-21,193.33,1021,4299,5320
1816,TSLA  ,2023-02-15,2024-06-21,195.0,273,865,1138
1817,TSLA  ,2023-02-15,2024-06-21,200.0,4741,9875,14616
1818,TSLA  ,2023-02-15,2024-06-21,206.67,1186,2901,4087
1819,TSLA  ,2023-02-15,2024-06-21,210.0,425,126,551
1820,TSLA  ,2023-02-15,2024-06-21,213.33,826,1202,2028
1821,TSLA  ,2023-02-15,2024-06-21,216.67,1641,5372,7013
1822,TSLA  ,2023-02-15,2024-06-21,220.0,2507,2403,4910
1823,TSLA  ,2023-02-15,2024-06-21,226.67,2594,3504,6098
1824,TSLA  ,2023-02-15,2024-06-21,230.0,499,134,633
1825,TSLA  ,2023-02-15,2024-06-21,233.33,6662,7246,13908
1826,TSLA  ,2023-02-15,2024-06-21,240.0,2120,4866,6986
1827,TSLA  ,2023-02-15,2024-06-21,246.67,2258,1235,3493
1828,TSLA  ,2023-02-15,2024-06-21,250.0,5451,3586,9037
1829,TSLA  ,2023-02-15,2024-06-21,253.33,1309,851,2160
1830,TSLA  ,2023-02-15,2024-06-21,260.0,2076,953,3029
1831,TSLA  ,2023-02-15,2024-06-21,266.67,10105,3339,13444
1832,TSLA  ,2023-02-15,2024-06-21,270.0,1451,1816,3267
1833,TSLA  ,2023-02-15,2024-06-21,273.33,1253,793,2046
1834,TSLA  ,2023-02-15,2024-06-21,276.67,1022,809,1831
1835,TSLA  ,2023-02-15,2024-06-21,280.0,1243,1601,2844
1836,TSLA  ,2023-02-15,2024-06-21,283.33,3609,1362,4971
1837,TSLA  ,2023-02-15,2024-06-21,286.67,991,768,1759
1838,TSLA  ,2023-02-15,2024-06-21,290.0,2318,1161,3479
1839,TSLA  ,2023-02-15,2024-06-21,293.33,1112,966,2078
1840,TSLA  ,2023-02-15,2024-06-21,296.67,1021,360,1381
1841,TSLA  ,2023-02-15,2024-06-21,300.0,9316,839,10155
1842,TSLA  ,2023-02-15,2024-06-21,303.33,1419,645,2064
1843,TSLA  ,2023-02-15,2024-06-21,306.67,1489,237,1726
1844,TSLA  ,2023-02-15,2024-06-21,310.0,1816,518,2334
1845,TSLA  ,2023-02-15,2024-06-21,313.33,1143,719,1862
1846,TSLA  ,2023-02-15,2024-06-21,316.67,2341,28,2369
1847,TSLA  ,2023-02-15,2024-06-21,320.0,691,691,1382
1848,TSLA  ,2023-02-15,2024-06-21,323.33,432,308,740
1849,TSLA  ,2023-02-15,2024-06-21,326.67,582,274,856
1850,TSLA  ,2023-02-15,2024-06-21,330.0,2725,123,2848
1851,TSLA  ,2023-02-15,2024-06-21,333.33,7547,1092,8639
1852,TSLA  ,2023-02-15,2024-06-21,336.67,2288,238,2526
1853,TSLA  ,2023-02-15,2024-06-21,340.0,774,30,804
1854,TSLA  ,2023-02-15,2024-06-21,343.33,1201,89,1290
1855,TSLA  ,2023-02-15,2024-06-21,346.67,400,45,445
1856,TSLA  ,2023-02-15,2024-06-21,350.0,3459,6,3465
1857,TSLA  ,2023-02-15,2024-06-21,353.33,199,70,269
1858,TSLA  ,2023-02-15,2024-06-21,356.67,502,0,502
1859,TSLA  ,2023-02-15,2024-06-21,360.0,2619,12,2631
1860,TSLA  ,2023-02-15,2024-06-21,363.33,360,0,360
1861,TSLA  ,2023-02-15,2024-06-21,366.67,4709,0,4709
1862,TSLA  ,2023-02-15,2024-06-21,370.0,3054,9,3063
1863,TSLA  ,2023-02-15,2024-06-21,373.33,560,1,561
1864,TSLA  ,2023-02-15,2024-06-21,376.67,804,0,804
1865,TSLA  ,2023-02-15,2024-06-21,380.0,1049,1,1050
1866,TSLA  ,2023-02-15,2024-06-21,383.33,1019,11,1030
1867,TSLA  ,2023-02-15,2024-06-21,386.67,299,5,304
1868,TSLA  ,2023-02-15,2024-06-21,390.0,444,3,447
1869,TSLA  ,2023-02-15,2024-06-21,393.33,889,2,891
1870,TSLA  ,2023-02-15,2024-06-21,396.67,720,2,722
1871,TSLA  ,2023-02-15,2024-06-21,400.0,38812,35,38847
1872,TSLA  ,2023-02-15,2024-06-21,416.67,3243,1,3244
1873,TSLA  ,2023-02-15,2024-06-21,433.33,3270,0,3270
1874,TSLA  ,2023-02-15,2024-06-21,450.0,3056,0,3056
1875,TSLA  ,2023-02-15,2024-06-21,466.67,5387,0,5387
1876,TSLA  ,2023-02-15,2024-06-21,483.33,1112,0,1112
1877,TSLA  ,2023-02-15,2024-06-21,500.0,10951,0,10951
1878,TSLA  ,2023-02-15,2024-06-21,516.67,2090,0,2090
1879,TSLA  ,2023-02-15,2024-06-21,533.33,3105,0,3105
1880,TSLA  ,2023-02-15,2024-06-21,550.0,2605,0,2605
1881,TSLA  ,2023-02-15,2024-06-21,566.67,1007,0,1007
1882,TSLA  ,2023-02-15,2024-06-21,583.33,1038,0,1038
1883,TSLA  ,2023-02-15,2024-06-21,600.0,17157,0,17157
1884,TSLA  ,2023-02-15,2024-06-21,616.67,14010,0,14010
1885,TSLA  ,2023-02-15,2024-06-21,633.33,4540,0,4540
1886,TSLA  ,2023-02-15,2024-06-21,650.0,621,0,621
1887,TSLA  ,2023-02-15,2024-06-21,666.67,6554,0,6554
1888,TSLA  ,2023-02-15,2024-06-21,683.33,1687,0,1687
1889,TSLA  ,2023-02-15,2024-06-21,700.0,3776,0,3776
1890,TSLA  ,2023-02-15,2024-06-21,716.67,899,0,899
1891,TSLA  ,2023-02-15,2024-06-21,733.33,2082,0,2082
1892,TSLA  ,2023-02-15,2024-06-21,750.0,5847,1,5848
1893,TSLA  ,2023-02-15,2024-06-21,758.33,14462,0,14462
1894,TSLA  ,2023-02-15,2024-09-20,50.0,44,923,967
1895,TSLA  ,2023-02-15,2024-09-20,55.0,29,177,206
1896,TSLA  ,2023-02-15,2024-09-20,60.0,10,146,156
1897,TSLA  ,2023-02-15,2024-09-20,65.0,39,69,108
1898,TSLA  ,2023-02-15,2024-09-20,70.0,11,136,147
1899,TSLA  ,2023-02-15,2024-09-20,75.0,10,2322,2332
1900,TSLA  ,2023-02-15,2024-09-20,80.0,63,139,202
1901,TSLA  ,2023-02-15,2024-09-20,85.0,987,454,1441
1902,TSLA  ,2023-02-15,2024-09-20,90.0,47,194,241
1903,TSLA  ,2023-02-15,2024-09-20,95.0,22,441,463
1904,TSLA  ,2023-02-15,2024-09-20,100.0,379,2217,2596
1905,TSLA  ,2023-02-15,2024-09-20,105.0,188,718,906
1906,TSLA  ,2023-02-15,2024-09-20,110.0,163,1095,1258
1907,TSLA  ,2023-02-15,2024-09-20,115.0,563,603,1166
1908,TSLA  ,2023-02-15,2024-09-20,120.0,717,547,1264
1909,TSLA  ,2023-02-15,2024-09-20,125.0,320,1201,1521
1910,TSLA  ,2023-02-15,2024-09-20,130.0,636,840,1476
1911,TSLA  ,2023-02-15,2024-09-20,135.0,580,271,851
1912,TSLA  ,2023-02-15,2024-09-20,140.0,1094,349,1443
1913,TSLA  ,2023-02-15,2024-09-20,145.0,1289,351,1640
1914,TSLA  ,2023-02-15,2024-09-20,150.0,1436,2727,4163
1915,TSLA  ,2023-02-15,2024-09-20,155.0,528,296,824
1916,TSLA  ,2023-02-15,2024-09-20,160.0,428,822,1250
1917,TSLA  ,2023-02-15,2024-09-20,165.0,280,109,389
1918,TSLA  ,2023-02-15,2024-09-20,170.0,203,281,484
1919,TSLA  ,2023-02-15,2024-09-20,175.0,235,126,361
1920,TSLA  ,2023-02-15,2024-09-20,180.0,732,85,817
1921,TSLA  ,2023-02-15,2024-09-20,185.0,829,916,1745
1922,TSLA  ,2023-02-15,2024-09-20,190.0,1491,126,1617
1923,TSLA  ,2023-02-15,2024-09-20,195.0,1411,118,1529
1924,TSLA  ,2023-02-15,2024-09-20,200.0,1751,1514,3265
1925,TSLA  ,2023-02-15,2024-09-20,210.0,795,267,1062
1926,TSLA  ,2023-02-15,2024-09-20,220.0,1344,426,1770
1927,TSLA  ,2023-02-15,2024-09-20,230.0,665,117,782
1928,TSLA  ,2023-02-15,2024-09-20,240.0,452,303,755
1929,TSLA  ,2023-02-15,2024-09-20,250.0,848,366,1214
1930,TSLA  ,2023-02-15,2024-09-20,260.0,902,70,972
1931,TSLA  ,2023-02-15,2024-09-20,270.0,523,534,1057
1932,TSLA  ,2023-02-15,2024-09-20,280.0,327,577,904
1933,TSLA  ,2023-02-15,2024-09-20,290.0,467,2810,3277
1934,TSLA  ,2023-02-15,2024-09-20,300.0,1035,1157,2192
1935,TSLA  ,2023-02-15,2024-09-20,310.0,182,786,968
1936,TSLA  ,2023-02-15,2024-09-20,320.0,112,257,369
1937,TSLA  ,2023-02-15,2024-09-20,330.0,106,117,223
1938,TSLA  ,2023-02-15,2024-09-20,340.0,708,110,818
1939,TSLA  ,2023-02-15,2024-09-20,350.0,1430,109,1539
1940,TSLA  ,2023-02-15,2024-09-20,360.0,52,63,115
1941,TSLA  ,2023-02-15,2024-09-20,370.0,77,3,80
1942,TSLA  ,2023-02-15,2024-09-20,380.0,76,2,78
1943,TSLA  ,2023-02-15,2024-09-20,390.0,189,17,206
1944,TSLA  ,2023-02-15,2025-01-17,5.0,660,11505,12165
1945,TSLA  ,2023-02-15,2025-01-17,10.0,139,849,988
1946,TSLA  ,2023-02-15,2025-01-17,15.0,29,862,891
1947,TSLA  ,2023-02-15,2025-01-17,20.0,385,5785,6170
1948,TSLA  ,2023-02-15,2025-01-17,25.0,103,2459,2562
1949,TSLA  ,2023-02-15,2025-01-17,30.0,13823,16562,30385
1950,TSLA  ,2023-02-15,2025-01-17,35.0,265,1117,1382
1951,TSLA  ,2023-02-15,2025-01-17,40.0,14708,15783,30491
1952,TSLA  ,2023-02-15,2025-01-17,45.0,2979,3196,6175
1953,TSLA  ,2023-02-15,2025-01-17,50.0,2740,8564,11304
1954,TSLA  ,2023-02-15,2025-01-17,55.0,2004,4217,6221
1955,TSLA  ,2023-02-15,2025-01-17,60.0,592,1961,2553
1956,TSLA  ,2023-02-15,2025-01-17,65.0,1652,1571,3223
1957,TSLA  ,2023-02-15,2025-01-17,70.0,2491,2199,4690
1958,TSLA  ,2023-02-15,2025-01-17,75.0,177,4310,4487
1959,TSLA  ,2023-02-15,2025-01-17,80.0,1308,1853,3161
1960,TSLA  ,2023-02-15,2025-01-17,85.0,1827,1609,3436
1961,TSLA  ,2023-02-15,2025-01-17,90.0,1121,5530,6651
1962,TSLA  ,2023-02-15,2025-01-17,95.0,137,502,639
1963,TSLA  ,2023-02-15,2025-01-17,100.0,5428,17618,23046
1964,TSLA  ,2023-02-15,2025-01-17,105.0,316,1673,1989
1965,TSLA  ,2023-02-15,2025-01-17,110.0,5443,7138,12581
1966,TSLA  ,2023-02-15,2025-01-17,115.0,3632,3632,7264
1967,TSLA  ,2023-02-15,2025-01-17,120.0,8372,6132,14504
1968,TSLA  ,2023-02-15,2025-01-17,125.0,2154,1166,3320
1969,TSLA  ,2023-02-15,2025-01-17,130.0,5636,7183,12819
1970,TSLA  ,2023-02-15,2025-01-17,135.0,5698,693,6391
1971,TSLA  ,2023-02-15,2025-01-17,140.0,8584,4611,13195
1972,TSLA  ,2023-02-15,2025-01-17,145.0,767,695,1462
1973,TSLA  ,2023-02-15,2025-01-17,150.0,11928,11867,23795
1974,TSLA  ,2023-02-15,2025-01-17,155.0,427,469,896
1975,TSLA  ,2023-02-15,2025-01-17,160.0,4603,5540,10143
1976,TSLA  ,2023-02-15,2025-01-17,165.0,250,859,1109
1977,TSLA  ,2023-02-15,2025-01-17,170.0,35399,9684,45083
1978,TSLA  ,2023-02-15,2025-01-17,175.0,33481,4515,37996
1979,TSLA  ,2023-02-15,2025-01-17,180.0,4011,8202,12213
1980,TSLA  ,2023-02-15,2025-01-17,185.0,7187,4531,11718
1981,TSLA  ,2023-02-15,2025-01-17,190.0,5688,4790,10478
1982,TSLA  ,2023-02-15,2025-01-17,195.0,3232,1731,4963
1983,TSLA  ,2023-02-15,2025-01-17,200.0,28889,12627,41516
1984,TSLA  ,2023-02-15,2025-01-17,210.0,5236,2623,7859
1985,TSLA  ,2023-02-15,2025-01-17,220.0,3090,4081,7171
1986,TSLA  ,2023-02-15,2025-01-17,230.0,4122,3263,7385
1987,TSLA  ,2023-02-15,2025-01-17,240.0,4696,4580,9276
1988,TSLA  ,2023-02-15,2025-01-17,250.0,11656,5078,16734
1989,TSLA  ,2023-02-15,2025-01-17,260.0,5622,1805,7427
1990,TSLA  ,2023-02-15,2025-01-17,270.0,3065,1293,4358
1991,TSLA  ,2023-02-15,2025-01-17,280.0,2245,3339,5584
1992,TSLA  ,2023-02-15,2025-01-17,290.0,3424,2807,6231
1993,TSLA  ,2023-02-15,2025-01-17,300.0,30490,3071,33561
1994,TSLA  ,2023-02-15,2025-01-17,310.0,4380,695,5075
1995,TSLA  ,2023-02-15,2025-01-17,320.0,2105,792,2897
1996,TSLA  ,2023-02-15,2025-01-17,330.0,2340,949,3289
1997,TSLA  ,2023-02-15,2025-01-17,340.0,1395,412,1807
1998,TSLA  ,2023-02-15,2025-01-17,350.0,7133,769,7902
1999,TSLA  ,2023-02-15,2025-01-17,360.0,1973,179,2152
2000,TSLA  ,2023-02-15,2025-01-17,370.0,1891,297,2188
2001,TSLA  ,2023-02-15,2025-01-17,380.0,1377,46,1423
2002,TSLA  ,2023-02-15,2025-01-17,390.0,1722,67,1789
2003,TSLA  ,2023-02-15,2025-01-17,400.0,19394,117,19511
2004,TSLA  ,2023-02-15,2025-01-17,410.0,4164,70,4234
2005,TSLA  ,2023-02-15,2025-01-17,420.0,4044,11,4055
2006,TSLA  ,2023-02-15,2025-01-17,430.0,590,2,592
2007,TSLA  ,2023-02-15,2025-01-17,440.0,1584,9,1593
2008,TSLA  ,2023-02-15,2025-01-17,450.0,3654,4,3658
2009,TSLA  ,2023-02-15,2025-01-17,460.0,1008,14,1022
2010,TSLA  ,2023-02-15,2025-01-17,470.0,1552,67,1619
2011,TSLA  ,2023-02-15,2025-01-17,480.0,1246,1,1247
2012,TSLA  ,2023-02-15,2025-01-17,490.0,804,0,804
2013,TSLA  ,2023-02-15,2025-01-17,500.0,10593,9,10602
2014,TSLA  ,2023-02-15,2025-01-17,510.0,1066,308,1374
2015,TSLA  ,2023-02-15,2025-01-17,520.0,8346,1,8347
2016,TSLA  ,2023-02-15,2025-01-17,530.0,652,0,652
2017,TSLA  ,2023-02-15,2025-01-17,540.0,603,0,603
2018,TSLA  ,2023-02-15,2025-01-17,550.0,3079,0,3079
2019,TSLA  ,2023-02-15,2025-01-17,560.0,631,0,631
2020,TSLA  ,2023-02-15,2025-01-17,570.0,660,0,660
2021,TSLA  ,2023-02-15,2025-01-17,580.0,879,0,879
2022,TSLA  ,2023-02-15,2025-01-17,590.0,756,1,757
2023,TSLA  ,2023-02-15,2025-01-17,600.0,15249,4,15253
2024,TSLA  ,2023-02-15,2025-01-17,610.0,17785,105,17890
2025,TSLA  ,2023-02-15,2025-06-20,5.0,229,974,1203
2026,TSLA  ,2023-02-15,2025-06-20,10.0,3,85,88
2027,TSLA  ,2023-02-15,2025-06-20,15.0,7,5847,5854
2028,TSLA  ,2023-02-15,2025-06-20,20.0,51,421,472
2029,TSLA  ,2023-02-15,2025-06-20,25.0,9,134,143
2030,TSLA  ,2023-02-15,2025-06-20,30.0,83,240,323
2031,TSLA  ,2023-02-15,2025-06-20,35.0,11,178,189
2032,TSLA  ,2023-02-15,2025-06-20,40.0,10,280,290
2033,TSLA  ,2023-02-15,2025-06-20,45.0,17,53,70
2034,TSLA  ,2023-02-15,2025-06-20,50.0,157,745,902
2035,TSLA  ,2023-02-15,2025-06-20,55.0,13,54,67
2036,TSLA  ,2023-02-15,2025-06-20,60.0,14,623,637
2037,TSLA  ,2023-02-15,2025-06-20,65.0,19,575,594
2038,TSLA  ,2023-02-15,2025-06-20,70.0,164,125,289
2039,TSLA  ,2023-02-15,2025-06-20,75.0,130,1285,1415
2040,TSLA  ,2023-02-15,2025-06-20,80.0,802,442,1244
2041,TSLA  ,2023-02-15,2025-06-20,85.0,351,243,594
2042,TSLA  ,2023-02-15,2025-06-20,90.0,10311,440,10751
2043,TSLA  ,2023-02-15,2025-06-20,95.0,46438,545,46983
2044,TSLA  ,2023-02-15,2025-06-20,100.0,973,5128,6101
2045,TSLA  ,2023-02-15,2025-06-20,105.0,157,438,595
2046,TSLA  ,2023-02-15,2025-06-20,110.0,353,1610,1963
2047,TSLA  ,2023-02-15,2025-06-20,115.0,433,257,690
2048,TSLA  ,2023-02-15,2025-06-20,120.0,510,974,1484
2049,TSLA  ,2023-02-15,2025-06-20,125.0,507,368,875
2050,TSLA  ,2023-02-15,2025-06-20,130.0,2601,1517,4118
2051,TSLA  ,2023-02-15,2025-06-20,135.0,4673,271,4944
2052,TSLA  ,2023-02-15,2025-06-20,140.0,985,2771,3756
2053,TSLA  ,2023-02-15,2025-06-20,145.0,407,482,889
2054,TSLA  ,2023-02-15,2025-06-20,150.0,1394,1305,2699
2055,TSLA  ,2023-02-15,2025-06-20,155.0,401,123,524
2056,TSLA  ,2023-02-15,2025-06-20,160.0,2169,836,3005
2057,TSLA  ,2023-02-15,2025-06-20,165.0,936,329,1265
2058,TSLA  ,2023-02-15,2025-06-20,170.0,2823,990,3813
2059,TSLA  ,2023-02-15,2025-06-20,175.0,743,1191,1934
2060,TSLA  ,2023-02-15,2025-06-20,180.0,636,541,1177
2061,TSLA  ,2023-02-15,2025-06-20,185.0,2464,192,2656
2062,TSLA  ,2023-02-15,2025-06-20,190.0,527,340,867
2063,TSLA  ,2023-02-15,2025-06-20,195.0,330,369,699
2064,TSLA  ,2023-02-15,2025-06-20,200.0,4240,3280,7520
2065,TSLA  ,2023-02-15,2025-06-20,205.0,274,214,488
2066,TSLA  ,2023-02-15,2025-06-20,210.0,411,118,529
2067,TSLA  ,2023-02-15,2025-06-20,215.0,134,34,168
2068,TSLA  ,2023-02-15,2025-06-20,220.0,671,91,762
2069,TSLA  ,2023-02-15,2025-06-20,225.0,535,192,727
2070,TSLA  ,2023-02-15,2025-06-20,230.0,534,80,614
2071,TSLA  ,2023-02-15,2025-06-20,235.0,337,253,590
2072,TSLA  ,2023-02-15,2025-06-20,240.0,4197,1395,5592
2073,TSLA  ,2023-02-15,2025-06-20,250.0,2050,541,2591
2074,TSLA  ,2023-02-15,2025-06-20,260.0,456,1337,1793
2075,TSLA  ,2023-02-15,2025-06-20,270.0,525,100,625
2076,TSLA  ,2023-02-15,2025-06-20,280.0,230,244,474
2077,TSLA  ,2023-02-15,2025-06-20,290.0,230,398,628
2078,TSLA  ,2023-02-15,2025-06-20,300.0,2812,641,3453
2079,TSLA  ,2023-02-15,2025-06-20,310.0,252,179,431
2080,TSLA  ,2023-02-15,2025-06-20,320.0,831,294,1125
2081,TSLA  ,2023-02-15,2025-06-20,330.0,202,186,388
2082,TSLA  ,2023-02-15,2025-06-20,340.0,453,346,799
2083,TSLA  ,2023-02-15,2025-06-20,350.0,2685,183,2868
2084,TSLA  ,2023-02-15,2025-06-20,360.0,674,197,871
2085,TSLA  ,2023-02-15,2025-06-20,370.0,172,153,325
2086,TSLA  ,2023-02-15,2025-06-20,380.0,80,13,93
2087,TSLA  ,2023-02-15,2025-06-20,390.0,1979,75,2054
