index,ProductSymbol,DateGen,ExpDate,Strike,Call,Put,TotalOI
0,TSLA  ,2023-02-09,2023-02-10,15.0,109,187,296
1,TSLA  ,2023-02-09,2023-02-10,20.0,19,1,20
2,TSLA  ,2023-02-09,2023-02-10,25.0,11,250,261
3,TSLA  ,2023-02-09,2023-02-10,30.0,7,1498,1505
4,TSLA  ,2023-02-09,2023-02-10,35.0,2,1462,1464
5,TSLA  ,2023-02-09,2023-02-10,40.0,2,934,936
6,TSLA  ,2023-02-09,2023-02-10,45.0,1,1869,1870
7,TSLA  ,2023-02-09,2023-02-10,50.0,10,2204,2214
8,TSLA  ,2023-02-09,2023-02-10,55.0,3,1158,1161
9,TSLA  ,2023-02-09,2023-02-10,60.0,10,2416,2426
10,TSLA  ,2023-02-09,2023-02-10,65.0,5,1705,1710
11,TSLA  ,2023-02-09,2023-02-10,70.0,14,1611,1625
12,TSLA  ,2023-02-09,2023-02-10,75.0,5,647,652
13,TSLA  ,2023-02-09,2023-02-10,80.0,69,1921,1990
14,TSLA  ,2023-02-09,2023-02-10,85.0,24,1022,1046
15,TSLA  ,2023-02-09,2023-02-10,90.0,59,1793,1852
16,TSLA  ,2023-02-09,2023-02-10,95.0,34,1370,1404
17,TSLA  ,2023-02-09,2023-02-10,98.0,42,695,737
18,TSLA  ,2023-02-09,2023-02-10,99.0,36,1226,1262
19,TSLA  ,2023-02-09,2023-02-10,100.0,164,3115,3279
20,TSLA  ,2023-02-09,2023-02-10,101.0,107,1894,2001
21,TSLA  ,2023-02-09,2023-02-10,102.0,51,513,564
22,TSLA  ,2023-02-09,2023-02-10,103.0,62,997,1059
23,TSLA  ,2023-02-09,2023-02-10,104.0,63,864,927
24,TSLA  ,2023-02-09,2023-02-10,105.0,157,3327,3484
25,TSLA  ,2023-02-09,2023-02-10,106.0,26,1778,1804
26,TSLA  ,2023-02-09,2023-02-10,107.0,54,1827,1881
27,TSLA  ,2023-02-09,2023-02-10,108.0,76,1530,1606
28,TSLA  ,2023-02-09,2023-02-10,109.0,104,1127,1231
29,TSLA  ,2023-02-09,2023-02-10,110.0,539,2354,2893
30,TSLA  ,2023-02-09,2023-02-10,111.0,102,383,485
31,TSLA  ,2023-02-09,2023-02-10,112.0,47,2474,2521
32,TSLA  ,2023-02-09,2023-02-10,113.0,173,1098,1271
33,TSLA  ,2023-02-09,2023-02-10,114.0,142,6026,6168
34,TSLA  ,2023-02-09,2023-02-10,115.0,269,2596,2865
35,TSLA  ,2023-02-09,2023-02-10,116.0,100,1084,1184
36,TSLA  ,2023-02-09,2023-02-10,117.0,175,1609,1784
37,TSLA  ,2023-02-09,2023-02-10,118.0,159,2835,2994
38,TSLA  ,2023-02-09,2023-02-10,119.0,145,816,961
39,TSLA  ,2023-02-09,2023-02-10,120.0,708,5079,5787
40,TSLA  ,2023-02-09,2023-02-10,121.0,243,1777,2020
41,TSLA  ,2023-02-09,2023-02-10,122.0,598,1208,1806
42,TSLA  ,2023-02-09,2023-02-10,123.0,271,1629,1900
43,TSLA  ,2023-02-09,2023-02-10,124.0,328,1550,1878
44,TSLA  ,2023-02-09,2023-02-10,125.0,856,4561,5417
45,TSLA  ,2023-02-09,2023-02-10,126.0,235,1102,1337
46,TSLA  ,2023-02-09,2023-02-10,127.0,377,1912,2289
47,TSLA  ,2023-02-09,2023-02-10,128.0,1144,1351,2495
48,TSLA  ,2023-02-09,2023-02-10,129.0,586,3349,3935
49,TSLA  ,2023-02-09,2023-02-10,130.0,1448,6662,8110
50,TSLA  ,2023-02-09,2023-02-10,131.0,531,2478,3009
51,TSLA  ,2023-02-09,2023-02-10,132.0,652,2086,2738
52,TSLA  ,2023-02-09,2023-02-10,133.0,750,2161,2911
53,TSLA  ,2023-02-09,2023-02-10,134.0,320,4826,5146
54,TSLA  ,2023-02-09,2023-02-10,135.0,1542,6497,8039
55,TSLA  ,2023-02-09,2023-02-10,136.0,391,3119,3510
56,TSLA  ,2023-02-09,2023-02-10,137.0,514,2829,3343
57,TSLA  ,2023-02-09,2023-02-10,138.0,793,5638,6431
58,TSLA  ,2023-02-09,2023-02-10,139.0,959,6547,7506
59,TSLA  ,2023-02-09,2023-02-10,140.0,2599,7943,10542
60,TSLA  ,2023-02-09,2023-02-10,141.0,739,1648,2387
61,TSLA  ,2023-02-09,2023-02-10,142.0,1276,3898,5174
62,TSLA  ,2023-02-09,2023-02-10,143.0,584,570,1154
63,TSLA  ,2023-02-09,2023-02-10,144.0,326,1383,1709
64,TSLA  ,2023-02-09,2023-02-10,145.0,2156,12741,14897
65,TSLA  ,2023-02-09,2023-02-10,146.0,895,1925,2820
66,TSLA  ,2023-02-09,2023-02-10,147.0,1007,3196,4203
67,TSLA  ,2023-02-09,2023-02-10,148.0,412,2401,2813
68,TSLA  ,2023-02-09,2023-02-10,149.0,322,2057,2379
69,TSLA  ,2023-02-09,2023-02-10,150.0,4012,12140,16152
70,TSLA  ,2023-02-09,2023-02-10,152.5,534,3609,4143
71,TSLA  ,2023-02-09,2023-02-10,155.0,6146,7457,13603
72,TSLA  ,2023-02-09,2023-02-10,157.5,1152,4578,5730
73,TSLA  ,2023-02-09,2023-02-10,160.0,3510,10849,14359
74,TSLA  ,2023-02-09,2023-02-10,162.5,1091,3262,4353
75,TSLA  ,2023-02-09,2023-02-10,165.0,4676,12496,17172
76,TSLA  ,2023-02-09,2023-02-10,167.5,1314,4950,6264
77,TSLA  ,2023-02-09,2023-02-10,170.0,5952,15607,21559
78,TSLA  ,2023-02-09,2023-02-10,172.5,2456,6484,8940
79,TSLA  ,2023-02-09,2023-02-10,175.0,5636,13466,19102
80,TSLA  ,2023-02-09,2023-02-10,177.5,2332,6104,8436
81,TSLA  ,2023-02-09,2023-02-10,180.0,7321,17634,24955
82,TSLA  ,2023-02-09,2023-02-10,182.5,2364,8474,10838
83,TSLA  ,2023-02-09,2023-02-10,185.0,7899,19419,27318
84,TSLA  ,2023-02-09,2023-02-10,187.5,2109,8382,10491
85,TSLA  ,2023-02-09,2023-02-10,190.0,14368,20213,34581
86,TSLA  ,2023-02-09,2023-02-10,192.5,3692,7431,11123
87,TSLA  ,2023-02-09,2023-02-10,195.0,14580,16617,31197
88,TSLA  ,2023-02-09,2023-02-10,197.5,7844,4832,12676
89,TSLA  ,2023-02-09,2023-02-10,200.0,33616,17719,51335
90,TSLA  ,2023-02-09,2023-02-10,202.5,11148,3149,14297
91,TSLA  ,2023-02-09,2023-02-10,205.0,21054,3049,24103
92,TSLA  ,2023-02-09,2023-02-10,207.5,7351,2167,9518
93,TSLA  ,2023-02-09,2023-02-10,210.0,26731,3270,30001
94,TSLA  ,2023-02-09,2023-02-10,212.5,5483,1067,6550
95,TSLA  ,2023-02-09,2023-02-10,215.0,17602,1760,19362
96,TSLA  ,2023-02-09,2023-02-10,217.5,6615,465,7080
97,TSLA  ,2023-02-09,2023-02-10,220.0,24174,1634,25808
98,TSLA  ,2023-02-09,2023-02-10,222.5,6071,284,6355
99,TSLA  ,2023-02-09,2023-02-10,225.0,11295,530,11825
100,TSLA  ,2023-02-09,2023-02-10,227.5,6602,205,6807
101,TSLA  ,2023-02-09,2023-02-10,230.0,15959,648,16607
102,TSLA  ,2023-02-09,2023-02-10,232.5,4027,127,4154
103,TSLA  ,2023-02-09,2023-02-10,235.0,12249,253,12502
104,TSLA  ,2023-02-09,2023-02-10,237.5,2865,105,2970
105,TSLA  ,2023-02-09,2023-02-10,240.0,11300,162,11462
106,TSLA  ,2023-02-09,2023-02-10,242.5,2884,0,2884
107,TSLA  ,2023-02-09,2023-02-10,245.0,8497,14,8511
108,TSLA  ,2023-02-09,2023-02-10,247.5,5696,0,5696
109,TSLA  ,2023-02-09,2023-02-10,250.0,14164,32,14196
110,TSLA  ,2023-02-09,2023-02-10,252.5,1270,0,1270
111,TSLA  ,2023-02-09,2023-02-10,255.0,6239,16,6255
112,TSLA  ,2023-02-09,2023-02-10,257.5,1690,1,1691
113,TSLA  ,2023-02-09,2023-02-10,260.0,9340,0,9340
114,TSLA  ,2023-02-09,2023-02-10,265.0,6706,10,6716
115,TSLA  ,2023-02-09,2023-02-10,270.0,12375,0,12375
116,TSLA  ,2023-02-09,2023-02-10,275.0,7991,0,7991
117,TSLA  ,2023-02-09,2023-02-10,280.0,7880,0,7880
118,TSLA  ,2023-02-09,2023-02-10,285.0,12163,0,12163
119,TSLA  ,2023-02-09,2023-02-10,290.0,9158,0,9158
120,TSLA  ,2023-02-09,2023-02-10,295.0,4160,0,4160
121,TSLA  ,2023-02-09,2023-02-10,300.0,3535,1,3536
122,TSLA  ,2023-02-09,2023-02-10,310.0,1721,0,1721
123,TSLA  ,2023-02-09,2023-02-10,320.0,1521,0,1521
124,TSLA  ,2023-02-09,2023-02-10,330.0,1239,0,1239
125,TSLA  ,2023-02-09,2023-02-10,340.0,1341,0,1341
126,TSLA  ,2023-02-09,2023-02-10,350.0,2089,0,2089
127,TSLA  ,2023-02-09,2023-02-10,360.0,3226,0,3226
128,TSLA  ,2023-02-09,2023-02-17,15.0,172,304,476
129,TSLA  ,2023-02-09,2023-02-17,20.0,35,41,76
130,TSLA  ,2023-02-09,2023-02-17,25.0,4,99,103
131,TSLA  ,2023-02-09,2023-02-17,30.0,71,2723,2794
132,TSLA  ,2023-02-09,2023-02-17,35.0,0,5413,5413
133,TSLA  ,2023-02-09,2023-02-17,40.0,163,10375,10538
134,TSLA  ,2023-02-09,2023-02-17,45.0,0,1739,1739
135,TSLA  ,2023-02-09,2023-02-17,50.0,977,17136,18113
136,TSLA  ,2023-02-09,2023-02-17,55.0,41,5311,5352
137,TSLA  ,2023-02-09,2023-02-17,60.0,488,9043,9531
138,TSLA  ,2023-02-09,2023-02-17,65.0,28,6535,6563
139,TSLA  ,2023-02-09,2023-02-17,70.0,74,53619,53693
140,TSLA  ,2023-02-09,2023-02-17,75.0,128,7661,7789
141,TSLA  ,2023-02-09,2023-02-17,80.0,204,27813,28017
142,TSLA  ,2023-02-09,2023-02-17,85.0,259,13279,13538
143,TSLA  ,2023-02-09,2023-02-17,90.0,284,16687,16971
144,TSLA  ,2023-02-09,2023-02-17,95.0,821,17562,18383
145,TSLA  ,2023-02-09,2023-02-17,100.0,3350,38357,41707
146,TSLA  ,2023-02-09,2023-02-17,105.0,20739,29269,50008
147,TSLA  ,2023-02-09,2023-02-17,110.0,3500,25716,29216
148,TSLA  ,2023-02-09,2023-02-17,115.0,15403,23896,39299
149,TSLA  ,2023-02-09,2023-02-17,118.0,266,1643,1909
150,TSLA  ,2023-02-09,2023-02-17,119.0,12,1374,1386
151,TSLA  ,2023-02-09,2023-02-17,120.0,26352,48750,75102
152,TSLA  ,2023-02-09,2023-02-17,121.0,30,1023,1053
153,TSLA  ,2023-02-09,2023-02-17,122.0,184,1331,1515
154,TSLA  ,2023-02-09,2023-02-17,123.0,97,1525,1622
155,TSLA  ,2023-02-09,2023-02-17,124.0,31,1188,1219
156,TSLA  ,2023-02-09,2023-02-17,125.0,12248,16202,28450
157,TSLA  ,2023-02-09,2023-02-17,126.0,47,1124,1171
158,TSLA  ,2023-02-09,2023-02-17,127.0,65,1224,1289
159,TSLA  ,2023-02-09,2023-02-17,128.0,50,2377,2427
160,TSLA  ,2023-02-09,2023-02-17,129.0,93,1622,1715
161,TSLA  ,2023-02-09,2023-02-17,130.0,13516,14900,28416
162,TSLA  ,2023-02-09,2023-02-17,131.0,151,1374,1525
163,TSLA  ,2023-02-09,2023-02-17,132.0,227,1334,1561
164,TSLA  ,2023-02-09,2023-02-17,133.0,70,1306,1376
165,TSLA  ,2023-02-09,2023-02-17,134.0,361,1614,1975
166,TSLA  ,2023-02-09,2023-02-17,135.0,7756,10809,18565
167,TSLA  ,2023-02-09,2023-02-17,136.0,1428,3271,4699
168,TSLA  ,2023-02-09,2023-02-17,137.0,869,1562,2431
169,TSLA  ,2023-02-09,2023-02-17,138.0,1183,1342,2525
170,TSLA  ,2023-02-09,2023-02-17,139.0,940,1043,1983
171,TSLA  ,2023-02-09,2023-02-17,140.0,8021,16054,24075
172,TSLA  ,2023-02-09,2023-02-17,141.0,327,1702,2029
173,TSLA  ,2023-02-09,2023-02-17,142.0,915,1544,2459
174,TSLA  ,2023-02-09,2023-02-17,143.0,268,1252,1520
175,TSLA  ,2023-02-09,2023-02-17,144.0,320,1119,1439
176,TSLA  ,2023-02-09,2023-02-17,145.0,12327,21656,33983
177,TSLA  ,2023-02-09,2023-02-17,146.0,1748,1363,3111
178,TSLA  ,2023-02-09,2023-02-17,147.0,530,4364,4894
179,TSLA  ,2023-02-09,2023-02-17,148.0,248,2082,2330
180,TSLA  ,2023-02-09,2023-02-17,149.0,458,1749,2207
181,TSLA  ,2023-02-09,2023-02-17,150.0,15256,25277,40533
182,TSLA  ,2023-02-09,2023-02-17,152.5,1069,2523,3592
183,TSLA  ,2023-02-09,2023-02-17,155.0,10430,8930,19360
184,TSLA  ,2023-02-09,2023-02-17,157.5,1495,4013,5508
185,TSLA  ,2023-02-09,2023-02-17,160.0,29332,20155,49487
186,TSLA  ,2023-02-09,2023-02-17,162.5,1385,5235,6620
187,TSLA  ,2023-02-09,2023-02-17,165.0,12612,11777,24389
188,TSLA  ,2023-02-09,2023-02-17,167.5,1005,3685,4690
189,TSLA  ,2023-02-09,2023-02-17,170.0,19329,17801,37130
190,TSLA  ,2023-02-09,2023-02-17,172.5,2234,5361,7595
191,TSLA  ,2023-02-09,2023-02-17,175.0,10220,10456,20676
192,TSLA  ,2023-02-09,2023-02-17,177.5,2378,3095,5473
193,TSLA  ,2023-02-09,2023-02-17,180.0,12597,19722,32319
194,TSLA  ,2023-02-09,2023-02-17,182.5,4775,3785,8560
195,TSLA  ,2023-02-09,2023-02-17,185.0,14761,7917,22678
196,TSLA  ,2023-02-09,2023-02-17,187.5,2201,2332,4533
197,TSLA  ,2023-02-09,2023-02-17,190.0,16618,14845,31463
198,TSLA  ,2023-02-09,2023-02-17,192.5,3370,2911,6281
199,TSLA  ,2023-02-09,2023-02-17,195.0,8438,7213,15651
200,TSLA  ,2023-02-09,2023-02-17,197.5,5228,2771,7999
201,TSLA  ,2023-02-09,2023-02-17,200.0,47282,8622,55904
202,TSLA  ,2023-02-09,2023-02-17,202.5,7369,2034,9403
203,TSLA  ,2023-02-09,2023-02-17,205.0,8770,2300,11070
204,TSLA  ,2023-02-09,2023-02-17,207.5,1447,504,1951
205,TSLA  ,2023-02-09,2023-02-17,210.0,19999,2233,22232
206,TSLA  ,2023-02-09,2023-02-17,212.5,2297,283,2580
207,TSLA  ,2023-02-09,2023-02-17,215.0,14588,1998,16586
208,TSLA  ,2023-02-09,2023-02-17,217.5,1220,47,1267
209,TSLA  ,2023-02-09,2023-02-17,220.0,37046,1955,39001
210,TSLA  ,2023-02-09,2023-02-17,222.5,1383,80,1463
211,TSLA  ,2023-02-09,2023-02-17,225.0,10203,636,10839
212,TSLA  ,2023-02-09,2023-02-17,227.5,640,22,662
213,TSLA  ,2023-02-09,2023-02-17,230.0,11393,591,11984
214,TSLA  ,2023-02-09,2023-02-17,232.5,857,42,899
215,TSLA  ,2023-02-09,2023-02-17,235.0,5238,169,5407
216,TSLA  ,2023-02-09,2023-02-17,237.5,661,48,709
217,TSLA  ,2023-02-09,2023-02-17,240.0,7355,107,7462
218,TSLA  ,2023-02-09,2023-02-17,242.5,1036,2,1038
219,TSLA  ,2023-02-09,2023-02-17,245.0,3283,81,3364
220,TSLA  ,2023-02-09,2023-02-17,247.5,604,2,606
221,TSLA  ,2023-02-09,2023-02-17,250.0,20052,108,20160
222,TSLA  ,2023-02-09,2023-02-17,252.5,428,1,429
223,TSLA  ,2023-02-09,2023-02-17,255.0,9551,22,9573
224,TSLA  ,2023-02-09,2023-02-17,257.5,373,0,373
225,TSLA  ,2023-02-09,2023-02-17,260.0,7563,117,7680
226,TSLA  ,2023-02-09,2023-02-17,262.5,1050,0,1050
227,TSLA  ,2023-02-09,2023-02-17,265.0,4462,58,4520
228,TSLA  ,2023-02-09,2023-02-17,270.0,8962,66,9028
229,TSLA  ,2023-02-09,2023-02-17,275.0,6172,14,6186
230,TSLA  ,2023-02-09,2023-02-17,280.0,6982,16,6998
231,TSLA  ,2023-02-09,2023-02-17,285.0,9526,0,9526
232,TSLA  ,2023-02-09,2023-02-17,290.0,7374,0,7374
233,TSLA  ,2023-02-09,2023-02-17,295.0,3058,2,3060
234,TSLA  ,2023-02-09,2023-02-17,300.0,12464,6,12470
235,TSLA  ,2023-02-09,2023-02-17,305.0,2808,20,2828
236,TSLA  ,2023-02-09,2023-02-17,310.0,2232,0,2232
237,TSLA  ,2023-02-09,2023-02-17,315.0,1697,0,1697
238,TSLA  ,2023-02-09,2023-02-17,320.0,9647,2,9649
239,TSLA  ,2023-02-09,2023-02-17,325.0,2003,0,2003
240,TSLA  ,2023-02-09,2023-02-17,330.0,1889,0,1889
241,TSLA  ,2023-02-09,2023-02-17,335.0,3755,0,3755
242,TSLA  ,2023-02-09,2023-02-17,340.0,2347,0,2347
243,TSLA  ,2023-02-09,2023-02-17,345.0,2724,0,2724
244,TSLA  ,2023-02-09,2023-02-17,350.0,4146,0,4146
245,TSLA  ,2023-02-09,2023-02-17,355.0,1123,0,1123
246,TSLA  ,2023-02-09,2023-02-17,360.0,1953,0,1953
247,TSLA  ,2023-02-09,2023-02-17,365.0,2033,0,2033
248,TSLA  ,2023-02-09,2023-02-17,370.0,1545,0,1545
249,TSLA  ,2023-02-09,2023-02-17,375.0,4565,0,4565
250,TSLA  ,2023-02-09,2023-02-17,380.0,2086,0,2086
251,TSLA  ,2023-02-09,2023-02-17,385.0,883,0,883
252,TSLA  ,2023-02-09,2023-02-17,390.0,1445,0,1445
253,TSLA  ,2023-02-09,2023-02-17,395.0,2035,0,2035
254,TSLA  ,2023-02-09,2023-02-17,400.0,4131,0,4131
255,TSLA  ,2023-02-09,2023-02-17,405.0,578,0,578
256,TSLA  ,2023-02-09,2023-02-17,410.0,798,0,798
257,TSLA  ,2023-02-09,2023-02-17,415.0,755,0,755
258,TSLA  ,2023-02-09,2023-02-17,420.0,794,0,794
259,TSLA  ,2023-02-09,2023-02-17,425.0,532,0,532
260,TSLA  ,2023-02-09,2023-02-17,430.0,728,0,728
261,TSLA  ,2023-02-09,2023-02-17,435.0,358,0,358
262,TSLA  ,2023-02-09,2023-02-17,440.0,822,0,822
263,TSLA  ,2023-02-09,2023-02-17,445.0,235,0,235
264,TSLA  ,2023-02-09,2023-02-17,450.0,753,0,753
265,TSLA  ,2023-02-09,2023-02-17,455.0,1720,0,1720
266,TSLA  ,2023-02-09,2023-02-17,460.0,349,0,349
267,TSLA  ,2023-02-09,2023-02-17,465.0,1039,0,1039
268,TSLA  ,2023-02-09,2023-02-17,470.0,1347,0,1347
269,TSLA  ,2023-02-09,2023-02-17,475.0,593,0,593
270,TSLA  ,2023-02-09,2023-02-17,480.0,347,0,347
271,TSLA  ,2023-02-09,2023-02-17,485.0,689,0,689
272,TSLA  ,2023-02-09,2023-02-17,490.0,242,0,242
273,TSLA  ,2023-02-09,2023-02-17,495.0,400,0,400
274,TSLA  ,2023-02-09,2023-02-17,500.0,3354,0,3354
275,TSLA  ,2023-02-09,2023-02-17,505.0,357,0,357
276,TSLA  ,2023-02-09,2023-02-17,510.0,356,0,356
277,TSLA  ,2023-02-09,2023-02-17,515.0,58,0,58
278,TSLA  ,2023-02-09,2023-02-17,520.0,327,0,327
279,TSLA  ,2023-02-09,2023-02-17,525.0,150,0,150
280,TSLA  ,2023-02-09,2023-02-17,530.0,391,0,391
281,TSLA  ,2023-02-09,2023-02-17,535.0,171,0,171
282,TSLA  ,2023-02-09,2023-02-17,540.0,219,0,219
283,TSLA  ,2023-02-09,2023-02-17,545.0,110,0,110
284,TSLA  ,2023-02-09,2023-02-17,550.0,789,0,789
285,TSLA  ,2023-02-09,2023-02-17,555.0,837,0,837
286,TSLA  ,2023-02-09,2023-02-17,560.0,573,0,573
287,TSLA  ,2023-02-09,2023-02-17,565.0,661,0,661
288,TSLA  ,2023-02-09,2023-02-17,570.0,317,0,317
289,TSLA  ,2023-02-09,2023-02-17,575.0,278,0,278
290,TSLA  ,2023-02-09,2023-02-17,580.0,1203,0,1203
291,TSLA  ,2023-02-09,2023-02-17,585.0,955,0,955
292,TSLA  ,2023-02-09,2023-02-17,590.0,297,0,297
293,TSLA  ,2023-02-09,2023-02-17,595.0,2000,0,2000
294,TSLA  ,2023-02-09,2023-02-17,600.0,2677,0,2677
295,TSLA  ,2023-02-09,2023-02-24,15.0,3,8,11
296,TSLA  ,2023-02-09,2023-02-24,20.0,3,1,4
297,TSLA  ,2023-02-09,2023-02-24,25.0,3,3,6
298,TSLA  ,2023-02-09,2023-02-24,30.0,3,748,751
299,TSLA  ,2023-02-09,2023-02-24,35.0,0,20,20
300,TSLA  ,2023-02-09,2023-02-24,40.0,0,439,439
301,TSLA  ,2023-02-09,2023-02-24,45.0,0,2031,2031
302,TSLA  ,2023-02-09,2023-02-24,50.0,0,1898,1898
303,TSLA  ,2023-02-09,2023-02-24,55.0,3,805,808
304,TSLA  ,2023-02-09,2023-02-24,60.0,11,1451,1462
305,TSLA  ,2023-02-09,2023-02-24,65.0,6,697,703
306,TSLA  ,2023-02-09,2023-02-24,70.0,6,545,551
307,TSLA  ,2023-02-09,2023-02-24,75.0,1,823,824
308,TSLA  ,2023-02-09,2023-02-24,80.0,8,992,1000
309,TSLA  ,2023-02-09,2023-02-24,85.0,1,633,634
310,TSLA  ,2023-02-09,2023-02-24,90.0,43,1411,1454
311,TSLA  ,2023-02-09,2023-02-24,95.0,19,1824,1843
312,TSLA  ,2023-02-09,2023-02-24,98.0,14,342,356
313,TSLA  ,2023-02-09,2023-02-24,99.0,10,611,621
314,TSLA  ,2023-02-09,2023-02-24,100.0,80,2394,2474
315,TSLA  ,2023-02-09,2023-02-24,101.0,14,334,348
316,TSLA  ,2023-02-09,2023-02-24,102.0,3,242,245
317,TSLA  ,2023-02-09,2023-02-24,103.0,7,129,136
318,TSLA  ,2023-02-09,2023-02-24,104.0,17,336,353
319,TSLA  ,2023-02-09,2023-02-24,105.0,45,1939,1984
320,TSLA  ,2023-02-09,2023-02-24,106.0,15,516,531
321,TSLA  ,2023-02-09,2023-02-24,107.0,8,655,663
322,TSLA  ,2023-02-09,2023-02-24,108.0,9,408,417
323,TSLA  ,2023-02-09,2023-02-24,109.0,9,234,243
324,TSLA  ,2023-02-09,2023-02-24,110.0,316,1623,1939
325,TSLA  ,2023-02-09,2023-02-24,111.0,42,449,491
326,TSLA  ,2023-02-09,2023-02-24,112.0,51,437,488
327,TSLA  ,2023-02-09,2023-02-24,113.0,46,547,593
328,TSLA  ,2023-02-09,2023-02-24,114.0,379,771,1150
329,TSLA  ,2023-02-09,2023-02-24,115.0,380,1090,1470
330,TSLA  ,2023-02-09,2023-02-24,116.0,357,592,949
331,TSLA  ,2023-02-09,2023-02-24,117.0,277,328,605
332,TSLA  ,2023-02-09,2023-02-24,118.0,187,479,666
333,TSLA  ,2023-02-09,2023-02-24,119.0,207,599,806
334,TSLA  ,2023-02-09,2023-02-24,120.0,435,2418,2853
335,TSLA  ,2023-02-09,2023-02-24,121.0,312,838,1150
336,TSLA  ,2023-02-09,2023-02-24,122.0,299,2477,2776
337,TSLA  ,2023-02-09,2023-02-24,123.0,443,596,1039
338,TSLA  ,2023-02-09,2023-02-24,124.0,157,254,411
339,TSLA  ,2023-02-09,2023-02-24,125.0,535,2308,2843
340,TSLA  ,2023-02-09,2023-02-24,126.0,162,469,631
341,TSLA  ,2023-02-09,2023-02-24,127.0,86,384,470
342,TSLA  ,2023-02-09,2023-02-24,128.0,215,667,882
343,TSLA  ,2023-02-09,2023-02-24,129.0,238,910,1148
344,TSLA  ,2023-02-09,2023-02-24,130.0,2599,2404,5003
345,TSLA  ,2023-02-09,2023-02-24,131.0,408,147,555
346,TSLA  ,2023-02-09,2023-02-24,132.0,243,764,1007
347,TSLA  ,2023-02-09,2023-02-24,133.0,143,407,550
348,TSLA  ,2023-02-09,2023-02-24,134.0,275,677,952
349,TSLA  ,2023-02-09,2023-02-24,135.0,1922,1531,3453
350,TSLA  ,2023-02-09,2023-02-24,136.0,81,443,524
351,TSLA  ,2023-02-09,2023-02-24,137.0,66,332,398
352,TSLA  ,2023-02-09,2023-02-24,138.0,66,464,530
353,TSLA  ,2023-02-09,2023-02-24,139.0,472,264,736
354,TSLA  ,2023-02-09,2023-02-24,140.0,1752,1954,3706
355,TSLA  ,2023-02-09,2023-02-24,141.0,363,699,1062
356,TSLA  ,2023-02-09,2023-02-24,142.0,389,631,1020
357,TSLA  ,2023-02-09,2023-02-24,143.0,84,236,320
358,TSLA  ,2023-02-09,2023-02-24,144.0,65,284,349
359,TSLA  ,2023-02-09,2023-02-24,145.0,1600,4581,6181
360,TSLA  ,2023-02-09,2023-02-24,146.0,53,535,588
361,TSLA  ,2023-02-09,2023-02-24,147.0,45,269,314
362,TSLA  ,2023-02-09,2023-02-24,148.0,134,393,527
363,TSLA  ,2023-02-09,2023-02-24,149.0,101,1039,1140
364,TSLA  ,2023-02-09,2023-02-24,150.0,2618,5531,8149
365,TSLA  ,2023-02-09,2023-02-24,152.5,94,1602,1696
366,TSLA  ,2023-02-09,2023-02-24,155.0,1623,5625,7248
367,TSLA  ,2023-02-09,2023-02-24,157.5,643,592,1235
368,TSLA  ,2023-02-09,2023-02-24,160.0,2936,3463,6399
369,TSLA  ,2023-02-09,2023-02-24,162.5,418,490,908
370,TSLA  ,2023-02-09,2023-02-24,165.0,2407,1341,3748
371,TSLA  ,2023-02-09,2023-02-24,167.5,984,1424,2408
372,TSLA  ,2023-02-09,2023-02-24,170.0,2819,2534,5353
373,TSLA  ,2023-02-09,2023-02-24,172.5,560,359,919
374,TSLA  ,2023-02-09,2023-02-24,175.0,2660,1580,4240
375,TSLA  ,2023-02-09,2023-02-24,177.5,384,2368,2752
376,TSLA  ,2023-02-09,2023-02-24,180.0,2863,2920,5783
377,TSLA  ,2023-02-09,2023-02-24,182.5,462,752,1214
378,TSLA  ,2023-02-09,2023-02-24,185.0,1487,2453,3940
379,TSLA  ,2023-02-09,2023-02-24,187.5,449,955,1404
380,TSLA  ,2023-02-09,2023-02-24,190.0,1880,3090,4970
381,TSLA  ,2023-02-09,2023-02-24,192.5,1308,1490,2798
382,TSLA  ,2023-02-09,2023-02-24,195.0,2134,1300,3434
383,TSLA  ,2023-02-09,2023-02-24,197.5,1570,1245,2815
384,TSLA  ,2023-02-09,2023-02-24,200.0,6411,2151,8562
385,TSLA  ,2023-02-09,2023-02-24,202.5,1135,593,1728
386,TSLA  ,2023-02-09,2023-02-24,205.0,2708,369,3077
387,TSLA  ,2023-02-09,2023-02-24,207.5,303,380,683
388,TSLA  ,2023-02-09,2023-02-24,210.0,3428,221,3649
389,TSLA  ,2023-02-09,2023-02-24,212.5,637,171,808
390,TSLA  ,2023-02-09,2023-02-24,215.0,1688,143,1831
391,TSLA  ,2023-02-09,2023-02-24,217.5,353,43,396
392,TSLA  ,2023-02-09,2023-02-24,220.0,5664,39,5703
393,TSLA  ,2023-02-09,2023-02-24,222.5,422,11,433
394,TSLA  ,2023-02-09,2023-02-24,225.0,3098,29,3127
395,TSLA  ,2023-02-09,2023-02-24,230.0,3005,41,3046
396,TSLA  ,2023-02-09,2023-02-24,235.0,1150,27,1177
397,TSLA  ,2023-02-09,2023-02-24,240.0,4347,8,4355
398,TSLA  ,2023-02-09,2023-02-24,245.0,1876,7,1883
399,TSLA  ,2023-02-09,2023-02-24,250.0,3218,23,3241
400,TSLA  ,2023-02-09,2023-02-24,255.0,706,1,707
401,TSLA  ,2023-02-09,2023-02-24,260.0,9703,5,9708
402,TSLA  ,2023-02-09,2023-02-24,265.0,1113,3,1116
403,TSLA  ,2023-02-09,2023-02-24,270.0,1134,4,1138
404,TSLA  ,2023-02-09,2023-02-24,275.0,1396,3,1399
405,TSLA  ,2023-02-09,2023-02-24,280.0,1872,4,1876
406,TSLA  ,2023-02-09,2023-02-24,285.0,3036,0,3036
407,TSLA  ,2023-02-09,2023-02-24,290.0,993,0,993
408,TSLA  ,2023-02-09,2023-02-24,295.0,293,0,293
409,TSLA  ,2023-02-09,2023-02-24,300.0,3513,0,3513
410,TSLA  ,2023-02-09,2023-02-24,310.0,1472,0,1472
411,TSLA  ,2023-02-09,2023-02-24,320.0,771,0,771
412,TSLA  ,2023-02-09,2023-02-24,330.0,628,0,628
413,TSLA  ,2023-02-09,2023-02-24,340.0,522,0,522
414,TSLA  ,2023-02-09,2023-02-24,350.0,1764,0,1764
415,TSLA  ,2023-02-09,2023-02-24,360.0,1534,0,1534
416,TSLA  ,2023-02-09,2023-03-03,15.0,8,256,264
417,TSLA  ,2023-02-09,2023-03-03,20.0,1,0,1
418,TSLA  ,2023-02-09,2023-03-03,25.0,4,47,51
419,TSLA  ,2023-02-09,2023-03-03,30.0,3,340,343
420,TSLA  ,2023-02-09,2023-03-03,35.0,3,1,4
421,TSLA  ,2023-02-09,2023-03-03,40.0,0,10,10
422,TSLA  ,2023-02-09,2023-03-03,45.0,0,2456,2456
423,TSLA  ,2023-02-09,2023-03-03,50.0,1,886,887
424,TSLA  ,2023-02-09,2023-03-03,55.0,0,156,156
425,TSLA  ,2023-02-09,2023-03-03,60.0,5,1112,1117
426,TSLA  ,2023-02-09,2023-03-03,65.0,1,79,80
427,TSLA  ,2023-02-09,2023-03-03,70.0,2,647,649
428,TSLA  ,2023-02-09,2023-03-03,75.0,0,258,258
429,TSLA  ,2023-02-09,2023-03-03,80.0,112,1074,1186
430,TSLA  ,2023-02-09,2023-03-03,85.0,4,557,561
431,TSLA  ,2023-02-09,2023-03-03,90.0,7,1023,1030
432,TSLA  ,2023-02-09,2023-03-03,95.0,7,1829,1836
433,TSLA  ,2023-02-09,2023-03-03,100.0,58,1914,1972
434,TSLA  ,2023-02-09,2023-03-03,105.0,16,648,664
435,TSLA  ,2023-02-09,2023-03-03,108.0,59,484,543
436,TSLA  ,2023-02-09,2023-03-03,109.0,34,295,329
437,TSLA  ,2023-02-09,2023-03-03,110.0,97,2980,3077
438,TSLA  ,2023-02-09,2023-03-03,111.0,7,555,562
439,TSLA  ,2023-02-09,2023-03-03,112.0,36,695,731
440,TSLA  ,2023-02-09,2023-03-03,113.0,28,558,586
441,TSLA  ,2023-02-09,2023-03-03,114.0,155,492,647
442,TSLA  ,2023-02-09,2023-03-03,115.0,168,846,1014
443,TSLA  ,2023-02-09,2023-03-03,116.0,158,395,553
444,TSLA  ,2023-02-09,2023-03-03,117.0,472,744,1216
445,TSLA  ,2023-02-09,2023-03-03,118.0,302,277,579
446,TSLA  ,2023-02-09,2023-03-03,119.0,318,507,825
447,TSLA  ,2023-02-09,2023-03-03,120.0,813,1593,2406
448,TSLA  ,2023-02-09,2023-03-03,121.0,120,503,623
449,TSLA  ,2023-02-09,2023-03-03,122.0,117,902,1019
450,TSLA  ,2023-02-09,2023-03-03,123.0,263,617,880
451,TSLA  ,2023-02-09,2023-03-03,124.0,446,438,884
452,TSLA  ,2023-02-09,2023-03-03,125.0,280,724,1004
453,TSLA  ,2023-02-09,2023-03-03,126.0,670,377,1047
454,TSLA  ,2023-02-09,2023-03-03,127.0,429,248,677
455,TSLA  ,2023-02-09,2023-03-03,128.0,454,790,1244
456,TSLA  ,2023-02-09,2023-03-03,129.0,646,548,1194
457,TSLA  ,2023-02-09,2023-03-03,130.0,683,1510,2193
458,TSLA  ,2023-02-09,2023-03-03,131.0,304,748,1052
459,TSLA  ,2023-02-09,2023-03-03,132.0,827,646,1473
460,TSLA  ,2023-02-09,2023-03-03,133.0,538,111,649
461,TSLA  ,2023-02-09,2023-03-03,134.0,567,1236,1803
462,TSLA  ,2023-02-09,2023-03-03,135.0,872,1078,1950
463,TSLA  ,2023-02-09,2023-03-03,136.0,92,68,160
464,TSLA  ,2023-02-09,2023-03-03,137.0,67,100,167
465,TSLA  ,2023-02-09,2023-03-03,138.0,151,318,469
466,TSLA  ,2023-02-09,2023-03-03,139.0,106,174,280
467,TSLA  ,2023-02-09,2023-03-03,140.0,691,1368,2059
468,TSLA  ,2023-02-09,2023-03-03,141.0,67,108,175
469,TSLA  ,2023-02-09,2023-03-03,142.0,295,193,488
470,TSLA  ,2023-02-09,2023-03-03,143.0,10,34,44
471,TSLA  ,2023-02-09,2023-03-03,144.0,21,2114,2135
472,TSLA  ,2023-02-09,2023-03-03,145.0,676,3728,4404
473,TSLA  ,2023-02-09,2023-03-03,146.0,26,547,573
474,TSLA  ,2023-02-09,2023-03-03,147.0,43,203,246
475,TSLA  ,2023-02-09,2023-03-03,148.0,28,368,396
476,TSLA  ,2023-02-09,2023-03-03,149.0,256,1656,1912
477,TSLA  ,2023-02-09,2023-03-03,150.0,1015,5488,6503
478,TSLA  ,2023-02-09,2023-03-03,152.5,154,813,967
479,TSLA  ,2023-02-09,2023-03-03,155.0,1163,996,2159
480,TSLA  ,2023-02-09,2023-03-03,157.5,121,400,521
481,TSLA  ,2023-02-09,2023-03-03,160.0,1070,3477,4547
482,TSLA  ,2023-02-09,2023-03-03,162.5,200,4314,4514
483,TSLA  ,2023-02-09,2023-03-03,165.0,1833,1340,3173
484,TSLA  ,2023-02-09,2023-03-03,167.5,252,439,691
485,TSLA  ,2023-02-09,2023-03-03,170.0,2466,4288,6754
486,TSLA  ,2023-02-09,2023-03-03,172.5,1189,725,1914
487,TSLA  ,2023-02-09,2023-03-03,175.0,1226,1545,2771
488,TSLA  ,2023-02-09,2023-03-03,177.5,440,320,760
489,TSLA  ,2023-02-09,2023-03-03,180.0,1964,2277,4241
490,TSLA  ,2023-02-09,2023-03-03,182.5,307,636,943
491,TSLA  ,2023-02-09,2023-03-03,185.0,1788,951,2739
492,TSLA  ,2023-02-09,2023-03-03,187.5,1589,732,2321
493,TSLA  ,2023-02-09,2023-03-03,190.0,2142,1313,3455
494,TSLA  ,2023-02-09,2023-03-03,192.5,565,630,1195
495,TSLA  ,2023-02-09,2023-03-03,195.0,1774,1237,3011
496,TSLA  ,2023-02-09,2023-03-03,197.5,1809,514,2323
497,TSLA  ,2023-02-09,2023-03-03,200.0,5857,1618,7475
498,TSLA  ,2023-02-09,2023-03-03,202.5,1177,1001,2178
499,TSLA  ,2023-02-09,2023-03-03,205.0,2988,423,3411
500,TSLA  ,2023-02-09,2023-03-03,207.5,434,461,895
501,TSLA  ,2023-02-09,2023-03-03,210.0,2523,228,2751
502,TSLA  ,2023-02-09,2023-03-03,212.5,346,9,355
503,TSLA  ,2023-02-09,2023-03-03,215.0,3369,46,3415
504,TSLA  ,2023-02-09,2023-03-03,217.5,431,58,489
505,TSLA  ,2023-02-09,2023-03-03,220.0,2677,95,2772
506,TSLA  ,2023-02-09,2023-03-03,222.5,134,5,139
507,TSLA  ,2023-02-09,2023-03-03,225.0,2217,50,2267
508,TSLA  ,2023-02-09,2023-03-03,230.0,2241,97,2338
509,TSLA  ,2023-02-09,2023-03-03,235.0,1199,1,1200
510,TSLA  ,2023-02-09,2023-03-03,240.0,3034,36,3070
511,TSLA  ,2023-02-09,2023-03-03,245.0,2420,12,2432
512,TSLA  ,2023-02-09,2023-03-03,250.0,3890,15,3905
513,TSLA  ,2023-02-09,2023-03-03,255.0,896,3,899
514,TSLA  ,2023-02-09,2023-03-03,260.0,659,0,659
515,TSLA  ,2023-02-09,2023-03-03,265.0,571,0,571
516,TSLA  ,2023-02-09,2023-03-03,270.0,658,0,658
517,TSLA  ,2023-02-09,2023-03-03,275.0,780,1,781
518,TSLA  ,2023-02-09,2023-03-03,280.0,1015,0,1015
519,TSLA  ,2023-02-09,2023-03-03,285.0,394,0,394
520,TSLA  ,2023-02-09,2023-03-03,290.0,1095,1,1096
521,TSLA  ,2023-02-09,2023-03-03,295.0,149,0,149
522,TSLA  ,2023-02-09,2023-03-03,300.0,4600,4,4604
523,TSLA  ,2023-02-09,2023-03-03,310.0,263,0,263
524,TSLA  ,2023-02-09,2023-03-03,320.0,332,5,337
525,TSLA  ,2023-02-09,2023-03-03,330.0,196,0,196
526,TSLA  ,2023-02-09,2023-03-03,340.0,353,0,353
527,TSLA  ,2023-02-09,2023-03-03,350.0,442,1,443
528,TSLA  ,2023-02-09,2023-03-03,360.0,904,0,904
529,TSLA  ,2023-02-09,2023-03-10,15.0,3,36,39
530,TSLA  ,2023-02-09,2023-03-10,20.0,3,0,3
531,TSLA  ,2023-02-09,2023-03-10,25.0,0,0,0
532,TSLA  ,2023-02-09,2023-03-10,30.0,0,0,0
533,TSLA  ,2023-02-09,2023-03-10,35.0,0,0,0
534,TSLA  ,2023-02-09,2023-03-10,40.0,0,0,0
535,TSLA  ,2023-02-09,2023-03-10,45.0,0,0,0
536,TSLA  ,2023-02-09,2023-03-10,50.0,5,23,28
537,TSLA  ,2023-02-09,2023-03-10,55.0,0,1200,1200
538,TSLA  ,2023-02-09,2023-03-10,60.0,0,12,12
539,TSLA  ,2023-02-09,2023-03-10,65.0,0,10,10
540,TSLA  ,2023-02-09,2023-03-10,70.0,0,25,25
541,TSLA  ,2023-02-09,2023-03-10,75.0,0,419,419
542,TSLA  ,2023-02-09,2023-03-10,80.0,0,65,65
543,TSLA  ,2023-02-09,2023-03-10,85.0,0,45,45
544,TSLA  ,2023-02-09,2023-03-10,90.0,0,41,41
545,TSLA  ,2023-02-09,2023-03-10,95.0,1,173,174
546,TSLA  ,2023-02-09,2023-03-10,100.0,0,503,503
547,TSLA  ,2023-02-09,2023-03-10,105.0,4,1150,1154
548,TSLA  ,2023-02-09,2023-03-10,110.0,14,720,734
549,TSLA  ,2023-02-09,2023-03-10,115.0,4,276,280
550,TSLA  ,2023-02-09,2023-03-10,120.0,4,221,225
551,TSLA  ,2023-02-09,2023-03-10,125.0,14,588,602
552,TSLA  ,2023-02-09,2023-03-10,130.0,79,222,301
553,TSLA  ,2023-02-09,2023-03-10,134.0,8,127,135
554,TSLA  ,2023-02-09,2023-03-10,135.0,33,522,555
555,TSLA  ,2023-02-09,2023-03-10,136.0,14,43,57
556,TSLA  ,2023-02-09,2023-03-10,137.0,7,75,82
557,TSLA  ,2023-02-09,2023-03-10,138.0,9,102,111
558,TSLA  ,2023-02-09,2023-03-10,139.0,3,95,98
559,TSLA  ,2023-02-09,2023-03-10,140.0,60,701,761
560,TSLA  ,2023-02-09,2023-03-10,141.0,139,15,154
561,TSLA  ,2023-02-09,2023-03-10,142.0,10,212,222
562,TSLA  ,2023-02-09,2023-03-10,143.0,4,302,306
563,TSLA  ,2023-02-09,2023-03-10,144.0,6,57,63
564,TSLA  ,2023-02-09,2023-03-10,145.0,100,325,425
565,TSLA  ,2023-02-09,2023-03-10,146.0,19,25,44
566,TSLA  ,2023-02-09,2023-03-10,147.0,79,115,194
567,TSLA  ,2023-02-09,2023-03-10,148.0,97,756,853
568,TSLA  ,2023-02-09,2023-03-10,149.0,3,186,189
569,TSLA  ,2023-02-09,2023-03-10,150.0,243,708,951
570,TSLA  ,2023-02-09,2023-03-10,152.5,104,163,267
571,TSLA  ,2023-02-09,2023-03-10,155.0,278,518,796
572,TSLA  ,2023-02-09,2023-03-10,157.5,56,351,407
573,TSLA  ,2023-02-09,2023-03-10,160.0,217,654,871
574,TSLA  ,2023-02-09,2023-03-10,162.5,93,253,346
575,TSLA  ,2023-02-09,2023-03-10,165.0,295,893,1188
576,TSLA  ,2023-02-09,2023-03-10,167.5,197,286,483
577,TSLA  ,2023-02-09,2023-03-10,170.0,385,1221,1606
578,TSLA  ,2023-02-09,2023-03-10,172.5,177,204,381
579,TSLA  ,2023-02-09,2023-03-10,175.0,428,720,1148
580,TSLA  ,2023-02-09,2023-03-10,177.5,1796,236,2032
581,TSLA  ,2023-02-09,2023-03-10,180.0,604,1205,1809
582,TSLA  ,2023-02-09,2023-03-10,182.5,157,110,267
583,TSLA  ,2023-02-09,2023-03-10,185.0,273,590,863
584,TSLA  ,2023-02-09,2023-03-10,187.5,1205,120,1325
585,TSLA  ,2023-02-09,2023-03-10,190.0,1168,706,1874
586,TSLA  ,2023-02-09,2023-03-10,192.5,481,208,689
587,TSLA  ,2023-02-09,2023-03-10,195.0,508,450,958
588,TSLA  ,2023-02-09,2023-03-10,197.5,375,488,863
589,TSLA  ,2023-02-09,2023-03-10,200.0,2039,569,2608
590,TSLA  ,2023-02-09,2023-03-10,202.5,1104,820,1924
591,TSLA  ,2023-02-09,2023-03-10,205.0,887,288,1175
592,TSLA  ,2023-02-09,2023-03-10,207.5,109,88,197
593,TSLA  ,2023-02-09,2023-03-10,210.0,1057,140,1197
594,TSLA  ,2023-02-09,2023-03-10,212.5,96,37,133
595,TSLA  ,2023-02-09,2023-03-10,215.0,301,82,383
596,TSLA  ,2023-02-09,2023-03-10,217.5,172,1,173
597,TSLA  ,2023-02-09,2023-03-10,220.0,862,17,879
598,TSLA  ,2023-02-09,2023-03-10,222.5,168,1,169
599,TSLA  ,2023-02-09,2023-03-10,225.0,758,114,872
600,TSLA  ,2023-02-09,2023-03-10,230.0,522,7,529
601,TSLA  ,2023-02-09,2023-03-10,235.0,374,4,378
602,TSLA  ,2023-02-09,2023-03-10,240.0,722,11,733
603,TSLA  ,2023-02-09,2023-03-10,245.0,339,43,382
604,TSLA  ,2023-02-09,2023-03-10,250.0,1231,36,1267
605,TSLA  ,2023-02-09,2023-03-10,255.0,252,2,254
606,TSLA  ,2023-02-09,2023-03-10,260.0,308,0,308
607,TSLA  ,2023-02-09,2023-03-10,265.0,1940,0,1940
608,TSLA  ,2023-02-09,2023-03-10,270.0,365,0,365
609,TSLA  ,2023-02-09,2023-03-10,275.0,190,0,190
610,TSLA  ,2023-02-09,2023-03-10,280.0,619,5,624
611,TSLA  ,2023-02-09,2023-03-10,285.0,256,0,256
612,TSLA  ,2023-02-09,2023-03-10,290.0,203,3,206
613,TSLA  ,2023-02-09,2023-03-10,295.0,199,0,199
614,TSLA  ,2023-02-09,2023-03-10,300.0,1027,0,1027
615,TSLA  ,2023-02-09,2023-03-10,310.0,262,6,268
616,TSLA  ,2023-02-09,2023-03-10,320.0,278,0,278
617,TSLA  ,2023-02-09,2023-03-10,330.0,69,0,69
618,TSLA  ,2023-02-09,2023-03-10,340.0,258,0,258
619,TSLA  ,2023-02-09,2023-03-10,350.0,242,0,242
620,TSLA  ,2023-02-09,2023-03-10,360.0,450,0,450
621,TSLA  ,2023-02-09,2023-03-17,1.67,103,24718,24821
622,TSLA  ,2023-02-09,2023-03-17,3.33,29,6941,6970
623,TSLA  ,2023-02-09,2023-03-17,5.0,2,8008,8010
624,TSLA  ,2023-02-09,2023-03-17,6.67,52,4669,4721
625,TSLA  ,2023-02-09,2023-03-17,8.33,15,1379,1394
626,TSLA  ,2023-02-09,2023-03-17,10.0,842,4105,4947
627,TSLA  ,2023-02-09,2023-03-17,11.67,1711,5414,7125
628,TSLA  ,2023-02-09,2023-03-17,13.33,1657,2125,3782
629,TSLA  ,2023-02-09,2023-03-17,15.0,987,5169,6156
630,TSLA  ,2023-02-09,2023-03-17,16.67,875,15329,16204
631,TSLA  ,2023-02-09,2023-03-17,18.33,467,12018,12485
632,TSLA  ,2023-02-09,2023-03-17,33.33,406,33555,33961
633,TSLA  ,2023-02-09,2023-03-17,50.0,499,21273,21772
634,TSLA  ,2023-02-09,2023-03-17,55.0,33,4649,4682
635,TSLA  ,2023-02-09,2023-03-17,60.0,202,6149,6351
636,TSLA  ,2023-02-09,2023-03-17,65.0,25,2736,2761
637,TSLA  ,2023-02-09,2023-03-17,66.67,903,17812,18715
638,TSLA  ,2023-02-09,2023-03-17,70.0,49,7525,7574
639,TSLA  ,2023-02-09,2023-03-17,75.0,54,5365,5419
640,TSLA  ,2023-02-09,2023-03-17,80.0,217,12052,12269
641,TSLA  ,2023-02-09,2023-03-17,83.33,886,5221,6107
642,TSLA  ,2023-02-09,2023-03-17,85.0,88,3490,3578
643,TSLA  ,2023-02-09,2023-03-17,90.0,664,16005,16669
644,TSLA  ,2023-02-09,2023-03-17,95.0,334,4125,4459
645,TSLA  ,2023-02-09,2023-03-17,100.0,1799,30841,32640
646,TSLA  ,2023-02-09,2023-03-17,105.0,1404,4426,5830
647,TSLA  ,2023-02-09,2023-03-17,110.0,3091,13120,16211
648,TSLA  ,2023-02-09,2023-03-17,115.0,3395,8711,12106
649,TSLA  ,2023-02-09,2023-03-17,116.67,1393,11234,12627
650,TSLA  ,2023-02-09,2023-03-17,120.0,12398,19057,31455
651,TSLA  ,2023-02-09,2023-03-17,123.33,2747,6369,9116
652,TSLA  ,2023-02-09,2023-03-17,125.0,3575,9692,13267
653,TSLA  ,2023-02-09,2023-03-17,126.67,1684,4582,6266
654,TSLA  ,2023-02-09,2023-03-17,130.0,7450,11603,19053
655,TSLA  ,2023-02-09,2023-03-17,133.33,3446,9575,13021
656,TSLA  ,2023-02-09,2023-03-17,135.0,27807,34024,61831
657,TSLA  ,2023-02-09,2023-03-17,136.67,2894,3528,6422
658,TSLA  ,2023-02-09,2023-03-17,140.0,7221,29071,36292
659,TSLA  ,2023-02-09,2023-03-17,143.33,2472,4873,7345
660,TSLA  ,2023-02-09,2023-03-17,145.0,2797,8060,10857
661,TSLA  ,2023-02-09,2023-03-17,146.67,1897,4394,6291
662,TSLA  ,2023-02-09,2023-03-17,150.0,13326,21304,34630
663,TSLA  ,2023-02-09,2023-03-17,153.33,1679,2923,4602
664,TSLA  ,2023-02-09,2023-03-17,155.0,3655,6192,9847
665,TSLA  ,2023-02-09,2023-03-17,156.67,2334,3380,5714
666,TSLA  ,2023-02-09,2023-03-17,160.0,7751,22811,30562
667,TSLA  ,2023-02-09,2023-03-17,163.33,3056,4984,8040
668,TSLA  ,2023-02-09,2023-03-17,165.0,7018,5356,12374
669,TSLA  ,2023-02-09,2023-03-17,166.67,6368,11569,17937
670,TSLA  ,2023-02-09,2023-03-17,170.0,11412,20807,32219
671,TSLA  ,2023-02-09,2023-03-17,173.33,3079,11016,14095
672,TSLA  ,2023-02-09,2023-03-17,175.0,4840,4672,9512
673,TSLA  ,2023-02-09,2023-03-17,176.67,5256,2777,8033
674,TSLA  ,2023-02-09,2023-03-17,180.0,21068,18709,39777
675,TSLA  ,2023-02-09,2023-03-17,183.33,3362,7905,11267
676,TSLA  ,2023-02-09,2023-03-17,185.0,3409,3565,6974
677,TSLA  ,2023-02-09,2023-03-17,186.67,2655,4222,6877
678,TSLA  ,2023-02-09,2023-03-17,190.0,12289,11285,23574
679,TSLA  ,2023-02-09,2023-03-17,193.33,2213,2495,4708
680,TSLA  ,2023-02-09,2023-03-17,195.0,4597,3548,8145
681,TSLA  ,2023-02-09,2023-03-17,196.67,2616,1745,4361
682,TSLA  ,2023-02-09,2023-03-17,198.33,3579,2024,5603
683,TSLA  ,2023-02-09,2023-03-17,200.0,43065,34611,77676
684,TSLA  ,2023-02-09,2023-03-17,201.67,1787,1300,3087
685,TSLA  ,2023-02-09,2023-03-17,203.33,3021,1314,4335
686,TSLA  ,2023-02-09,2023-03-17,205.0,3936,2186,6122
687,TSLA  ,2023-02-09,2023-03-17,206.67,1432,1924,3356
688,TSLA  ,2023-02-09,2023-03-17,208.33,2156,634,2790
689,TSLA  ,2023-02-09,2023-03-17,210.0,9466,1268,10734
690,TSLA  ,2023-02-09,2023-03-17,211.67,1721,587,2308
691,TSLA  ,2023-02-09,2023-03-17,213.33,1320,473,1793
692,TSLA  ,2023-02-09,2023-03-17,215.0,10310,569,10879
693,TSLA  ,2023-02-09,2023-03-17,216.67,4625,2780,7405
694,TSLA  ,2023-02-09,2023-03-17,218.33,1013,110,1123
695,TSLA  ,2023-02-09,2023-03-17,220.0,10933,824,11757
696,TSLA  ,2023-02-09,2023-03-17,221.67,1389,148,1537
697,TSLA  ,2023-02-09,2023-03-17,223.33,817,127,944
698,TSLA  ,2023-02-09,2023-03-17,225.0,4887,693,5580
699,TSLA  ,2023-02-09,2023-03-17,226.67,1924,176,2100
700,TSLA  ,2023-02-09,2023-03-17,228.33,5157,43,5200
701,TSLA  ,2023-02-09,2023-03-17,230.0,6320,743,7063
702,TSLA  ,2023-02-09,2023-03-17,231.67,1466,55,1521
703,TSLA  ,2023-02-09,2023-03-17,233.33,7283,418,7701
704,TSLA  ,2023-02-09,2023-03-17,235.0,6701,99,6800
705,TSLA  ,2023-02-09,2023-03-17,236.67,1083,53,1136
706,TSLA  ,2023-02-09,2023-03-17,238.33,985,54,1039
707,TSLA  ,2023-02-09,2023-03-17,240.0,5611,230,5841
708,TSLA  ,2023-02-09,2023-03-17,241.67,975,55,1030
709,TSLA  ,2023-02-09,2023-03-17,243.33,1339,111,1450
710,TSLA  ,2023-02-09,2023-03-17,245.0,1971,29,2000
711,TSLA  ,2023-02-09,2023-03-17,246.67,959,36,995
712,TSLA  ,2023-02-09,2023-03-17,248.33,1085,34,1119
713,TSLA  ,2023-02-09,2023-03-17,250.0,19118,587,19705
714,TSLA  ,2023-02-09,2023-03-17,251.67,1232,78,1310
715,TSLA  ,2023-02-09,2023-03-17,253.33,581,35,616
716,TSLA  ,2023-02-09,2023-03-17,255.0,3143,68,3211
717,TSLA  ,2023-02-09,2023-03-17,256.67,664,24,688
718,TSLA  ,2023-02-09,2023-03-17,258.33,765,25,790
719,TSLA  ,2023-02-09,2023-03-17,260.0,6210,51,6261
720,TSLA  ,2023-02-09,2023-03-17,261.67,1286,13,1299
721,TSLA  ,2023-02-09,2023-03-17,263.33,1070,57,1127
722,TSLA  ,2023-02-09,2023-03-17,265.0,1072,16,1088
723,TSLA  ,2023-02-09,2023-03-17,266.67,9908,374,10282
724,TSLA  ,2023-02-09,2023-03-17,270.0,4043,32,4075
725,TSLA  ,2023-02-09,2023-03-17,273.33,3851,80,3931
726,TSLA  ,2023-02-09,2023-03-17,275.0,365,9,374
727,TSLA  ,2023-02-09,2023-03-17,276.67,1393,38,1431
728,TSLA  ,2023-02-09,2023-03-17,280.0,2575,138,2713
729,TSLA  ,2023-02-09,2023-03-17,283.33,7045,54,7099
730,TSLA  ,2023-02-09,2023-03-17,285.0,162,0,162
731,TSLA  ,2023-02-09,2023-03-17,286.67,1912,17,1929
732,TSLA  ,2023-02-09,2023-03-17,290.0,3185,69,3254
733,TSLA  ,2023-02-09,2023-03-17,293.33,7272,342,7614
734,TSLA  ,2023-02-09,2023-03-17,295.0,1997,11,2008
735,TSLA  ,2023-02-09,2023-03-17,296.67,950,16,966
736,TSLA  ,2023-02-09,2023-03-17,298.33,1138,2,1140
737,TSLA  ,2023-02-09,2023-03-17,300.0,71583,450,72033
738,TSLA  ,2023-02-09,2023-03-17,301.67,1477,17,1494
739,TSLA  ,2023-02-09,2023-03-17,303.33,1308,3,1311
740,TSLA  ,2023-02-09,2023-03-17,305.0,2693,8,2701
741,TSLA  ,2023-02-09,2023-03-17,306.67,1913,3,1916
742,TSLA  ,2023-02-09,2023-03-17,308.33,3819,2,3821
743,TSLA  ,2023-02-09,2023-03-17,310.0,4810,15,4825
744,TSLA  ,2023-02-09,2023-03-17,311.67,2007,5,2012
745,TSLA  ,2023-02-09,2023-03-17,313.33,3761,0,3761
746,TSLA  ,2023-02-09,2023-03-17,316.67,29717,11,29728
747,TSLA  ,2023-02-09,2023-03-17,320.0,14860,202,15062
748,TSLA  ,2023-02-09,2023-03-17,323.33,403,0,403
749,TSLA  ,2023-02-09,2023-03-17,326.67,531,0,531
750,TSLA  ,2023-02-09,2023-03-17,330.0,3317,6,3323
751,TSLA  ,2023-02-09,2023-03-17,333.33,20582,27,20609
752,TSLA  ,2023-02-09,2023-03-17,336.67,665,0,665
753,TSLA  ,2023-02-09,2023-03-17,340.0,5429,0,5429
754,TSLA  ,2023-02-09,2023-03-17,343.33,1906,0,1906
755,TSLA  ,2023-02-09,2023-03-17,346.67,705,0,705
756,TSLA  ,2023-02-09,2023-03-17,350.0,11080,218,11298
757,TSLA  ,2023-02-09,2023-03-17,353.33,661,0,661
758,TSLA  ,2023-02-09,2023-03-17,356.67,501,0,501
759,TSLA  ,2023-02-09,2023-03-17,360.0,2116,0,2116
760,TSLA  ,2023-02-09,2023-03-17,363.33,572,0,572
761,TSLA  ,2023-02-09,2023-03-17,366.67,7823,0,7823
762,TSLA  ,2023-02-09,2023-03-17,370.0,1250,0,1250
763,TSLA  ,2023-02-09,2023-03-17,373.33,689,0,689
764,TSLA  ,2023-02-09,2023-03-17,383.33,12588,0,12588
765,TSLA  ,2023-02-09,2023-03-17,400.0,25885,0,25885
766,TSLA  ,2023-02-09,2023-03-17,416.67,13092,0,13092
767,TSLA  ,2023-02-09,2023-03-17,433.33,19331,0,19331
768,TSLA  ,2023-02-09,2023-03-17,441.67,2057,0,2057
769,TSLA  ,2023-02-09,2023-03-17,450.0,5507,0,5507
770,TSLA  ,2023-02-09,2023-03-17,458.33,2438,0,2438
771,TSLA  ,2023-02-09,2023-03-17,466.67,3795,9,3804
772,TSLA  ,2023-02-09,2023-03-17,475.0,3789,0,3789
773,TSLA  ,2023-02-09,2023-03-17,483.33,1962,0,1962
774,TSLA  ,2023-02-09,2023-03-17,491.67,2535,0,2535
775,TSLA  ,2023-02-09,2023-03-17,500.0,12499,9,12508
776,TSLA  ,2023-02-09,2023-03-17,508.33,1694,0,1694
777,TSLA  ,2023-02-09,2023-03-17,516.67,1072,0,1072
778,TSLA  ,2023-02-09,2023-03-17,525.0,4737,0,4737
779,TSLA  ,2023-02-09,2023-03-17,533.33,4776,0,4776
780,TSLA  ,2023-02-09,2023-03-17,541.67,1031,0,1031
781,TSLA  ,2023-02-09,2023-03-17,550.0,5028,0,5028
782,TSLA  ,2023-02-09,2023-03-17,558.33,3779,0,3779
783,TSLA  ,2023-02-09,2023-03-17,566.67,7758,0,7758
784,TSLA  ,2023-02-09,2023-03-17,575.0,11836,0,11836
785,TSLA  ,2023-02-09,2023-03-17,583.33,2637,0,2637
786,TSLA  ,2023-02-09,2023-03-17,591.67,1282,0,1282
787,TSLA  ,2023-02-09,2023-03-17,600.0,5090,0,5090
788,TSLA  ,2023-02-09,2023-03-17,608.33,530,0,530
789,TSLA  ,2023-02-09,2023-03-17,616.67,3980,0,3980
790,TSLA  ,2023-02-09,2023-03-17,625.0,945,0,945
791,TSLA  ,2023-02-09,2023-03-17,633.33,2371,0,2371
792,TSLA  ,2023-02-09,2023-03-17,641.67,1450,0,1450
793,TSLA  ,2023-02-09,2023-03-17,650.0,8254,0,8254
794,TSLA  ,2023-02-09,2023-03-17,666.67,70187,0,70187
795,TSLA  ,2023-02-09,2023-03-17,675.0,21530,0,21530
796,TSLA  ,2023-02-09,2023-03-17,683.33,3804,0,3804
797,TSLA  ,2023-02-09,2023-03-17,691.67,1174,0,1174
798,TSLA  ,2023-02-09,2023-03-17,700.0,4576,0,4576
799,TSLA  ,2023-02-09,2023-03-17,708.33,587,0,587
800,TSLA  ,2023-02-09,2023-03-17,716.67,684,0,684
801,TSLA  ,2023-02-09,2023-03-17,725.0,797,0,797
802,TSLA  ,2023-02-09,2023-03-17,733.33,1729,0,1729
803,TSLA  ,2023-02-09,2023-03-17,741.67,754,0,754
804,TSLA  ,2023-02-09,2023-03-17,750.0,703,0,703
805,TSLA  ,2023-02-09,2023-03-17,758.33,1235,0,1235
806,TSLA  ,2023-02-09,2023-03-17,766.67,1260,0,1260
807,TSLA  ,2023-02-09,2023-03-17,775.0,827,0,827
808,TSLA  ,2023-02-09,2023-03-17,783.33,1306,0,1306
809,TSLA  ,2023-02-09,2023-03-17,791.67,1447,0,1447
810,TSLA  ,2023-02-09,2023-03-17,800.0,5218,0,5218
811,TSLA  ,2023-02-09,2023-03-17,808.33,1842,0,1842
812,TSLA  ,2023-02-09,2023-03-17,816.67,2560,0,2560
813,TSLA  ,2023-02-09,2023-03-17,825.0,59709,0,59709
814,TSLA  ,2023-02-09,2023-03-24,20.0,6,122,128
815,TSLA  ,2023-02-09,2023-03-24,30.0,0,0,0
816,TSLA  ,2023-02-09,2023-03-24,40.0,0,0,0
817,TSLA  ,2023-02-09,2023-03-24,50.0,0,1543,1543
818,TSLA  ,2023-02-09,2023-03-24,55.0,3,0,3
819,TSLA  ,2023-02-09,2023-03-24,60.0,0,9,9
820,TSLA  ,2023-02-09,2023-03-24,65.0,0,0,0
821,TSLA  ,2023-02-09,2023-03-24,70.0,0,6,6
822,TSLA  ,2023-02-09,2023-03-24,75.0,0,0,0
823,TSLA  ,2023-02-09,2023-03-24,80.0,0,27,27
824,TSLA  ,2023-02-09,2023-03-24,85.0,1,20,21
825,TSLA  ,2023-02-09,2023-03-24,90.0,0,23,23
826,TSLA  ,2023-02-09,2023-03-24,95.0,0,19,19
827,TSLA  ,2023-02-09,2023-03-24,100.0,11,92,103
828,TSLA  ,2023-02-09,2023-03-24,105.0,10,55,65
829,TSLA  ,2023-02-09,2023-03-24,110.0,6,40,46
830,TSLA  ,2023-02-09,2023-03-24,115.0,1,19,20
831,TSLA  ,2023-02-09,2023-03-24,120.0,1,187,188
832,TSLA  ,2023-02-09,2023-03-24,125.0,4,109,113
833,TSLA  ,2023-02-09,2023-03-24,130.0,129,275,404
834,TSLA  ,2023-02-09,2023-03-24,135.0,16,93,109
835,TSLA  ,2023-02-09,2023-03-24,140.0,24,322,346
836,TSLA  ,2023-02-09,2023-03-24,145.0,55,126,181
837,TSLA  ,2023-02-09,2023-03-24,146.0,7,12,19
838,TSLA  ,2023-02-09,2023-03-24,147.0,64,13,77
839,TSLA  ,2023-02-09,2023-03-24,148.0,57,68,125
840,TSLA  ,2023-02-09,2023-03-24,149.0,60,66,126
841,TSLA  ,2023-02-09,2023-03-24,150.0,44,545,589
842,TSLA  ,2023-02-09,2023-03-24,152.5,1,26,27
843,TSLA  ,2023-02-09,2023-03-24,155.0,433,315,748
844,TSLA  ,2023-02-09,2023-03-24,157.5,4,425,429
845,TSLA  ,2023-02-09,2023-03-24,160.0,106,290,396
846,TSLA  ,2023-02-09,2023-03-24,162.5,9,55,64
847,TSLA  ,2023-02-09,2023-03-24,165.0,28,423,451
848,TSLA  ,2023-02-09,2023-03-24,167.5,16,433,449
849,TSLA  ,2023-02-09,2023-03-24,170.0,41,444,485
850,TSLA  ,2023-02-09,2023-03-24,172.5,27,122,149
851,TSLA  ,2023-02-09,2023-03-24,175.0,106,277,383
852,TSLA  ,2023-02-09,2023-03-24,177.5,26,444,470
853,TSLA  ,2023-02-09,2023-03-24,180.0,211,547,758
854,TSLA  ,2023-02-09,2023-03-24,182.5,3,23,26
855,TSLA  ,2023-02-09,2023-03-24,185.0,74,158,232
856,TSLA  ,2023-02-09,2023-03-24,187.5,107,28,135
857,TSLA  ,2023-02-09,2023-03-24,190.0,322,569,891
858,TSLA  ,2023-02-09,2023-03-24,192.5,54,70,124
859,TSLA  ,2023-02-09,2023-03-24,195.0,285,114,399
860,TSLA  ,2023-02-09,2023-03-24,197.5,148,50,198
861,TSLA  ,2023-02-09,2023-03-24,200.0,1562,1579,3141
862,TSLA  ,2023-02-09,2023-03-24,202.5,38,65,103
863,TSLA  ,2023-02-09,2023-03-24,205.0,1057,35,1092
864,TSLA  ,2023-02-09,2023-03-24,207.5,52,64,116
865,TSLA  ,2023-02-09,2023-03-24,210.0,2263,19,2282
866,TSLA  ,2023-02-09,2023-03-24,212.5,51,0,51
867,TSLA  ,2023-02-09,2023-03-24,215.0,248,6,254
868,TSLA  ,2023-02-09,2023-03-24,217.5,12,25,37
869,TSLA  ,2023-02-09,2023-03-24,220.0,371,309,680
870,TSLA  ,2023-02-09,2023-03-24,222.5,71,5,76
871,TSLA  ,2023-02-09,2023-03-24,225.0,174,81,255
872,TSLA  ,2023-02-09,2023-03-24,230.0,334,122,456
873,TSLA  ,2023-02-09,2023-03-24,235.0,237,59,296
874,TSLA  ,2023-02-09,2023-03-24,240.0,130,130,260
875,TSLA  ,2023-02-09,2023-03-24,245.0,505,18,523
876,TSLA  ,2023-02-09,2023-03-24,250.0,604,13,617
877,TSLA  ,2023-02-09,2023-03-24,255.0,87,13,100
878,TSLA  ,2023-02-09,2023-03-24,260.0,95,0,95
879,TSLA  ,2023-02-09,2023-03-24,265.0,58,1,59
880,TSLA  ,2023-02-09,2023-03-24,270.0,48,0,48
881,TSLA  ,2023-02-09,2023-03-24,275.0,45,0,45
882,TSLA  ,2023-02-09,2023-03-24,280.0,250,0,250
883,TSLA  ,2023-02-09,2023-03-24,285.0,39,0,39
884,TSLA  ,2023-02-09,2023-03-24,290.0,100,0,100
885,TSLA  ,2023-02-09,2023-03-24,300.0,254,0,254
886,TSLA  ,2023-02-09,2023-03-24,310.0,74,0,74
887,TSLA  ,2023-02-09,2023-03-24,320.0,133,0,133
888,TSLA  ,2023-02-09,2023-03-24,330.0,4,0,4
889,TSLA  ,2023-02-09,2023-03-24,340.0,301,0,301
890,TSLA  ,2023-02-09,2023-03-24,350.0,90,0,90
891,TSLA  ,2023-02-09,2023-03-24,360.0,302,0,302
892,TSLA  ,2023-02-09,2023-04-21,5.0,14,101,115
893,TSLA  ,2023-02-09,2023-04-21,10.0,0,8,8
894,TSLA  ,2023-02-09,2023-04-21,15.0,0,41,41
895,TSLA  ,2023-02-09,2023-04-21,20.0,4,320,324
896,TSLA  ,2023-02-09,2023-04-21,25.0,5,2484,2489
897,TSLA  ,2023-02-09,2023-04-21,30.0,0,1781,1781
898,TSLA  ,2023-02-09,2023-04-21,35.0,5,436,441
899,TSLA  ,2023-02-09,2023-04-21,40.0,6,505,511
900,TSLA  ,2023-02-09,2023-04-21,45.0,2,780,782
901,TSLA  ,2023-02-09,2023-04-21,50.0,126,5159,5285
902,TSLA  ,2023-02-09,2023-04-21,55.0,17,2825,2842
903,TSLA  ,2023-02-09,2023-04-21,60.0,19,1909,1928
904,TSLA  ,2023-02-09,2023-04-21,65.0,65,5056,5121
905,TSLA  ,2023-02-09,2023-04-21,70.0,105,4361,4466
906,TSLA  ,2023-02-09,2023-04-21,75.0,124,13176,13300
907,TSLA  ,2023-02-09,2023-04-21,80.0,25226,4518,29744
908,TSLA  ,2023-02-09,2023-04-21,85.0,90,3347,3437
909,TSLA  ,2023-02-09,2023-04-21,90.0,266,2276,2542
910,TSLA  ,2023-02-09,2023-04-21,95.0,151,6171,6322
911,TSLA  ,2023-02-09,2023-04-21,100.0,1631,24330,25961
912,TSLA  ,2023-02-09,2023-04-21,105.0,372,2529,2901
913,TSLA  ,2023-02-09,2023-04-21,108.33,901,4883,5784
914,TSLA  ,2023-02-09,2023-04-21,110.0,1091,5143,6234
915,TSLA  ,2023-02-09,2023-04-21,115.0,1443,3399,4842
916,TSLA  ,2023-02-09,2023-04-21,116.67,2544,9686,12230
917,TSLA  ,2023-02-09,2023-04-21,120.0,7448,6767,14215
918,TSLA  ,2023-02-09,2023-04-21,125.0,11119,12585,23704
919,TSLA  ,2023-02-09,2023-04-21,130.0,1843,6346,8189
920,TSLA  ,2023-02-09,2023-04-21,133.33,4579,3770,8349
921,TSLA  ,2023-02-09,2023-04-21,135.0,1866,2567,4433
922,TSLA  ,2023-02-09,2023-04-21,140.0,2836,8619,11455
923,TSLA  ,2023-02-09,2023-04-21,141.67,6332,3736,10068
924,TSLA  ,2023-02-09,2023-04-21,145.0,1913,2065,3978
925,TSLA  ,2023-02-09,2023-04-21,150.0,6994,17008,24002
926,TSLA  ,2023-02-09,2023-04-21,155.0,1321,1015,2336
927,TSLA  ,2023-02-09,2023-04-21,158.33,2967,3762,6729
928,TSLA  ,2023-02-09,2023-04-21,160.0,2421,3990,6411
929,TSLA  ,2023-02-09,2023-04-21,165.0,1522,1175,2697
930,TSLA  ,2023-02-09,2023-04-21,166.67,2696,5361,8057
931,TSLA  ,2023-02-09,2023-04-21,170.0,2227,2698,4925
932,TSLA  ,2023-02-09,2023-04-21,175.0,10720,7184,17904
933,TSLA  ,2023-02-09,2023-04-21,180.0,2907,4158,7065
934,TSLA  ,2023-02-09,2023-04-21,183.33,2657,4124,6781
935,TSLA  ,2023-02-09,2023-04-21,185.0,1758,3399,5157
936,TSLA  ,2023-02-09,2023-04-21,190.0,1837,2969,4806
937,TSLA  ,2023-02-09,2023-04-21,191.67,3196,4625,7821
938,TSLA  ,2023-02-09,2023-04-21,195.0,2898,1820,4718
939,TSLA  ,2023-02-09,2023-04-21,200.0,11974,8300,20274
940,TSLA  ,2023-02-09,2023-04-21,205.0,4246,1494,5740
941,TSLA  ,2023-02-09,2023-04-21,208.33,6476,2321,8797
942,TSLA  ,2023-02-09,2023-04-21,210.0,3734,1385,5119
943,TSLA  ,2023-02-09,2023-04-21,215.0,1574,658,2232
944,TSLA  ,2023-02-09,2023-04-21,216.67,1875,2262,4137
945,TSLA  ,2023-02-09,2023-04-21,220.0,6550,646,7196
946,TSLA  ,2023-02-09,2023-04-21,225.0,8226,1971,10197
947,TSLA  ,2023-02-09,2023-04-21,230.0,1318,227,1545
948,TSLA  ,2023-02-09,2023-04-21,233.33,1578,633,2211
949,TSLA  ,2023-02-09,2023-04-21,235.0,954,252,1206
950,TSLA  ,2023-02-09,2023-04-21,240.0,12461,514,12975
951,TSLA  ,2023-02-09,2023-04-21,241.67,853,71,924
952,TSLA  ,2023-02-09,2023-04-21,243.33,1008,60,1068
953,TSLA  ,2023-02-09,2023-04-21,245.0,1484,142,1626
954,TSLA  ,2023-02-09,2023-04-21,246.67,1143,28,1171
955,TSLA  ,2023-02-09,2023-04-21,248.33,722,330,1052
956,TSLA  ,2023-02-09,2023-04-21,250.0,8064,702,8766
957,TSLA  ,2023-02-09,2023-04-21,251.67,1588,25,1613
958,TSLA  ,2023-02-09,2023-04-21,253.33,431,13,444
959,TSLA  ,2023-02-09,2023-04-21,255.0,1264,22,1286
960,TSLA  ,2023-02-09,2023-04-21,258.33,700,894,1594
961,TSLA  ,2023-02-09,2023-04-21,260.0,1677,6,1683
962,TSLA  ,2023-02-09,2023-04-21,265.0,228,0,228
963,TSLA  ,2023-02-09,2023-04-21,266.67,1499,195,1694
964,TSLA  ,2023-02-09,2023-04-21,270.0,118,2,120
965,TSLA  ,2023-02-09,2023-04-21,275.0,2025,90,2115
966,TSLA  ,2023-02-09,2023-04-21,280.0,1330,206,1536
967,TSLA  ,2023-02-09,2023-04-21,283.33,1317,213,1530
968,TSLA  ,2023-02-09,2023-04-21,285.0,51,0,51
969,TSLA  ,2023-02-09,2023-04-21,290.0,46,0,46
970,TSLA  ,2023-02-09,2023-04-21,291.67,3045,30,3075
971,TSLA  ,2023-02-09,2023-04-21,300.0,8065,37,8102
972,TSLA  ,2023-02-09,2023-04-21,308.33,4545,25,4570
973,TSLA  ,2023-02-09,2023-04-21,316.67,21919,1,21920
974,TSLA  ,2023-02-09,2023-04-21,325.0,2370,0,2370
975,TSLA  ,2023-02-09,2023-04-21,333.33,4420,0,4420
976,TSLA  ,2023-02-09,2023-04-21,341.67,743,8,751
977,TSLA  ,2023-02-09,2023-04-21,350.0,3046,0,3046
978,TSLA  ,2023-02-09,2023-04-21,358.33,904,0,904
979,TSLA  ,2023-02-09,2023-04-21,366.67,1060,4,1064
980,TSLA  ,2023-02-09,2023-04-21,375.0,1056,10,1066
981,TSLA  ,2023-02-09,2023-04-21,383.33,638,3,641
982,TSLA  ,2023-02-09,2023-04-21,391.67,370,0,370
983,TSLA  ,2023-02-09,2023-04-21,400.0,2611,0,2611
984,TSLA  ,2023-02-09,2023-04-21,408.33,493,0,493
985,TSLA  ,2023-02-09,2023-04-21,416.67,1143,0,1143
986,TSLA  ,2023-02-09,2023-04-21,425.0,4780,0,4780
987,TSLA  ,2023-02-09,2023-04-21,433.33,2782,0,2782
988,TSLA  ,2023-02-09,2023-04-21,441.67,708,0,708
989,TSLA  ,2023-02-09,2023-04-21,450.0,940,0,940
990,TSLA  ,2023-02-09,2023-04-21,458.33,3204,0,3204
991,TSLA  ,2023-02-09,2023-04-21,466.67,431,0,431
992,TSLA  ,2023-02-09,2023-04-21,475.0,1641,0,1641
993,TSLA  ,2023-02-09,2023-04-21,483.33,844,0,844
994,TSLA  ,2023-02-09,2023-04-21,491.67,175,0,175
995,TSLA  ,2023-02-09,2023-04-21,500.0,1789,0,1789
996,TSLA  ,2023-02-09,2023-04-21,508.33,857,0,857
997,TSLA  ,2023-02-09,2023-04-21,516.67,504,0,504
998,TSLA  ,2023-02-09,2023-04-21,525.0,423,0,423
999,TSLA  ,2023-02-09,2023-04-21,533.33,482,0,482
1000,TSLA  ,2023-02-09,2023-04-21,541.67,468,0,468
1001,TSLA  ,2023-02-09,2023-04-21,550.0,11886,0,11886
1002,TSLA  ,2023-02-09,2023-04-21,558.33,175,0,175
1003,TSLA  ,2023-02-09,2023-04-21,566.67,690,0,690
1004,TSLA  ,2023-02-09,2023-04-21,575.0,2187,0,2187
1005,TSLA  ,2023-02-09,2023-04-21,583.33,868,0,868
1006,TSLA  ,2023-02-09,2023-04-21,600.0,17967,0,17967
1007,TSLA  ,2023-02-09,2023-05-19,50.0,62,2793,2855
1008,TSLA  ,2023-02-09,2023-05-19,55.0,51,597,648
1009,TSLA  ,2023-02-09,2023-05-19,60.0,156,949,1105
1010,TSLA  ,2023-02-09,2023-05-19,65.0,65,477,542
1011,TSLA  ,2023-02-09,2023-05-19,70.0,178,1355,1533
1012,TSLA  ,2023-02-09,2023-05-19,75.0,135,1677,1812
1013,TSLA  ,2023-02-09,2023-05-19,80.0,85,1670,1755
1014,TSLA  ,2023-02-09,2023-05-19,85.0,63,1712,1775
1015,TSLA  ,2023-02-09,2023-05-19,90.0,243,2755,2998
1016,TSLA  ,2023-02-09,2023-05-19,95.0,132,1632,1764
1017,TSLA  ,2023-02-09,2023-05-19,100.0,1068,24427,25495
1018,TSLA  ,2023-02-09,2023-05-19,105.0,273,6123,6396
1019,TSLA  ,2023-02-09,2023-05-19,110.0,15972,7304,23276
1020,TSLA  ,2023-02-09,2023-05-19,115.0,1353,1915,3268
1021,TSLA  ,2023-02-09,2023-05-19,120.0,2132,7834,9966
1022,TSLA  ,2023-02-09,2023-05-19,125.0,3626,2507,6133
1023,TSLA  ,2023-02-09,2023-05-19,130.0,2699,4926,7625
1024,TSLA  ,2023-02-09,2023-05-19,135.0,1989,2129,4118
1025,TSLA  ,2023-02-09,2023-05-19,140.0,1982,11247,13229
1026,TSLA  ,2023-02-09,2023-05-19,145.0,2324,2485,4809
1027,TSLA  ,2023-02-09,2023-05-19,150.0,4083,4073,8156
1028,TSLA  ,2023-02-09,2023-05-19,155.0,1530,1464,2994
1029,TSLA  ,2023-02-09,2023-05-19,160.0,3128,4292,7420
1030,TSLA  ,2023-02-09,2023-05-19,165.0,1377,1324,2701
1031,TSLA  ,2023-02-09,2023-05-19,170.0,2793,4432,7225
1032,TSLA  ,2023-02-09,2023-05-19,175.0,2043,1643,3686
1033,TSLA  ,2023-02-09,2023-05-19,180.0,8211,6143,14354
1034,TSLA  ,2023-02-09,2023-05-19,185.0,1731,1361,3092
1035,TSLA  ,2023-02-09,2023-05-19,190.0,2621,3283,5904
1036,TSLA  ,2023-02-09,2023-05-19,195.0,2472,2030,4502
1037,TSLA  ,2023-02-09,2023-05-19,200.0,7326,2300,9626
1038,TSLA  ,2023-02-09,2023-05-19,205.0,4056,1252,5308
1039,TSLA  ,2023-02-09,2023-05-19,210.0,9345,554,9899
1040,TSLA  ,2023-02-09,2023-05-19,215.0,2670,960,3630
1041,TSLA  ,2023-02-09,2023-05-19,220.0,2329,860,3189
1042,TSLA  ,2023-02-09,2023-05-19,225.0,1530,130,1660
1043,TSLA  ,2023-02-09,2023-05-19,230.0,1693,43,1736
1044,TSLA  ,2023-02-09,2023-05-19,235.0,1044,112,1156
1045,TSLA  ,2023-02-09,2023-05-19,240.0,1989,85,2074
1046,TSLA  ,2023-02-09,2023-05-19,245.0,323,133,456
1047,TSLA  ,2023-02-09,2023-05-19,250.0,2341,38,2379
1048,TSLA  ,2023-02-09,2023-05-19,260.0,551,107,658
1049,TSLA  ,2023-02-09,2023-05-19,270.0,1577,129,1706
1050,TSLA  ,2023-02-09,2023-05-19,280.0,379,22,401
1051,TSLA  ,2023-02-09,2023-05-19,290.0,351,367,718
1052,TSLA  ,2023-02-09,2023-05-19,300.0,1129,539,1668
1053,TSLA  ,2023-02-09,2023-05-19,310.0,301,5255,5556
1054,TSLA  ,2023-02-09,2023-05-19,320.0,547,1169,1716
1055,TSLA  ,2023-02-09,2023-05-19,330.0,284,26,310
1056,TSLA  ,2023-02-09,2023-05-19,340.0,185,1,186
1057,TSLA  ,2023-02-09,2023-05-19,350.0,236,0,236
1058,TSLA  ,2023-02-09,2023-05-19,360.0,707,1,708
1059,TSLA  ,2023-02-09,2023-05-19,370.0,84,0,84
1060,TSLA  ,2023-02-09,2023-05-19,380.0,17,0,17
1061,TSLA  ,2023-02-09,2023-05-19,390.0,812,1,813
1062,TSLA  ,2023-02-09,2023-06-16,1.67,110,41907,42017
1063,TSLA  ,2023-02-09,2023-06-16,3.33,402,5010,5412
1064,TSLA  ,2023-02-09,2023-06-16,5.0,108,1684,1792
1065,TSLA  ,2023-02-09,2023-06-16,6.67,75,1309,1384
1066,TSLA  ,2023-02-09,2023-06-16,8.33,425,2371,2796
1067,TSLA  ,2023-02-09,2023-06-16,10.0,3234,3724,6958
1068,TSLA  ,2023-02-09,2023-06-16,11.67,155,8573,8728
1069,TSLA  ,2023-02-09,2023-06-16,13.33,1234,5641,6875
1070,TSLA  ,2023-02-09,2023-06-16,15.0,168,4101,4269
1071,TSLA  ,2023-02-09,2023-06-16,16.67,489,9827,10316
1072,TSLA  ,2023-02-09,2023-06-16,18.33,88,4924,5012
1073,TSLA  ,2023-02-09,2023-06-16,33.33,862,16573,17435
1074,TSLA  ,2023-02-09,2023-06-16,50.0,1108,17406,18514
1075,TSLA  ,2023-02-09,2023-06-16,55.0,31,7345,7376
1076,TSLA  ,2023-02-09,2023-06-16,60.0,15,2292,2307
1077,TSLA  ,2023-02-09,2023-06-16,65.0,4,617,621
1078,TSLA  ,2023-02-09,2023-06-16,66.67,1036,14247,15283
1079,TSLA  ,2023-02-09,2023-06-16,70.0,51,4041,4092
1080,TSLA  ,2023-02-09,2023-06-16,75.0,86,6567,6653
1081,TSLA  ,2023-02-09,2023-06-16,80.0,184,3699,3883
1082,TSLA  ,2023-02-09,2023-06-16,83.33,716,5094,5810
1083,TSLA  ,2023-02-09,2023-06-16,85.0,86,4255,4341
1084,TSLA  ,2023-02-09,2023-06-16,90.0,202,3244,3446
1085,TSLA  ,2023-02-09,2023-06-16,95.0,173,1610,1783
1086,TSLA  ,2023-02-09,2023-06-16,100.0,3477,27397,30874
1087,TSLA  ,2023-02-09,2023-06-16,105.0,367,5333,5700
1088,TSLA  ,2023-02-09,2023-06-16,110.0,1167,5583,6750
1089,TSLA  ,2023-02-09,2023-06-16,115.0,588,2696,3284
1090,TSLA  ,2023-02-09,2023-06-16,116.67,1786,5233,7019
1091,TSLA  ,2023-02-09,2023-06-16,120.0,3444,8861,12305
1092,TSLA  ,2023-02-09,2023-06-16,123.33,448,1128,1576
1093,TSLA  ,2023-02-09,2023-06-16,125.0,4106,7049,11155
1094,TSLA  ,2023-02-09,2023-06-16,126.67,867,1307,2174
1095,TSLA  ,2023-02-09,2023-06-16,130.0,3703,8530,12233
1096,TSLA  ,2023-02-09,2023-06-16,133.33,2536,9211,11747
1097,TSLA  ,2023-02-09,2023-06-16,135.0,2773,2715,5488
1098,TSLA  ,2023-02-09,2023-06-16,136.67,1079,2573,3652
1099,TSLA  ,2023-02-09,2023-06-16,140.0,7824,6048,13872
1100,TSLA  ,2023-02-09,2023-06-16,143.33,1257,3384,4641
1101,TSLA  ,2023-02-09,2023-06-16,145.0,2178,3412,5590
1102,TSLA  ,2023-02-09,2023-06-16,146.67,1593,1911,3504
1103,TSLA  ,2023-02-09,2023-06-16,150.0,13045,12147,25192
1104,TSLA  ,2023-02-09,2023-06-16,153.33,2469,3369,5838
1105,TSLA  ,2023-02-09,2023-06-16,155.0,1233,3104,4337
1106,TSLA  ,2023-02-09,2023-06-16,156.67,1685,788,2473
1107,TSLA  ,2023-02-09,2023-06-16,160.0,6660,6895,13555
1108,TSLA  ,2023-02-09,2023-06-16,163.33,975,1200,2175
1109,TSLA  ,2023-02-09,2023-06-16,165.0,1893,2804,4697
1110,TSLA  ,2023-02-09,2023-06-16,166.67,3724,13168,16892
1111,TSLA  ,2023-02-09,2023-06-16,170.0,2862,4108,6970
1112,TSLA  ,2023-02-09,2023-06-16,173.33,1458,6216,7674
1113,TSLA  ,2023-02-09,2023-06-16,175.0,3093,4536,7629
1114,TSLA  ,2023-02-09,2023-06-16,180.0,9436,6466,15902
1115,TSLA  ,2023-02-09,2023-06-16,183.33,10210,10184,20394
1116,TSLA  ,2023-02-09,2023-06-16,185.0,8220,6043,14263
1117,TSLA  ,2023-02-09,2023-06-16,186.67,965,1845,2810
1118,TSLA  ,2023-02-09,2023-06-16,190.0,5903,4671,10574
1119,TSLA  ,2023-02-09,2023-06-16,193.33,1957,7814,9771
1120,TSLA  ,2023-02-09,2023-06-16,195.0,2618,2549,5167
1121,TSLA  ,2023-02-09,2023-06-16,200.0,25022,24011,49033
1122,TSLA  ,2023-02-09,2023-06-16,205.0,2768,1049,3817
1123,TSLA  ,2023-02-09,2023-06-16,206.67,2150,3371,5521
1124,TSLA  ,2023-02-09,2023-06-16,210.0,4407,988,5395
1125,TSLA  ,2023-02-09,2023-06-16,213.33,1682,2634,4316
1126,TSLA  ,2023-02-09,2023-06-16,215.0,3260,1128,4388
1127,TSLA  ,2023-02-09,2023-06-16,216.67,6875,6140,13015
1128,TSLA  ,2023-02-09,2023-06-16,220.0,7499,6579,14078
1129,TSLA  ,2023-02-09,2023-06-16,225.0,1893,1193,3086
1130,TSLA  ,2023-02-09,2023-06-16,226.67,1346,1920,3266
1131,TSLA  ,2023-02-09,2023-06-16,230.0,6714,2917,9631
1132,TSLA  ,2023-02-09,2023-06-16,233.33,10872,7299,18171
1133,TSLA  ,2023-02-09,2023-06-16,235.0,2506,663,3169
1134,TSLA  ,2023-02-09,2023-06-16,240.0,6739,3444,10183
1135,TSLA  ,2023-02-09,2023-06-16,243.33,1319,1697,3016
1136,TSLA  ,2023-02-09,2023-06-16,245.0,1642,63,1705
1137,TSLA  ,2023-02-09,2023-06-16,246.67,3021,89,3110
1138,TSLA  ,2023-02-09,2023-06-16,250.0,15658,3399,19057
1139,TSLA  ,2023-02-09,2023-06-16,253.33,1229,195,1424
1140,TSLA  ,2023-02-09,2023-06-16,255.0,1014,73,1087
1141,TSLA  ,2023-02-09,2023-06-16,260.0,4963,80,5043
1142,TSLA  ,2023-02-09,2023-06-16,265.0,1947,52,1999
1143,TSLA  ,2023-02-09,2023-06-16,266.67,7287,408,7695
1144,TSLA  ,2023-02-09,2023-06-16,270.0,1357,9,1366
1145,TSLA  ,2023-02-09,2023-06-16,273.33,971,1051,2022
1146,TSLA  ,2023-02-09,2023-06-16,275.0,2266,5,2271
1147,TSLA  ,2023-02-09,2023-06-16,280.0,3741,60,3801
1148,TSLA  ,2023-02-09,2023-06-16,283.33,4554,51,4605
1149,TSLA  ,2023-02-09,2023-06-16,285.0,968,2,970
1150,TSLA  ,2023-02-09,2023-06-16,286.67,766,30,796
1151,TSLA  ,2023-02-09,2023-06-16,290.0,699,823,1522
1152,TSLA  ,2023-02-09,2023-06-16,293.33,1691,62,1753
1153,TSLA  ,2023-02-09,2023-06-16,295.0,319,258,577
1154,TSLA  ,2023-02-09,2023-06-16,300.0,17508,90,17598
1155,TSLA  ,2023-02-09,2023-06-16,305.0,3114,5,3119
1156,TSLA  ,2023-02-09,2023-06-16,306.67,1458,31,1489
1157,TSLA  ,2023-02-09,2023-06-16,310.0,1699,46,1745
1158,TSLA  ,2023-02-09,2023-06-16,313.33,508,36,544
1159,TSLA  ,2023-02-09,2023-06-16,315.0,270,82,352
1160,TSLA  ,2023-02-09,2023-06-16,316.67,6691,241,6932
1161,TSLA  ,2023-02-09,2023-06-16,320.0,2362,3,2365
1162,TSLA  ,2023-02-09,2023-06-16,326.67,9683,6,9689
1163,TSLA  ,2023-02-09,2023-06-16,330.0,1089,48,1137
1164,TSLA  ,2023-02-09,2023-06-16,333.33,33450,231,33681
1165,TSLA  ,2023-02-09,2023-06-16,340.0,1567,3,1570
1166,TSLA  ,2023-02-09,2023-06-16,346.67,1064,0,1064
1167,TSLA  ,2023-02-09,2023-06-16,350.0,8465,332,8797
1168,TSLA  ,2023-02-09,2023-06-16,353.33,838,0,838
1169,TSLA  ,2023-02-09,2023-06-16,360.0,1928,1,1929
1170,TSLA  ,2023-02-09,2023-06-16,366.67,10818,450,11268
1171,TSLA  ,2023-02-09,2023-06-16,370.0,785,0,785
1172,TSLA  ,2023-02-09,2023-06-16,383.33,11702,0,11702
1173,TSLA  ,2023-02-09,2023-06-16,400.0,18842,904,19746
1174,TSLA  ,2023-02-09,2023-06-16,416.67,3608,0,3608
1175,TSLA  ,2023-02-09,2023-06-16,433.33,9560,0,9560
1176,TSLA  ,2023-02-09,2023-06-16,450.0,8109,0,8109
1177,TSLA  ,2023-02-09,2023-06-16,466.67,20800,0,20800
1178,TSLA  ,2023-02-09,2023-06-16,483.33,8266,0,8266
1179,TSLA  ,2023-02-09,2023-06-16,500.0,23851,0,23851
1180,TSLA  ,2023-02-09,2023-06-16,516.67,2696,0,2696
1181,TSLA  ,2023-02-09,2023-06-16,533.33,4885,0,4885
1182,TSLA  ,2023-02-09,2023-06-16,550.0,6255,0,6255
1183,TSLA  ,2023-02-09,2023-06-16,558.33,1704,0,1704
1184,TSLA  ,2023-02-09,2023-06-16,566.67,1358,0,1358
1185,TSLA  ,2023-02-09,2023-06-16,575.0,701,0,701
1186,TSLA  ,2023-02-09,2023-06-16,583.33,1212,0,1212
1187,TSLA  ,2023-02-09,2023-06-16,591.67,399,0,399
1188,TSLA  ,2023-02-09,2023-06-16,600.0,6438,0,6438
1189,TSLA  ,2023-02-09,2023-06-16,608.33,1140,0,1140
1190,TSLA  ,2023-02-09,2023-06-16,616.67,811,0,811
1191,TSLA  ,2023-02-09,2023-06-16,625.0,2171,0,2171
1192,TSLA  ,2023-02-09,2023-06-16,633.33,5537,0,5537
1193,TSLA  ,2023-02-09,2023-06-16,641.67,436,0,436
1194,TSLA  ,2023-02-09,2023-06-16,650.0,534,0,534
1195,TSLA  ,2023-02-09,2023-06-16,666.67,17973,0,17973
1196,TSLA  ,2023-02-09,2023-06-16,675.0,943,0,943
1197,TSLA  ,2023-02-09,2023-06-16,683.33,604,0,604
1198,TSLA  ,2023-02-09,2023-06-16,691.67,885,0,885
1199,TSLA  ,2023-02-09,2023-06-16,700.0,2749,0,2749
1200,TSLA  ,2023-02-09,2023-06-16,708.33,537,0,537
1201,TSLA  ,2023-02-09,2023-06-16,716.67,714,0,714
1202,TSLA  ,2023-02-09,2023-06-16,725.0,1179,0,1179
1203,TSLA  ,2023-02-09,2023-06-16,733.33,2258,0,2258
1204,TSLA  ,2023-02-09,2023-06-16,741.67,768,0,768
1205,TSLA  ,2023-02-09,2023-06-16,750.0,12383,0,12383
1206,TSLA  ,2023-02-09,2023-06-16,758.33,1292,0,1292
1207,TSLA  ,2023-02-09,2023-06-16,766.67,1267,0,1267
1208,TSLA  ,2023-02-09,2023-06-16,775.0,1089,0,1089
1209,TSLA  ,2023-02-09,2023-06-16,783.33,2174,0,2174
1210,TSLA  ,2023-02-09,2023-06-16,791.67,1825,0,1825
1211,TSLA  ,2023-02-09,2023-06-16,800.0,8854,0,8854
1212,TSLA  ,2023-02-09,2023-06-16,808.33,1313,0,1313
1213,TSLA  ,2023-02-09,2023-06-16,816.67,1829,0,1829
1214,TSLA  ,2023-02-09,2023-06-16,825.0,38984,0,38984
1215,TSLA  ,2023-02-09,2023-07-21,5.0,32,721,753
1216,TSLA  ,2023-02-09,2023-07-21,10.0,5,906,911
1217,TSLA  ,2023-02-09,2023-07-21,15.0,4,379,383
1218,TSLA  ,2023-02-09,2023-07-21,20.0,12,1226,1238
1219,TSLA  ,2023-02-09,2023-07-21,25.0,25,1002,1027
1220,TSLA  ,2023-02-09,2023-07-21,30.0,114,1337,1451
1221,TSLA  ,2023-02-09,2023-07-21,35.0,45,777,822
1222,TSLA  ,2023-02-09,2023-07-21,40.0,21,1137,1158
1223,TSLA  ,2023-02-09,2023-07-21,45.0,38,425,463
1224,TSLA  ,2023-02-09,2023-07-21,50.0,66,5108,5174
1225,TSLA  ,2023-02-09,2023-07-21,55.0,86,1848,1934
1226,TSLA  ,2023-02-09,2023-07-21,60.0,94,3329,3423
1227,TSLA  ,2023-02-09,2023-07-21,65.0,86,395,481
1228,TSLA  ,2023-02-09,2023-07-21,70.0,25,2492,2517
1229,TSLA  ,2023-02-09,2023-07-21,75.0,63,4164,4227
1230,TSLA  ,2023-02-09,2023-07-21,80.0,79,3662,3741
1231,TSLA  ,2023-02-09,2023-07-21,85.0,54,1382,1436
1232,TSLA  ,2023-02-09,2023-07-21,90.0,125,3333,3458
1233,TSLA  ,2023-02-09,2023-07-21,95.0,60,1614,1674
1234,TSLA  ,2023-02-09,2023-07-21,100.0,295,5499,5794
1235,TSLA  ,2023-02-09,2023-07-21,105.0,333,2484,2817
1236,TSLA  ,2023-02-09,2023-07-21,110.0,1124,2954,4078
1237,TSLA  ,2023-02-09,2023-07-21,115.0,467,1003,1470
1238,TSLA  ,2023-02-09,2023-07-21,120.0,1254,4458,5712
1239,TSLA  ,2023-02-09,2023-07-21,125.0,1408,2151,3559
1240,TSLA  ,2023-02-09,2023-07-21,130.0,1512,1684,3196
1241,TSLA  ,2023-02-09,2023-07-21,135.0,1155,3224,4379
1242,TSLA  ,2023-02-09,2023-07-21,140.0,1500,2901,4401
1243,TSLA  ,2023-02-09,2023-07-21,145.0,1054,2153,3207
1244,TSLA  ,2023-02-09,2023-07-21,150.0,3234,3464,6698
1245,TSLA  ,2023-02-09,2023-07-21,155.0,1654,2824,4478
1246,TSLA  ,2023-02-09,2023-07-21,160.0,1682,1334,3016
1247,TSLA  ,2023-02-09,2023-07-21,165.0,603,1404,2007
1248,TSLA  ,2023-02-09,2023-07-21,170.0,1778,2042,3820
1249,TSLA  ,2023-02-09,2023-07-21,175.0,1642,1242,2884
1250,TSLA  ,2023-02-09,2023-07-21,180.0,2081,1657,3738
1251,TSLA  ,2023-02-09,2023-07-21,185.0,3925,12890,16815
1252,TSLA  ,2023-02-09,2023-07-21,190.0,2200,2332,4532
1253,TSLA  ,2023-02-09,2023-07-21,195.0,1358,1965,3323
1254,TSLA  ,2023-02-09,2023-07-21,200.0,5267,2099,7366
1255,TSLA  ,2023-02-09,2023-07-21,205.0,2101,671,2772
1256,TSLA  ,2023-02-09,2023-07-21,210.0,5194,835,6029
1257,TSLA  ,2023-02-09,2023-07-21,215.0,3511,815,4326
1258,TSLA  ,2023-02-09,2023-07-21,220.0,2914,1547,4461
1259,TSLA  ,2023-02-09,2023-07-21,225.0,2727,2010,4737
1260,TSLA  ,2023-02-09,2023-07-21,230.0,2500,1200,3700
1261,TSLA  ,2023-02-09,2023-07-21,235.0,971,511,1482
1262,TSLA  ,2023-02-09,2023-07-21,240.0,1265,1638,2903
1263,TSLA  ,2023-02-09,2023-07-21,245.0,777,663,1440
1264,TSLA  ,2023-02-09,2023-07-21,250.0,24394,1579,25973
1265,TSLA  ,2023-02-09,2023-07-21,255.0,868,641,1509
1266,TSLA  ,2023-02-09,2023-07-21,260.0,646,69,715
1267,TSLA  ,2023-02-09,2023-07-21,265.0,239,9,248
1268,TSLA  ,2023-02-09,2023-07-21,270.0,433,126,559
1269,TSLA  ,2023-02-09,2023-07-21,275.0,284,76,360
1270,TSLA  ,2023-02-09,2023-07-21,280.0,1280,146,1426
1271,TSLA  ,2023-02-09,2023-07-21,285.0,895,143,1038
1272,TSLA  ,2023-02-09,2023-07-21,290.0,457,31,488
1273,TSLA  ,2023-02-09,2023-07-21,295.0,134,11,145
1274,TSLA  ,2023-02-09,2023-07-21,300.0,1510,4,1514
1275,TSLA  ,2023-02-09,2023-07-21,305.0,190,5,195
1276,TSLA  ,2023-02-09,2023-07-21,310.0,728,6,734
1277,TSLA  ,2023-02-09,2023-07-21,315.0,275,1,276
1278,TSLA  ,2023-02-09,2023-07-21,320.0,447,0,447
1279,TSLA  ,2023-02-09,2023-07-21,325.0,605,0,605
1280,TSLA  ,2023-02-09,2023-07-21,330.0,435,26,461
1281,TSLA  ,2023-02-09,2023-07-21,335.0,159,7,166
1282,TSLA  ,2023-02-09,2023-07-21,340.0,428,16,444
1283,TSLA  ,2023-02-09,2023-07-21,345.0,155,0,155
1284,TSLA  ,2023-02-09,2023-07-21,350.0,643,1,644
1285,TSLA  ,2023-02-09,2023-07-21,355.0,264,1,265
1286,TSLA  ,2023-02-09,2023-07-21,360.0,535,0,535
1287,TSLA  ,2023-02-09,2023-07-21,365.0,957,0,957
1288,TSLA  ,2023-02-09,2023-07-21,370.0,951,0,951
1289,TSLA  ,2023-02-09,2023-07-21,375.0,3222,0,3222
1290,TSLA  ,2023-02-09,2023-07-21,380.0,149,0,149
1291,TSLA  ,2023-02-09,2023-07-21,390.0,250,0,250
1292,TSLA  ,2023-02-09,2023-09-15,1.67,861,20021,20882
1293,TSLA  ,2023-02-09,2023-09-15,3.33,1086,2849,3935
1294,TSLA  ,2023-02-09,2023-09-15,5.0,25,942,967
1295,TSLA  ,2023-02-09,2023-09-15,6.67,29,3365,3394
1296,TSLA  ,2023-02-09,2023-09-15,8.33,32,1176,1208
1297,TSLA  ,2023-02-09,2023-09-15,10.0,26,2172,2198
1298,TSLA  ,2023-02-09,2023-09-15,11.67,49,617,666
1299,TSLA  ,2023-02-09,2023-09-15,13.33,83,230,313
1300,TSLA  ,2023-02-09,2023-09-15,15.0,0,116,116
1301,TSLA  ,2023-02-09,2023-09-15,16.67,143,4190,4333
1302,TSLA  ,2023-02-09,2023-09-15,30.0,3,69,72
1303,TSLA  ,2023-02-09,2023-09-15,33.33,3118,11371,14489
1304,TSLA  ,2023-02-09,2023-09-15,35.0,2,32,34
1305,TSLA  ,2023-02-09,2023-09-15,40.0,3,182,185
1306,TSLA  ,2023-02-09,2023-09-15,45.0,6,48,54
1307,TSLA  ,2023-02-09,2023-09-15,50.0,411,7609,8020
1308,TSLA  ,2023-02-09,2023-09-15,55.0,22,2386,2408
1309,TSLA  ,2023-02-09,2023-09-15,60.0,30,4733,4763
1310,TSLA  ,2023-02-09,2023-09-15,65.0,4,2015,2019
1311,TSLA  ,2023-02-09,2023-09-15,66.67,438,5669,6107
1312,TSLA  ,2023-02-09,2023-09-15,70.0,83,611,694
1313,TSLA  ,2023-02-09,2023-09-15,75.0,26,646,672
1314,TSLA  ,2023-02-09,2023-09-15,80.0,259,799,1058
1315,TSLA  ,2023-02-09,2023-09-15,83.33,407,4456,4863
1316,TSLA  ,2023-02-09,2023-09-15,85.0,50,321,371
1317,TSLA  ,2023-02-09,2023-09-15,90.0,485,2635,3120
1318,TSLA  ,2023-02-09,2023-09-15,95.0,70,2439,2509
1319,TSLA  ,2023-02-09,2023-09-15,100.0,3257,11931,15188
1320,TSLA  ,2023-02-09,2023-09-15,105.0,87,2148,2235
1321,TSLA  ,2023-02-09,2023-09-15,108.33,400,2126,2526
1322,TSLA  ,2023-02-09,2023-09-15,110.0,1369,1479,2848
1323,TSLA  ,2023-02-09,2023-09-15,115.0,180,3015,3195
1324,TSLA  ,2023-02-09,2023-09-15,116.67,569,12235,12804
1325,TSLA  ,2023-02-09,2023-09-15,120.0,353,1784,2137
1326,TSLA  ,2023-02-09,2023-09-15,123.33,544,1349,1893
1327,TSLA  ,2023-02-09,2023-09-15,125.0,1741,7154,8895
1328,TSLA  ,2023-02-09,2023-09-15,126.67,130,1075,1205
1329,TSLA  ,2023-02-09,2023-09-15,130.0,1400,4983,6383
1330,TSLA  ,2023-02-09,2023-09-15,133.33,203,2370,2573
1331,TSLA  ,2023-02-09,2023-09-15,135.0,205,1209,1414
1332,TSLA  ,2023-02-09,2023-09-15,136.67,283,923,1206
1333,TSLA  ,2023-02-09,2023-09-15,140.0,1783,1965,3748
1334,TSLA  ,2023-02-09,2023-09-15,141.67,765,1678,2443
1335,TSLA  ,2023-02-09,2023-09-15,143.33,274,1539,1813
1336,TSLA  ,2023-02-09,2023-09-15,145.0,352,2669,3021
1337,TSLA  ,2023-02-09,2023-09-15,146.67,1373,1075,2448
1338,TSLA  ,2023-02-09,2023-09-15,150.0,33851,9114,42965
1339,TSLA  ,2023-02-09,2023-09-15,153.33,30482,1827,32309
1340,TSLA  ,2023-02-09,2023-09-15,155.0,419,386,805
1341,TSLA  ,2023-02-09,2023-09-15,156.67,394,649,1043
1342,TSLA  ,2023-02-09,2023-09-15,158.33,317,582,899
1343,TSLA  ,2023-02-09,2023-09-15,160.0,3746,5987,9733
1344,TSLA  ,2023-02-09,2023-09-15,163.33,416,1490,1906
1345,TSLA  ,2023-02-09,2023-09-15,165.0,1303,745,2048
1346,TSLA  ,2023-02-09,2023-09-15,166.67,1398,3090,4488
1347,TSLA  ,2023-02-09,2023-09-15,170.0,657,715,1372
1348,TSLA  ,2023-02-09,2023-09-15,173.33,10320,3055,13375
1349,TSLA  ,2023-02-09,2023-09-15,175.0,10902,7605,18507
1350,TSLA  ,2023-02-09,2023-09-15,180.0,33728,6429,40157
1351,TSLA  ,2023-02-09,2023-09-15,183.33,32295,5270,37565
1352,TSLA  ,2023-02-09,2023-09-15,185.0,322,292,614
1353,TSLA  ,2023-02-09,2023-09-15,186.67,526,3389,3915
1354,TSLA  ,2023-02-09,2023-09-15,190.0,752,1399,2151
1355,TSLA  ,2023-02-09,2023-09-15,191.67,494,1178,1672
1356,TSLA  ,2023-02-09,2023-09-15,193.33,950,2814,3764
1357,TSLA  ,2023-02-09,2023-09-15,195.0,336,565,901
1358,TSLA  ,2023-02-09,2023-09-15,200.0,11888,17190,29078
1359,TSLA  ,2023-02-09,2023-09-15,205.0,346,144,490
1360,TSLA  ,2023-02-09,2023-09-15,206.67,981,519,1500
1361,TSLA  ,2023-02-09,2023-09-15,208.33,566,2165,2731
1362,TSLA  ,2023-02-09,2023-09-15,210.0,1168,247,1415
1363,TSLA  ,2023-02-09,2023-09-15,213.33,591,1272,1863
1364,TSLA  ,2023-02-09,2023-09-15,215.0,608,152,760
1365,TSLA  ,2023-02-09,2023-09-15,216.67,2288,4247,6535
1366,TSLA  ,2023-02-09,2023-09-15,220.0,7453,3148,10601
1367,TSLA  ,2023-02-09,2023-09-15,225.0,2484,3312,5796
1368,TSLA  ,2023-02-09,2023-09-15,226.67,1292,1433,2725
1369,TSLA  ,2023-02-09,2023-09-15,230.0,2427,750,3177
1370,TSLA  ,2023-02-09,2023-09-15,233.33,2775,3027,5802
1371,TSLA  ,2023-02-09,2023-09-15,235.0,266,428,694
1372,TSLA  ,2023-02-09,2023-09-15,240.0,1297,2041,3338
1373,TSLA  ,2023-02-09,2023-09-15,241.67,1109,719,1828
1374,TSLA  ,2023-02-09,2023-09-15,245.0,72,208,280
1375,TSLA  ,2023-02-09,2023-09-15,246.67,507,439,946
1376,TSLA  ,2023-02-09,2023-09-15,250.0,10528,4152,14680
1377,TSLA  ,2023-02-09,2023-09-15,253.33,840,521,1361
1378,TSLA  ,2023-02-09,2023-09-15,255.0,61,12,73
1379,TSLA  ,2023-02-09,2023-09-15,258.33,729,2408,3137
1380,TSLA  ,2023-02-09,2023-09-15,260.0,11800,1418,13218
1381,TSLA  ,2023-02-09,2023-09-15,265.0,69,118,187
1382,TSLA  ,2023-02-09,2023-09-15,266.67,2418,319,2737
1383,TSLA  ,2023-02-09,2023-09-15,270.0,322,162,484
1384,TSLA  ,2023-02-09,2023-09-15,273.33,712,355,1067
1385,TSLA  ,2023-02-09,2023-09-15,275.0,2823,344,3167
1386,TSLA  ,2023-02-09,2023-09-15,280.0,2093,562,2655
1387,TSLA  ,2023-02-09,2023-09-15,283.33,1230,264,1494
1388,TSLA  ,2023-02-09,2023-09-15,286.67,535,96,631
1389,TSLA  ,2023-02-09,2023-09-15,290.0,167,60,227
1390,TSLA  ,2023-02-09,2023-09-15,291.67,989,337,1326
1391,TSLA  ,2023-02-09,2023-09-15,293.33,1318,392,1710
1392,TSLA  ,2023-02-09,2023-09-15,300.0,8240,947,9187
1393,TSLA  ,2023-02-09,2023-09-15,306.67,2659,328,2987
1394,TSLA  ,2023-02-09,2023-09-15,308.33,789,334,1123
1395,TSLA  ,2023-02-09,2023-09-15,313.33,860,286,1146
1396,TSLA  ,2023-02-09,2023-09-15,316.67,1582,161,1743
1397,TSLA  ,2023-02-09,2023-09-15,320.0,1776,168,1944
1398,TSLA  ,2023-02-09,2023-09-15,325.0,2771,75,2846
1399,TSLA  ,2023-02-09,2023-09-15,326.67,1108,5,1113
1400,TSLA  ,2023-02-09,2023-09-15,333.33,6446,84,6530
1401,TSLA  ,2023-02-09,2023-09-15,340.0,23342,147,23489
1402,TSLA  ,2023-02-09,2023-09-15,341.67,178,187,365
1403,TSLA  ,2023-02-09,2023-09-15,346.67,520,135,655
1404,TSLA  ,2023-02-09,2023-09-15,350.0,17718,318,18036
1405,TSLA  ,2023-02-09,2023-09-15,353.33,22621,149,22770
1406,TSLA  ,2023-02-09,2023-09-15,358.33,427,287,714
1407,TSLA  ,2023-02-09,2023-09-15,360.0,3308,341,3649
1408,TSLA  ,2023-02-09,2023-09-15,366.67,2927,549,3476
1409,TSLA  ,2023-02-09,2023-09-15,375.0,3211,161,3372
1410,TSLA  ,2023-02-09,2023-09-15,383.33,4532,16,4548
1411,TSLA  ,2023-02-09,2023-09-15,391.67,827,1,828
1412,TSLA  ,2023-02-09,2023-09-15,400.0,5691,68,5759
1413,TSLA  ,2023-02-09,2023-09-15,408.33,1619,0,1619
1414,TSLA  ,2023-02-09,2023-09-15,416.67,971,0,971
1415,TSLA  ,2023-02-09,2023-09-15,425.0,3268,0,3268
1416,TSLA  ,2023-02-09,2023-09-15,433.33,4954,8,4962
1417,TSLA  ,2023-02-09,2023-09-15,441.67,1021,0,1021
1418,TSLA  ,2023-02-09,2023-09-15,450.0,2458,0,2458
1419,TSLA  ,2023-02-09,2023-09-15,458.33,401,0,401
1420,TSLA  ,2023-02-09,2023-09-15,466.67,2695,0,2695
1421,TSLA  ,2023-02-09,2023-09-15,475.0,329,0,329
1422,TSLA  ,2023-02-09,2023-09-15,483.33,663,0,663
1423,TSLA  ,2023-02-09,2023-09-15,491.67,1097,0,1097
1424,TSLA  ,2023-02-09,2023-09-15,500.0,5026,0,5026
1425,TSLA  ,2023-02-09,2023-09-15,508.33,812,0,812
1426,TSLA  ,2023-02-09,2023-09-15,516.67,1262,0,1262
1427,TSLA  ,2023-02-09,2023-09-15,525.0,1195,0,1195
1428,TSLA  ,2023-02-09,2023-09-15,533.33,1601,0,1601
1429,TSLA  ,2023-02-09,2023-09-15,541.67,1161,0,1161
1430,TSLA  ,2023-02-09,2023-09-15,550.0,11715,0,11715
1431,TSLA  ,2023-02-09,2023-09-15,558.33,188,0,188
1432,TSLA  ,2023-02-09,2023-09-15,566.67,4082,0,4082
1433,TSLA  ,2023-02-09,2023-09-15,575.0,348,0,348
1434,TSLA  ,2023-02-09,2023-09-15,583.33,511,0,511
1435,TSLA  ,2023-02-09,2023-09-15,591.67,2091,0,2091
1436,TSLA  ,2023-02-09,2023-09-15,600.0,8637,0,8637
1437,TSLA  ,2023-02-09,2023-09-15,608.33,672,0,672
1438,TSLA  ,2023-02-09,2023-09-15,616.67,1025,0,1025
1439,TSLA  ,2023-02-09,2023-09-15,625.0,1034,0,1034
1440,TSLA  ,2023-02-09,2023-09-15,633.33,642,0,642
1441,TSLA  ,2023-02-09,2023-09-15,641.67,428,0,428
1442,TSLA  ,2023-02-09,2023-09-15,650.0,27283,0,27283
1443,TSLA  ,2023-02-09,2023-09-15,658.33,1206,0,1206
1444,TSLA  ,2023-02-09,2023-09-15,666.67,1303,0,1303
1445,TSLA  ,2023-02-09,2023-09-15,675.0,491,0,491
1446,TSLA  ,2023-02-09,2023-09-15,683.33,360,0,360
1447,TSLA  ,2023-02-09,2023-09-15,700.0,1533,0,1533
1448,TSLA  ,2023-02-09,2023-09-15,716.67,1139,0,1139
1449,TSLA  ,2023-02-09,2023-09-15,733.33,2326,0,2326
1450,TSLA  ,2023-02-09,2023-09-15,750.0,8206,0,8206
1451,TSLA  ,2023-02-09,2023-09-15,758.33,71871,0,71871
1452,TSLA  ,2023-02-09,2023-12-15,50.0,1277,3373,4650
1453,TSLA  ,2023-02-09,2023-12-15,55.0,64,1128,1192
1454,TSLA  ,2023-02-09,2023-12-15,60.0,37,1135,1172
1455,TSLA  ,2023-02-09,2023-12-15,65.0,4,359,363
1456,TSLA  ,2023-02-09,2023-12-15,70.0,27,3823,3850
1457,TSLA  ,2023-02-09,2023-12-15,75.0,19,3983,4002
1458,TSLA  ,2023-02-09,2023-12-15,80.0,157,786,943
1459,TSLA  ,2023-02-09,2023-12-15,85.0,2577,2381,4958
1460,TSLA  ,2023-02-09,2023-12-15,90.0,1644,5577,7221
1461,TSLA  ,2023-02-09,2023-12-15,95.0,831,501,1332
1462,TSLA  ,2023-02-09,2023-12-15,100.0,2282,5800,8082
1463,TSLA  ,2023-02-09,2023-12-15,105.0,324,722,1046
1464,TSLA  ,2023-02-09,2023-12-15,110.0,737,2150,2887
1465,TSLA  ,2023-02-09,2023-12-15,115.0,1715,941,2656
1466,TSLA  ,2023-02-09,2023-12-15,120.0,1019,1249,2268
1467,TSLA  ,2023-02-09,2023-12-15,125.0,490,1304,1794
1468,TSLA  ,2023-02-09,2023-12-15,130.0,789,10587,11376
1469,TSLA  ,2023-02-09,2023-12-15,135.0,794,5786,6580
1470,TSLA  ,2023-02-09,2023-12-15,140.0,970,1387,2357
1471,TSLA  ,2023-02-09,2023-12-15,145.0,633,883,1516
1472,TSLA  ,2023-02-09,2023-12-15,150.0,1523,11888,13411
1473,TSLA  ,2023-02-09,2023-12-15,155.0,418,1001,1419
1474,TSLA  ,2023-02-09,2023-12-15,160.0,2829,10768,13597
1475,TSLA  ,2023-02-09,2023-12-15,165.0,1485,461,1946
1476,TSLA  ,2023-02-09,2023-12-15,170.0,752,4458,5210
1477,TSLA  ,2023-02-09,2023-12-15,175.0,2133,368,2501
1478,TSLA  ,2023-02-09,2023-12-15,180.0,1646,1117,2763
1479,TSLA  ,2023-02-09,2023-12-15,185.0,534,558,1092
1480,TSLA  ,2023-02-09,2023-12-15,190.0,1177,495,1672
1481,TSLA  ,2023-02-09,2023-12-15,195.0,749,535,1284
1482,TSLA  ,2023-02-09,2023-12-15,200.0,8827,1335,10162
1483,TSLA  ,2023-02-09,2023-12-15,205.0,6814,311,7125
1484,TSLA  ,2023-02-09,2023-12-15,210.0,2698,415,3113
1485,TSLA  ,2023-02-09,2023-12-15,215.0,1195,349,1544
1486,TSLA  ,2023-02-09,2023-12-15,220.0,1524,1089,2613
1487,TSLA  ,2023-02-09,2023-12-15,225.0,1271,244,1515
1488,TSLA  ,2023-02-09,2023-12-15,230.0,1572,674,2246
1489,TSLA  ,2023-02-09,2023-12-15,235.0,493,428,921
1490,TSLA  ,2023-02-09,2023-12-15,240.0,5740,532,6272
1491,TSLA  ,2023-02-09,2023-12-15,245.0,1869,501,2370
1492,TSLA  ,2023-02-09,2023-12-15,250.0,15717,3450,19167
1493,TSLA  ,2023-02-09,2023-12-15,260.0,10069,749,10818
1494,TSLA  ,2023-02-09,2023-12-15,270.0,3823,513,4336
1495,TSLA  ,2023-02-09,2023-12-15,280.0,1259,641,1900
1496,TSLA  ,2023-02-09,2023-12-15,290.0,409,415,824
1497,TSLA  ,2023-02-09,2023-12-15,300.0,962,986,1948
1498,TSLA  ,2023-02-09,2023-12-15,310.0,937,593,1530
1499,TSLA  ,2023-02-09,2023-12-15,320.0,570,520,1090
1500,TSLA  ,2023-02-09,2023-12-15,330.0,464,213,677
1501,TSLA  ,2023-02-09,2023-12-15,340.0,319,65,384
1502,TSLA  ,2023-02-09,2023-12-15,350.0,802,159,961
1503,TSLA  ,2023-02-09,2023-12-15,360.0,524,116,640
1504,TSLA  ,2023-02-09,2023-12-15,370.0,33,241,274
1505,TSLA  ,2023-02-09,2023-12-15,380.0,103,312,415
1506,TSLA  ,2023-02-09,2023-12-15,390.0,296,104,400
1507,TSLA  ,2023-02-09,2024-01-19,1.67,2491,29243,31734
1508,TSLA  ,2023-02-09,2024-01-19,3.33,966,5840,6806
1509,TSLA  ,2023-02-09,2024-01-19,5.0,256,10178,10434
1510,TSLA  ,2023-02-09,2024-01-19,6.67,75,3260,3335
1511,TSLA  ,2023-02-09,2024-01-19,8.33,3902,2758,6660
1512,TSLA  ,2023-02-09,2024-01-19,10.0,294,3994,4288
1513,TSLA  ,2023-02-09,2024-01-19,11.67,253,3175,3428
1514,TSLA  ,2023-02-09,2024-01-19,13.33,819,507,1326
1515,TSLA  ,2023-02-09,2024-01-19,15.0,279,2066,2345
1516,TSLA  ,2023-02-09,2024-01-19,16.67,486,4566,5052
1517,TSLA  ,2023-02-09,2024-01-19,18.33,393,6128,6521
1518,TSLA  ,2023-02-09,2024-01-19,20.0,260,7589,7849
1519,TSLA  ,2023-02-09,2024-01-19,21.67,108,843,951
1520,TSLA  ,2023-02-09,2024-01-19,23.33,382,3838,4220
1521,TSLA  ,2023-02-09,2024-01-19,25.0,369,2799,3168
1522,TSLA  ,2023-02-09,2024-01-19,26.67,833,1194,2027
1523,TSLA  ,2023-02-09,2024-01-19,28.33,341,851,1192
1524,TSLA  ,2023-02-09,2024-01-19,30.0,228,8800,9028
1525,TSLA  ,2023-02-09,2024-01-19,31.67,1328,1353,2681
1526,TSLA  ,2023-02-09,2024-01-19,33.33,4315,32829,37144
1527,TSLA  ,2023-02-09,2024-01-19,50.0,2159,30237,32396
1528,TSLA  ,2023-02-09,2024-01-19,55.0,81,1274,1355
1529,TSLA  ,2023-02-09,2024-01-19,60.0,250,2630,2880
1530,TSLA  ,2023-02-09,2024-01-19,65.0,266,767,1033
1531,TSLA  ,2023-02-09,2024-01-19,66.67,4705,14639,19344
1532,TSLA  ,2023-02-09,2024-01-19,70.0,143,883,1026
1533,TSLA  ,2023-02-09,2024-01-19,75.0,93,2701,2794
1534,TSLA  ,2023-02-09,2024-01-19,80.0,414,1730,2144
1535,TSLA  ,2023-02-09,2024-01-19,83.33,1066,7960,9026
1536,TSLA  ,2023-02-09,2024-01-19,85.0,512,458,970
1537,TSLA  ,2023-02-09,2024-01-19,90.0,3540,1381,4921
1538,TSLA  ,2023-02-09,2024-01-19,95.0,3026,1354,4380
1539,TSLA  ,2023-02-09,2024-01-19,100.0,13894,39037,52931
1540,TSLA  ,2023-02-09,2024-01-19,105.0,1290,1915,3205
1541,TSLA  ,2023-02-09,2024-01-19,110.0,5033,7098,12131
1542,TSLA  ,2023-02-09,2024-01-19,115.0,4697,5576,10273
1543,TSLA  ,2023-02-09,2024-01-19,116.67,1936,8293,10229
1544,TSLA  ,2023-02-09,2024-01-19,120.0,3488,6087,9575
1545,TSLA  ,2023-02-09,2024-01-19,123.33,1984,2359,4343
1546,TSLA  ,2023-02-09,2024-01-19,125.0,2414,12641,15055
1547,TSLA  ,2023-02-09,2024-01-19,126.67,1742,6573,8315
1548,TSLA  ,2023-02-09,2024-01-19,130.0,5067,11933,17000
1549,TSLA  ,2023-02-09,2024-01-19,133.33,2434,10985,13419
1550,TSLA  ,2023-02-09,2024-01-19,135.0,1340,1285,2625
1551,TSLA  ,2023-02-09,2024-01-19,136.67,2441,2295,4736
1552,TSLA  ,2023-02-09,2024-01-19,140.0,5035,4274,9309
1553,TSLA  ,2023-02-09,2024-01-19,143.33,1671,2274,3945
1554,TSLA  ,2023-02-09,2024-01-19,145.0,758,843,1601
1555,TSLA  ,2023-02-09,2024-01-19,146.67,1026,984,2010
1556,TSLA  ,2023-02-09,2024-01-19,150.0,17552,22143,39695
1557,TSLA  ,2023-02-09,2024-01-19,153.33,10747,1047,11794
1558,TSLA  ,2023-02-09,2024-01-19,155.0,535,1457,1992
1559,TSLA  ,2023-02-09,2024-01-19,156.67,1730,803,2533
1560,TSLA  ,2023-02-09,2024-01-19,160.0,3603,12308,15911
1561,TSLA  ,2023-02-09,2024-01-19,163.33,506,7394,7900
1562,TSLA  ,2023-02-09,2024-01-19,165.0,701,456,1157
1563,TSLA  ,2023-02-09,2024-01-19,166.67,6753,6894,13647
1564,TSLA  ,2023-02-09,2024-01-19,170.0,2939,6217,9156
1565,TSLA  ,2023-02-09,2024-01-19,173.33,856,2587,3443
1566,TSLA  ,2023-02-09,2024-01-19,175.0,1715,2116,3831
1567,TSLA  ,2023-02-09,2024-01-19,176.67,1018,1262,2280
1568,TSLA  ,2023-02-09,2024-01-19,180.0,39185,11019,50204
1569,TSLA  ,2023-02-09,2024-01-19,183.33,34395,7411,41806
1570,TSLA  ,2023-02-09,2024-01-19,185.0,1621,718,2339
1571,TSLA  ,2023-02-09,2024-01-19,186.67,1256,2281,3537
1572,TSLA  ,2023-02-09,2024-01-19,190.0,1625,627,2252
1573,TSLA  ,2023-02-09,2024-01-19,193.33,2292,9810,12102
1574,TSLA  ,2023-02-09,2024-01-19,195.0,397,1680,2077
1575,TSLA  ,2023-02-09,2024-01-19,200.0,33357,24221,57578
1576,TSLA  ,2023-02-09,2024-01-19,203.33,6288,2273,8561
1577,TSLA  ,2023-02-09,2024-01-19,206.67,1627,1195,2822
1578,TSLA  ,2023-02-09,2024-01-19,210.0,10957,6346,17303
1579,TSLA  ,2023-02-09,2024-01-19,213.33,1568,2694,4262
1580,TSLA  ,2023-02-09,2024-01-19,216.67,9181,7347,16528
1581,TSLA  ,2023-02-09,2024-01-19,220.0,6685,7072,13757
1582,TSLA  ,2023-02-09,2024-01-19,223.33,5768,1428,7196
1583,TSLA  ,2023-02-09,2024-01-19,226.67,19992,2978,22970
1584,TSLA  ,2023-02-09,2024-01-19,230.0,13893,19011,32904
1585,TSLA  ,2023-02-09,2024-01-19,233.33,37136,13921,51057
1586,TSLA  ,2023-02-09,2024-01-19,236.67,1982,1679,3661
1587,TSLA  ,2023-02-09,2024-01-19,240.0,2483,3916,6399
1588,TSLA  ,2023-02-09,2024-01-19,243.33,1202,2000,3202
1589,TSLA  ,2023-02-09,2024-01-19,246.67,1051,2117,3168
1590,TSLA  ,2023-02-09,2024-01-19,250.0,22318,5235,27553
1591,TSLA  ,2023-02-09,2024-01-19,253.33,2808,2101,4909
1592,TSLA  ,2023-02-09,2024-01-19,256.67,2833,1560,4393
1593,TSLA  ,2023-02-09,2024-01-19,260.0,7326,3170,10496
1594,TSLA  ,2023-02-09,2024-01-19,263.33,7771,2147,9918
1595,TSLA  ,2023-02-09,2024-01-19,266.67,10332,8966,19298
1596,TSLA  ,2023-02-09,2024-01-19,270.0,4572,5211,9783
1597,TSLA  ,2023-02-09,2024-01-19,273.33,3244,3091,6335
1598,TSLA  ,2023-02-09,2024-01-19,276.67,1746,1761,3507
1599,TSLA  ,2023-02-09,2024-01-19,280.0,9304,6496,15800
1600,TSLA  ,2023-02-09,2024-01-19,283.33,3102,3032,6134
1601,TSLA  ,2023-02-09,2024-01-19,286.67,2486,1503,3989
1602,TSLA  ,2023-02-09,2024-01-19,290.0,9074,556,9630
1603,TSLA  ,2023-02-09,2024-01-19,293.33,2098,1988,4086
1604,TSLA  ,2023-02-09,2024-01-19,296.67,2034,1688,3722
1605,TSLA  ,2023-02-09,2024-01-19,300.0,25420,6497,31917
1606,TSLA  ,2023-02-09,2024-01-19,303.33,3398,74,3472
1607,TSLA  ,2023-02-09,2024-01-19,306.67,6576,132,6708
1608,TSLA  ,2023-02-09,2024-01-19,310.0,3732,1012,4744
1609,TSLA  ,2023-02-09,2024-01-19,313.33,1157,22,1179
1610,TSLA  ,2023-02-09,2024-01-19,316.67,4171,306,4477
1611,TSLA  ,2023-02-09,2024-01-19,320.0,6132,317,6449
1612,TSLA  ,2023-02-09,2024-01-19,323.33,454,246,700
1613,TSLA  ,2023-02-09,2024-01-19,325.0,10242,113,10355
1614,TSLA  ,2023-02-09,2024-01-19,326.67,1348,633,1981
1615,TSLA  ,2023-02-09,2024-01-19,330.0,7282,11,7293
1616,TSLA  ,2023-02-09,2024-01-19,333.33,29861,1960,31821
1617,TSLA  ,2023-02-09,2024-01-19,336.67,1466,7,1473
1618,TSLA  ,2023-02-09,2024-01-19,340.0,3886,3,3889
1619,TSLA  ,2023-02-09,2024-01-19,341.67,888,9,897
1620,TSLA  ,2023-02-09,2024-01-19,343.33,526,0,526
1621,TSLA  ,2023-02-09,2024-01-19,346.67,2388,3,2391
1622,TSLA  ,2023-02-09,2024-01-19,350.0,15421,314,15735
1623,TSLA  ,2023-02-09,2024-01-19,353.33,1148,0,1148
1624,TSLA  ,2023-02-09,2024-01-19,356.67,878,0,878
1625,TSLA  ,2023-02-09,2024-01-19,358.33,1218,3,1221
1626,TSLA  ,2023-02-09,2024-01-19,360.0,9209,600,9809
1627,TSLA  ,2023-02-09,2024-01-19,363.33,443,7,450
1628,TSLA  ,2023-02-09,2024-01-19,366.67,38759,2843,41602
1629,TSLA  ,2023-02-09,2024-01-19,370.0,6885,4,6889
1630,TSLA  ,2023-02-09,2024-01-19,373.33,1053,11,1064
1631,TSLA  ,2023-02-09,2024-01-19,375.0,11361,8,11369
1632,TSLA  ,2023-02-09,2024-01-19,376.67,526,106,632
1633,TSLA  ,2023-02-09,2024-01-19,380.0,1027,1,1028
1634,TSLA  ,2023-02-09,2024-01-19,383.33,3079,2,3081
1635,TSLA  ,2023-02-09,2024-01-19,386.67,406,203,609
1636,TSLA  ,2023-02-09,2024-01-19,390.0,876,1,877
1637,TSLA  ,2023-02-09,2024-01-19,391.67,2129,1,2130
1638,TSLA  ,2023-02-09,2024-01-19,393.33,554,4,558
1639,TSLA  ,2023-02-09,2024-01-19,396.67,2634,0,2634
1640,TSLA  ,2023-02-09,2024-01-19,400.0,38699,965,39664
1641,TSLA  ,2023-02-09,2024-01-19,408.33,5123,1,5124
1642,TSLA  ,2023-02-09,2024-01-19,416.67,3791,2142,5933
1643,TSLA  ,2023-02-09,2024-01-19,425.0,4673,2,4675
1644,TSLA  ,2023-02-09,2024-01-19,433.33,5651,3,5654
1645,TSLA  ,2023-02-09,2024-01-19,441.67,1148,0,1148
1646,TSLA  ,2023-02-09,2024-01-19,450.0,7905,2426,10331
1647,TSLA  ,2023-02-09,2024-01-19,458.33,1997,0,1997
1648,TSLA  ,2023-02-09,2024-01-19,466.67,28966,0,28966
1649,TSLA  ,2023-02-09,2024-01-19,475.0,4830,10,4840
1650,TSLA  ,2023-02-09,2024-01-19,483.33,1593,0,1593
1651,TSLA  ,2023-02-09,2024-01-19,491.67,2141,0,2141
1652,TSLA  ,2023-02-09,2024-01-19,500.0,36833,135,36968
1653,TSLA  ,2023-02-09,2024-01-19,516.67,4790,2,4792
1654,TSLA  ,2023-02-09,2024-01-19,533.33,20812,0,20812
1655,TSLA  ,2023-02-09,2024-01-19,550.0,16395,0,16395
1656,TSLA  ,2023-02-09,2024-01-19,558.33,1182,0,1182
1657,TSLA  ,2023-02-09,2024-01-19,566.67,11375,0,11375
1658,TSLA  ,2023-02-09,2024-01-19,575.0,13956,0,13956
1659,TSLA  ,2023-02-09,2024-01-19,583.33,13826,0,13826
1660,TSLA  ,2023-02-09,2024-01-19,591.67,2265,0,2265
1661,TSLA  ,2023-02-09,2024-01-19,600.0,18503,0,18503
1662,TSLA  ,2023-02-09,2024-01-19,608.33,2278,0,2278
1663,TSLA  ,2023-02-09,2024-01-19,616.67,11851,0,11851
1664,TSLA  ,2023-02-09,2024-01-19,625.0,2407,0,2407
1665,TSLA  ,2023-02-09,2024-01-19,633.33,5724,0,5724
1666,TSLA  ,2023-02-09,2024-01-19,641.67,927,0,927
1667,TSLA  ,2023-02-09,2024-01-19,650.0,3206,0,3206
1668,TSLA  ,2023-02-09,2024-01-19,666.67,40887,0,40887
1669,TSLA  ,2023-02-09,2024-01-19,675.0,4348,0,4348
1670,TSLA  ,2023-02-09,2024-01-19,683.33,7135,0,7135
1671,TSLA  ,2023-02-09,2024-01-19,691.67,1587,0,1587
1672,TSLA  ,2023-02-09,2024-01-19,700.0,5470,0,5470
1673,TSLA  ,2023-02-09,2024-01-19,708.33,761,0,761
1674,TSLA  ,2023-02-09,2024-01-19,716.67,6045,0,6045
1675,TSLA  ,2023-02-09,2024-01-19,725.0,2696,3,2699
1676,TSLA  ,2023-02-09,2024-01-19,733.33,3420,0,3420
1677,TSLA  ,2023-02-09,2024-01-19,741.67,805,0,805
1678,TSLA  ,2023-02-09,2024-01-19,750.0,2320,0,2320
1679,TSLA  ,2023-02-09,2024-01-19,758.33,937,0,937
1680,TSLA  ,2023-02-09,2024-01-19,766.67,2137,0,2137
1681,TSLA  ,2023-02-09,2024-01-19,775.0,2921,0,2921
1682,TSLA  ,2023-02-09,2024-01-19,783.33,692,0,692
1683,TSLA  ,2023-02-09,2024-01-19,791.67,3177,0,3177
1684,TSLA  ,2023-02-09,2024-01-19,800.0,13611,0,13611
1685,TSLA  ,2023-02-09,2024-01-19,808.33,3927,0,3927
1686,TSLA  ,2023-02-09,2024-01-19,816.67,5812,0,5812
1687,TSLA  ,2023-02-09,2024-01-19,825.0,75733,0,75733
1688,TSLA  ,2023-02-09,2024-03-15,1.67,107,1887,1994
1689,TSLA  ,2023-02-09,2024-03-15,3.33,22,769,791
1690,TSLA  ,2023-02-09,2024-03-15,5.0,64,893,957
1691,TSLA  ,2023-02-09,2024-03-15,6.67,6,93,99
1692,TSLA  ,2023-02-09,2024-03-15,8.33,16,42,58
1693,TSLA  ,2023-02-09,2024-03-15,10.0,6,307,313
1694,TSLA  ,2023-02-09,2024-03-15,11.67,11,189,200
1695,TSLA  ,2023-02-09,2024-03-15,13.33,18,35,53
1696,TSLA  ,2023-02-09,2024-03-15,15.0,24,192,216
1697,TSLA  ,2023-02-09,2024-03-15,16.67,124,229,353
1698,TSLA  ,2023-02-09,2024-03-15,33.33,809,1974,2783
1699,TSLA  ,2023-02-09,2024-03-15,50.0,447,5525,5972
1700,TSLA  ,2023-02-09,2024-03-15,55.0,28,300,328
1701,TSLA  ,2023-02-09,2024-03-15,60.0,44,823,867
1702,TSLA  ,2023-02-09,2024-03-15,65.0,22,715,737
1703,TSLA  ,2023-02-09,2024-03-15,66.67,2035,1006,3041
1704,TSLA  ,2023-02-09,2024-03-15,70.0,50,235,285
1705,TSLA  ,2023-02-09,2024-03-15,75.0,20,398,418
1706,TSLA  ,2023-02-09,2024-03-15,80.0,191,555,746
1707,TSLA  ,2023-02-09,2024-03-15,83.33,999,4513,5512
1708,TSLA  ,2023-02-09,2024-03-15,85.0,291,210,501
1709,TSLA  ,2023-02-09,2024-03-15,90.0,742,385,1127
1710,TSLA  ,2023-02-09,2024-03-15,95.0,1558,409,1967
1711,TSLA  ,2023-02-09,2024-03-15,100.0,3365,3040,6405
1712,TSLA  ,2023-02-09,2024-03-15,105.0,818,717,1535
1713,TSLA  ,2023-02-09,2024-03-15,110.0,912,2516,3428
1714,TSLA  ,2023-02-09,2024-03-15,115.0,2041,202,2243
1715,TSLA  ,2023-02-09,2024-03-15,116.67,609,956,1565
1716,TSLA  ,2023-02-09,2024-03-15,120.0,327,589,916
1717,TSLA  ,2023-02-09,2024-03-15,125.0,663,707,1370
1718,TSLA  ,2023-02-09,2024-03-15,130.0,1570,442,2012
1719,TSLA  ,2023-02-09,2024-03-15,133.33,588,5693,6281
1720,TSLA  ,2023-02-09,2024-03-15,135.0,214,191,405
1721,TSLA  ,2023-02-09,2024-03-15,140.0,176,270,446
1722,TSLA  ,2023-02-09,2024-03-15,141.67,515,326,841
1723,TSLA  ,2023-02-09,2024-03-15,145.0,265,307,572
1724,TSLA  ,2023-02-09,2024-03-15,150.0,1285,4409,5694
1725,TSLA  ,2023-02-09,2024-03-15,155.0,83,205,288
1726,TSLA  ,2023-02-09,2024-03-15,158.33,172,581,753
1727,TSLA  ,2023-02-09,2024-03-15,160.0,216,4378,4594
1728,TSLA  ,2023-02-09,2024-03-15,165.0,145,3882,4027
1729,TSLA  ,2023-02-09,2024-03-15,166.67,583,1199,1782
1730,TSLA  ,2023-02-09,2024-03-15,170.0,274,8784,9058
1731,TSLA  ,2023-02-09,2024-03-15,175.0,699,1939,2638
1732,TSLA  ,2023-02-09,2024-03-15,180.0,306,437,743
1733,TSLA  ,2023-02-09,2024-03-15,183.33,525,1146,1671
1734,TSLA  ,2023-02-09,2024-03-15,185.0,218,150,368
1735,TSLA  ,2023-02-09,2024-03-15,190.0,166,208,374
1736,TSLA  ,2023-02-09,2024-03-15,191.67,633,1383,2016
1737,TSLA  ,2023-02-09,2024-03-15,195.0,567,129,696
1738,TSLA  ,2023-02-09,2024-03-15,200.0,5084,4667,9751
1739,TSLA  ,2023-02-09,2024-03-15,208.33,1151,732,1883
1740,TSLA  ,2023-02-09,2024-03-15,210.0,463,128,591
1741,TSLA  ,2023-02-09,2024-03-15,216.67,1282,998,2280
1742,TSLA  ,2023-02-09,2024-03-15,220.0,496,33,529
1743,TSLA  ,2023-02-09,2024-03-15,225.0,1452,2420,3872
1744,TSLA  ,2023-02-09,2024-03-15,230.0,224,17,241
1745,TSLA  ,2023-02-09,2024-03-15,233.33,1616,1230,2846
1746,TSLA  ,2023-02-09,2024-03-15,240.0,132,11,143
1747,TSLA  ,2023-02-09,2024-03-15,241.67,1126,955,2081
1748,TSLA  ,2023-02-09,2024-03-15,250.0,2059,1516,3575
1749,TSLA  ,2023-02-09,2024-03-15,258.33,4134,1117,5251
1750,TSLA  ,2023-02-09,2024-03-15,260.0,363,71,434
1751,TSLA  ,2023-02-09,2024-03-15,266.67,4453,810,5263
1752,TSLA  ,2023-02-09,2024-03-15,270.0,79,2,81
1753,TSLA  ,2023-02-09,2024-03-15,275.0,8958,1006,9964
1754,TSLA  ,2023-02-09,2024-03-15,280.0,99,20,119
1755,TSLA  ,2023-02-09,2024-03-15,283.33,1166,710,1876
1756,TSLA  ,2023-02-09,2024-03-15,290.0,0,2,2
1757,TSLA  ,2023-02-09,2024-03-15,291.67,1288,143,1431
1758,TSLA  ,2023-02-09,2024-03-15,300.0,4711,642,5353
1759,TSLA  ,2023-02-09,2024-03-15,308.33,407,39,446
1760,TSLA  ,2023-02-09,2024-03-15,316.67,928,389,1317
1761,TSLA  ,2023-02-09,2024-03-15,325.0,1502,16,1518
1762,TSLA  ,2023-02-09,2024-03-15,333.33,866,24,890
1763,TSLA  ,2023-02-09,2024-03-15,341.67,286,24,310
1764,TSLA  ,2023-02-09,2024-03-15,350.0,911,42,953
1765,TSLA  ,2023-02-09,2024-03-15,358.33,428,68,496
1766,TSLA  ,2023-02-09,2024-03-15,366.67,542,161,703
1767,TSLA  ,2023-02-09,2024-03-15,375.0,658,2,660
1768,TSLA  ,2023-02-09,2024-03-15,383.33,202,1335,1537
1769,TSLA  ,2023-02-09,2024-03-15,391.67,310,8,318
1770,TSLA  ,2023-02-09,2024-03-15,400.0,1156,21,1177
1771,TSLA  ,2023-02-09,2024-03-15,408.33,623,3,626
1772,TSLA  ,2023-02-09,2024-03-15,416.67,372,316,688
1773,TSLA  ,2023-02-09,2024-03-15,425.0,897,8,905
1774,TSLA  ,2023-02-09,2024-03-15,433.33,590,0,590
1775,TSLA  ,2023-02-09,2024-03-15,441.67,170,0,170
1776,TSLA  ,2023-02-09,2024-03-15,450.0,1458,0,1458
1777,TSLA  ,2023-02-09,2024-03-15,458.33,236,0,236
1778,TSLA  ,2023-02-09,2024-03-15,466.67,799,0,799
1779,TSLA  ,2023-02-09,2024-03-15,475.0,426,0,426
1780,TSLA  ,2023-02-09,2024-03-15,483.33,486,0,486
1781,TSLA  ,2023-02-09,2024-03-15,491.67,319,0,319
1782,TSLA  ,2023-02-09,2024-03-15,500.0,2842,0,2842
1783,TSLA  ,2023-02-09,2024-03-15,508.33,228,0,228
1784,TSLA  ,2023-02-09,2024-03-15,516.67,697,0,697
1785,TSLA  ,2023-02-09,2024-03-15,525.0,118,0,118
1786,TSLA  ,2023-02-09,2024-03-15,533.33,232,0,232
1787,TSLA  ,2023-02-09,2024-03-15,541.67,165,0,165
1788,TSLA  ,2023-02-09,2024-03-15,550.0,423,0,423
1789,TSLA  ,2023-02-09,2024-03-15,558.33,265,0,265
1790,TSLA  ,2023-02-09,2024-03-15,566.67,381,0,381
1791,TSLA  ,2023-02-09,2024-03-15,575.0,660,0,660
1792,TSLA  ,2023-02-09,2024-03-15,583.33,465,0,465
1793,TSLA  ,2023-02-09,2024-03-15,600.0,3614,1,3615
1794,TSLA  ,2023-02-09,2024-06-21,1.67,630,16473,17103
1795,TSLA  ,2023-02-09,2024-06-21,3.33,149,3272,3421
1796,TSLA  ,2023-02-09,2024-06-21,5.0,20,1504,1524
1797,TSLA  ,2023-02-09,2024-06-21,6.67,219,1208,1427
1798,TSLA  ,2023-02-09,2024-06-21,8.33,121,368,489
1799,TSLA  ,2023-02-09,2024-06-21,10.0,275,1827,2102
1800,TSLA  ,2023-02-09,2024-06-21,11.67,540,314,854
1801,TSLA  ,2023-02-09,2024-06-21,13.33,39,218,257
1802,TSLA  ,2023-02-09,2024-06-21,16.67,1406,3529,4935
1803,TSLA  ,2023-02-09,2024-06-21,33.33,7803,5382,13185
1804,TSLA  ,2023-02-09,2024-06-21,50.0,1917,3750,5667
1805,TSLA  ,2023-02-09,2024-06-21,55.0,6,381,387
1806,TSLA  ,2023-02-09,2024-06-21,60.0,57,517,574
1807,TSLA  ,2023-02-09,2024-06-21,65.0,111,2098,2209
1808,TSLA  ,2023-02-09,2024-06-21,66.67,1877,4344,6221
1809,TSLA  ,2023-02-09,2024-06-21,70.0,49,252,301
1810,TSLA  ,2023-02-09,2024-06-21,75.0,70,123,193
1811,TSLA  ,2023-02-09,2024-06-21,80.0,111,1173,1284
1812,TSLA  ,2023-02-09,2024-06-21,83.33,30601,4211,34812
1813,TSLA  ,2023-02-09,2024-06-21,85.0,60,857,917
1814,TSLA  ,2023-02-09,2024-06-21,90.0,532,1146,1678
1815,TSLA  ,2023-02-09,2024-06-21,95.0,363,422,785
1816,TSLA  ,2023-02-09,2024-06-21,100.0,5358,9780,15138
1817,TSLA  ,2023-02-09,2024-06-21,105.0,796,804,1600
1818,TSLA  ,2023-02-09,2024-06-21,110.0,499,2189,2688
1819,TSLA  ,2023-02-09,2024-06-21,115.0,413,251,664
1820,TSLA  ,2023-02-09,2024-06-21,116.67,2480,1018,3498
1821,TSLA  ,2023-02-09,2024-06-21,120.0,559,1205,1764
1822,TSLA  ,2023-02-09,2024-06-21,123.33,643,3492,4135
1823,TSLA  ,2023-02-09,2024-06-21,125.0,135,2434,2569
1824,TSLA  ,2023-02-09,2024-06-21,126.67,689,1278,1967
1825,TSLA  ,2023-02-09,2024-06-21,130.0,839,1516,2355
1826,TSLA  ,2023-02-09,2024-06-21,133.33,1923,2853,4776
1827,TSLA  ,2023-02-09,2024-06-21,135.0,66,356,422
1828,TSLA  ,2023-02-09,2024-06-21,136.67,383,1886,2269
1829,TSLA  ,2023-02-09,2024-06-21,140.0,1458,2588,4046
1830,TSLA  ,2023-02-09,2024-06-21,143.33,1357,1748,3105
1831,TSLA  ,2023-02-09,2024-06-21,145.0,587,212,799
1832,TSLA  ,2023-02-09,2024-06-21,146.67,1616,565,2181
1833,TSLA  ,2023-02-09,2024-06-21,150.0,4347,9913,14260
1834,TSLA  ,2023-02-09,2024-06-21,153.33,257,815,1072
1835,TSLA  ,2023-02-09,2024-06-21,155.0,93,437,530
1836,TSLA  ,2023-02-09,2024-06-21,156.67,393,227,620
1837,TSLA  ,2023-02-09,2024-06-21,160.0,905,2727,3632
1838,TSLA  ,2023-02-09,2024-06-21,163.33,185,1422,1607
1839,TSLA  ,2023-02-09,2024-06-21,165.0,342,898,1240
1840,TSLA  ,2023-02-09,2024-06-21,166.67,1732,5495,7227
1841,TSLA  ,2023-02-09,2024-06-21,170.0,308,829,1137
1842,TSLA  ,2023-02-09,2024-06-21,173.33,522,5882,6404
1843,TSLA  ,2023-02-09,2024-06-21,175.0,1046,354,1400
1844,TSLA  ,2023-02-09,2024-06-21,180.0,1398,6090,7488
1845,TSLA  ,2023-02-09,2024-06-21,183.33,931,3703,4634
1846,TSLA  ,2023-02-09,2024-06-21,185.0,299,231,530
1847,TSLA  ,2023-02-09,2024-06-21,186.67,1323,1750,3073
1848,TSLA  ,2023-02-09,2024-06-21,190.0,333,87,420
1849,TSLA  ,2023-02-09,2024-06-21,193.33,1018,4285,5303
1850,TSLA  ,2023-02-09,2024-06-21,195.0,278,850,1128
1851,TSLA  ,2023-02-09,2024-06-21,200.0,4606,9770,14376
1852,TSLA  ,2023-02-09,2024-06-21,206.67,980,2853,3833
1853,TSLA  ,2023-02-09,2024-06-21,210.0,388,92,480
1854,TSLA  ,2023-02-09,2024-06-21,213.33,783,1498,2281
1855,TSLA  ,2023-02-09,2024-06-21,216.67,1514,5267,6781
1856,TSLA  ,2023-02-09,2024-06-21,220.0,2043,2391,4434
1857,TSLA  ,2023-02-09,2024-06-21,226.67,2328,3403,5731
1858,TSLA  ,2023-02-09,2024-06-21,230.0,309,100,409
1859,TSLA  ,2023-02-09,2024-06-21,233.33,6560,7139,13699
1860,TSLA  ,2023-02-09,2024-06-21,240.0,1382,4867,6249
1861,TSLA  ,2023-02-09,2024-06-21,246.67,2027,1307,3334
1862,TSLA  ,2023-02-09,2024-06-21,250.0,5409,3524,8933
1863,TSLA  ,2023-02-09,2024-06-21,253.33,1280,851,2131
1864,TSLA  ,2023-02-09,2024-06-21,260.0,2050,953,3003
1865,TSLA  ,2023-02-09,2024-06-21,266.67,10073,3359,13432
1866,TSLA  ,2023-02-09,2024-06-21,270.0,1461,1818,3279
1867,TSLA  ,2023-02-09,2024-06-21,273.33,1227,793,2020
1868,TSLA  ,2023-02-09,2024-06-21,276.67,1010,795,1805
1869,TSLA  ,2023-02-09,2024-06-21,280.0,1192,1565,2757
1870,TSLA  ,2023-02-09,2024-06-21,283.33,3568,1362,4930
1871,TSLA  ,2023-02-09,2024-06-21,286.67,973,771,1744
1872,TSLA  ,2023-02-09,2024-06-21,290.0,2249,1161,3410
1873,TSLA  ,2023-02-09,2024-06-21,293.33,1097,968,2065
1874,TSLA  ,2023-02-09,2024-06-21,296.67,858,360,1218
1875,TSLA  ,2023-02-09,2024-06-21,300.0,9314,893,10207
1876,TSLA  ,2023-02-09,2024-06-21,303.33,1358,645,2003
1877,TSLA  ,2023-02-09,2024-06-21,306.67,1501,237,1738
1878,TSLA  ,2023-02-09,2024-06-21,310.0,1718,518,2236
1879,TSLA  ,2023-02-09,2024-06-21,313.33,901,719,1620
1880,TSLA  ,2023-02-09,2024-06-21,316.67,2317,13,2330
1881,TSLA  ,2023-02-09,2024-06-21,320.0,691,691,1382
1882,TSLA  ,2023-02-09,2024-06-21,323.33,407,308,715
1883,TSLA  ,2023-02-09,2024-06-21,326.67,582,274,856
1884,TSLA  ,2023-02-09,2024-06-21,330.0,2700,123,2823
1885,TSLA  ,2023-02-09,2024-06-21,333.33,7562,1092,8654
1886,TSLA  ,2023-02-09,2024-06-21,336.67,2289,238,2527
1887,TSLA  ,2023-02-09,2024-06-21,340.0,781,29,810
1888,TSLA  ,2023-02-09,2024-06-21,343.33,1158,89,1247
1889,TSLA  ,2023-02-09,2024-06-21,346.67,397,41,438
1890,TSLA  ,2023-02-09,2024-06-21,350.0,3408,6,3414
1891,TSLA  ,2023-02-09,2024-06-21,353.33,199,69,268
1892,TSLA  ,2023-02-09,2024-06-21,356.67,493,0,493
1893,TSLA  ,2023-02-09,2024-06-21,360.0,2620,12,2632
1894,TSLA  ,2023-02-09,2024-06-21,363.33,366,0,366
1895,TSLA  ,2023-02-09,2024-06-21,366.67,4711,0,4711
1896,TSLA  ,2023-02-09,2024-06-21,370.0,3050,9,3059
1897,TSLA  ,2023-02-09,2024-06-21,373.33,556,0,556
1898,TSLA  ,2023-02-09,2024-06-21,376.67,816,0,816
1899,TSLA  ,2023-02-09,2024-06-21,380.0,683,1,684
1900,TSLA  ,2023-02-09,2024-06-21,383.33,1029,11,1040
1901,TSLA  ,2023-02-09,2024-06-21,386.67,310,5,315
1902,TSLA  ,2023-02-09,2024-06-21,390.0,449,1,450
1903,TSLA  ,2023-02-09,2024-06-21,393.33,884,1,885
1904,TSLA  ,2023-02-09,2024-06-21,396.67,720,0,720
1905,TSLA  ,2023-02-09,2024-06-21,400.0,38916,34,38950
1906,TSLA  ,2023-02-09,2024-06-21,416.67,3219,1,3220
1907,TSLA  ,2023-02-09,2024-06-21,433.33,3266,0,3266
1908,TSLA  ,2023-02-09,2024-06-21,450.0,3196,0,3196
1909,TSLA  ,2023-02-09,2024-06-21,466.67,5343,0,5343
1910,TSLA  ,2023-02-09,2024-06-21,483.33,1101,0,1101
1911,TSLA  ,2023-02-09,2024-06-21,500.0,10892,0,10892
1912,TSLA  ,2023-02-09,2024-06-21,516.67,2087,0,2087
1913,TSLA  ,2023-02-09,2024-06-21,533.33,3105,0,3105
1914,TSLA  ,2023-02-09,2024-06-21,550.0,2602,0,2602
1915,TSLA  ,2023-02-09,2024-06-21,566.67,1007,0,1007
1916,TSLA  ,2023-02-09,2024-06-21,583.33,1041,0,1041
1917,TSLA  ,2023-02-09,2024-06-21,600.0,17171,0,17171
1918,TSLA  ,2023-02-09,2024-06-21,616.67,14012,0,14012
1919,TSLA  ,2023-02-09,2024-06-21,633.33,4563,0,4563
1920,TSLA  ,2023-02-09,2024-06-21,650.0,605,0,605
1921,TSLA  ,2023-02-09,2024-06-21,666.67,6562,0,6562
1922,TSLA  ,2023-02-09,2024-06-21,683.33,1688,0,1688
1923,TSLA  ,2023-02-09,2024-06-21,700.0,3763,0,3763
1924,TSLA  ,2023-02-09,2024-06-21,716.67,890,0,890
1925,TSLA  ,2023-02-09,2024-06-21,733.33,2209,0,2209
1926,TSLA  ,2023-02-09,2024-06-21,750.0,6148,1,6149
1927,TSLA  ,2023-02-09,2024-06-21,758.33,13795,0,13795
1928,TSLA  ,2023-02-09,2024-09-20,50.0,44,908,952
1929,TSLA  ,2023-02-09,2024-09-20,55.0,29,53,82
1930,TSLA  ,2023-02-09,2024-09-20,60.0,10,156,166
1931,TSLA  ,2023-02-09,2024-09-20,65.0,32,69,101
1932,TSLA  ,2023-02-09,2024-09-20,70.0,11,134,145
1933,TSLA  ,2023-02-09,2024-09-20,75.0,10,2322,2332
1934,TSLA  ,2023-02-09,2024-09-20,80.0,63,152,215
1935,TSLA  ,2023-02-09,2024-09-20,85.0,986,454,1440
1936,TSLA  ,2023-02-09,2024-09-20,90.0,47,187,234
1937,TSLA  ,2023-02-09,2024-09-20,95.0,22,453,475
1938,TSLA  ,2023-02-09,2024-09-20,100.0,377,2209,2586
1939,TSLA  ,2023-02-09,2024-09-20,105.0,189,692,881
1940,TSLA  ,2023-02-09,2024-09-20,110.0,168,1013,1181
1941,TSLA  ,2023-02-09,2024-09-20,115.0,558,593,1151
1942,TSLA  ,2023-02-09,2024-09-20,120.0,738,550,1288
1943,TSLA  ,2023-02-09,2024-09-20,125.0,324,1198,1522
1944,TSLA  ,2023-02-09,2024-09-20,130.0,612,841,1453
1945,TSLA  ,2023-02-09,2024-09-20,135.0,598,286,884
1946,TSLA  ,2023-02-09,2024-09-20,140.0,1095,365,1460
1947,TSLA  ,2023-02-09,2024-09-20,145.0,1280,346,1626
1948,TSLA  ,2023-02-09,2024-09-20,150.0,1419,2726,4145
1949,TSLA  ,2023-02-09,2024-09-20,155.0,531,292,823
1950,TSLA  ,2023-02-09,2024-09-20,160.0,316,829,1145
1951,TSLA  ,2023-02-09,2024-09-20,165.0,253,110,363
1952,TSLA  ,2023-02-09,2024-09-20,170.0,191,239,430
1953,TSLA  ,2023-02-09,2024-09-20,175.0,221,136,357
1954,TSLA  ,2023-02-09,2024-09-20,180.0,741,85,826
1955,TSLA  ,2023-02-09,2024-09-20,185.0,829,962,1791
1956,TSLA  ,2023-02-09,2024-09-20,190.0,1486,93,1579
1957,TSLA  ,2023-02-09,2024-09-20,195.0,1408,117,1525
1958,TSLA  ,2023-02-09,2024-09-20,200.0,1744,1409,3153
1959,TSLA  ,2023-02-09,2024-09-20,210.0,749,262,1011
1960,TSLA  ,2023-02-09,2024-09-20,220.0,1479,406,1885
1961,TSLA  ,2023-02-09,2024-09-20,230.0,508,139,647
1962,TSLA  ,2023-02-09,2024-09-20,240.0,367,290,657
1963,TSLA  ,2023-02-09,2024-09-20,250.0,783,367,1150
1964,TSLA  ,2023-02-09,2024-09-20,260.0,901,100,1001
1965,TSLA  ,2023-02-09,2024-09-20,270.0,499,534,1033
1966,TSLA  ,2023-02-09,2024-09-20,280.0,326,496,822
1967,TSLA  ,2023-02-09,2024-09-20,290.0,454,2781,3235
1968,TSLA  ,2023-02-09,2024-09-20,300.0,1063,1142,2205
1969,TSLA  ,2023-02-09,2024-09-20,310.0,123,714,837
1970,TSLA  ,2023-02-09,2024-09-20,320.0,109,205,314
1971,TSLA  ,2023-02-09,2024-09-20,330.0,81,117,198
1972,TSLA  ,2023-02-09,2024-09-20,340.0,698,109,807
1973,TSLA  ,2023-02-09,2024-09-20,350.0,1413,109,1522
1974,TSLA  ,2023-02-09,2024-09-20,360.0,52,63,115
1975,TSLA  ,2023-02-09,2024-09-20,370.0,1,2,3
1976,TSLA  ,2023-02-09,2024-09-20,380.0,65,2,67
1977,TSLA  ,2023-02-09,2024-09-20,390.0,10,15,25
1978,TSLA  ,2023-02-09,2025-01-17,5.0,671,11167,11838
1979,TSLA  ,2023-02-09,2025-01-17,10.0,138,816,954
1980,TSLA  ,2023-02-09,2025-01-17,15.0,29,862,891
1981,TSLA  ,2023-02-09,2025-01-17,20.0,386,5798,6184
1982,TSLA  ,2023-02-09,2025-01-17,25.0,103,2462,2565
1983,TSLA  ,2023-02-09,2025-01-17,30.0,13816,16532,30348
1984,TSLA  ,2023-02-09,2025-01-17,35.0,266,1096,1362
1985,TSLA  ,2023-02-09,2025-01-17,40.0,14712,15779,30491
1986,TSLA  ,2023-02-09,2025-01-17,45.0,2979,3196,6175
1987,TSLA  ,2023-02-09,2025-01-17,50.0,2747,8768,11515
1988,TSLA  ,2023-02-09,2025-01-17,55.0,2004,4212,6216
1989,TSLA  ,2023-02-09,2025-01-17,60.0,590,2026,2616
1990,TSLA  ,2023-02-09,2025-01-17,65.0,1649,1576,3225
1991,TSLA  ,2023-02-09,2025-01-17,70.0,2486,2156,4642
1992,TSLA  ,2023-02-09,2025-01-17,75.0,184,4381,4565
1993,TSLA  ,2023-02-09,2025-01-17,80.0,1310,1844,3154
1994,TSLA  ,2023-02-09,2025-01-17,85.0,1827,1488,3315
1995,TSLA  ,2023-02-09,2025-01-17,90.0,1140,5550,6690
1996,TSLA  ,2023-02-09,2025-01-17,95.0,138,401,539
1997,TSLA  ,2023-02-09,2025-01-17,100.0,5448,17510,22958
1998,TSLA  ,2023-02-09,2025-01-17,105.0,312,1576,1888
1999,TSLA  ,2023-02-09,2025-01-17,110.0,5440,7163,12603
2000,TSLA  ,2023-02-09,2025-01-17,115.0,3623,3643,7266
2001,TSLA  ,2023-02-09,2025-01-17,120.0,8461,6153,14614
2002,TSLA  ,2023-02-09,2025-01-17,125.0,2155,1169,3324
2003,TSLA  ,2023-02-09,2025-01-17,130.0,5688,7172,12860
2004,TSLA  ,2023-02-09,2025-01-17,135.0,5699,695,6394
2005,TSLA  ,2023-02-09,2025-01-17,140.0,8548,4606,13154
2006,TSLA  ,2023-02-09,2025-01-17,145.0,766,683,1449
2007,TSLA  ,2023-02-09,2025-01-17,150.0,11847,11823,23670
2008,TSLA  ,2023-02-09,2025-01-17,155.0,236,470,706
2009,TSLA  ,2023-02-09,2025-01-17,160.0,4614,5543,10157
2010,TSLA  ,2023-02-09,2025-01-17,165.0,247,863,1110
2011,TSLA  ,2023-02-09,2025-01-17,170.0,35448,9665,45113
2012,TSLA  ,2023-02-09,2025-01-17,175.0,33514,4548,38062
2013,TSLA  ,2023-02-09,2025-01-17,180.0,4038,8242,12280
2014,TSLA  ,2023-02-09,2025-01-17,185.0,1327,4495,5822
2015,TSLA  ,2023-02-09,2025-01-17,190.0,5701,4829,10530
2016,TSLA  ,2023-02-09,2025-01-17,195.0,3233,1731,4964
2017,TSLA  ,2023-02-09,2025-01-17,200.0,28264,12455,40719
2018,TSLA  ,2023-02-09,2025-01-17,210.0,4910,2647,7557
2019,TSLA  ,2023-02-09,2025-01-17,220.0,3113,4180,7293
2020,TSLA  ,2023-02-09,2025-01-17,230.0,4078,3263,7341
2021,TSLA  ,2023-02-09,2025-01-17,240.0,4654,4368,9022
2022,TSLA  ,2023-02-09,2025-01-17,250.0,11603,5118,16721
2023,TSLA  ,2023-02-09,2025-01-17,260.0,5672,1777,7449
2024,TSLA  ,2023-02-09,2025-01-17,270.0,3050,1232,4282
2025,TSLA  ,2023-02-09,2025-01-17,280.0,2253,3360,5613
2026,TSLA  ,2023-02-09,2025-01-17,290.0,3440,2809,6249
2027,TSLA  ,2023-02-09,2025-01-17,300.0,31171,3111,34282
2028,TSLA  ,2023-02-09,2025-01-17,310.0,4401,693,5094
2029,TSLA  ,2023-02-09,2025-01-17,320.0,1732,793,2525
2030,TSLA  ,2023-02-09,2025-01-17,330.0,2398,949,3347
2031,TSLA  ,2023-02-09,2025-01-17,340.0,1264,411,1675
2032,TSLA  ,2023-02-09,2025-01-17,350.0,6949,566,7515
2033,TSLA  ,2023-02-09,2025-01-17,360.0,2014,168,2182
2034,TSLA  ,2023-02-09,2025-01-17,370.0,2076,287,2363
2035,TSLA  ,2023-02-09,2025-01-17,380.0,1547,46,1593
2036,TSLA  ,2023-02-09,2025-01-17,390.0,2082,64,2146
2037,TSLA  ,2023-02-09,2025-01-17,400.0,18854,101,18955
2038,TSLA  ,2023-02-09,2025-01-17,410.0,4197,2,4199
2039,TSLA  ,2023-02-09,2025-01-17,420.0,2905,8,2913
2040,TSLA  ,2023-02-09,2025-01-17,430.0,580,2,582
2041,TSLA  ,2023-02-09,2025-01-17,440.0,637,7,644
2042,TSLA  ,2023-02-09,2025-01-17,450.0,3599,3,3602
2043,TSLA  ,2023-02-09,2025-01-17,460.0,908,4,912
2044,TSLA  ,2023-02-09,2025-01-17,470.0,1556,1,1557
2045,TSLA  ,2023-02-09,2025-01-17,480.0,1247,1,1248
2046,TSLA  ,2023-02-09,2025-01-17,490.0,700,0,700
2047,TSLA  ,2023-02-09,2025-01-17,500.0,10872,2,10874
2048,TSLA  ,2023-02-09,2025-01-17,510.0,1149,1,1150
2049,TSLA  ,2023-02-09,2025-01-17,520.0,8335,1,8336
2050,TSLA  ,2023-02-09,2025-01-17,530.0,644,0,644
2051,TSLA  ,2023-02-09,2025-01-17,540.0,610,0,610
2052,TSLA  ,2023-02-09,2025-01-17,550.0,3074,0,3074
2053,TSLA  ,2023-02-09,2025-01-17,560.0,629,0,629
2054,TSLA  ,2023-02-09,2025-01-17,570.0,681,2,683
2055,TSLA  ,2023-02-09,2025-01-17,580.0,842,0,842
2056,TSLA  ,2023-02-09,2025-01-17,590.0,805,0,805
2057,TSLA  ,2023-02-09,2025-01-17,600.0,15238,0,15238
2058,TSLA  ,2023-02-09,2025-01-17,610.0,18185,0,18185
2059,TSLA  ,2023-02-09,2025-06-20,5.0,190,811,1001
2060,TSLA  ,2023-02-09,2025-06-20,10.0,3,85,88
2061,TSLA  ,2023-02-09,2025-06-20,15.0,7,4786,4793
2062,TSLA  ,2023-02-09,2025-06-20,20.0,48,362,410
2063,TSLA  ,2023-02-09,2025-06-20,25.0,9,117,126
2064,TSLA  ,2023-02-09,2025-06-20,30.0,83,230,313
2065,TSLA  ,2023-02-09,2025-06-20,35.0,11,177,188
2066,TSLA  ,2023-02-09,2025-06-20,40.0,9,287,296
2067,TSLA  ,2023-02-09,2025-06-20,45.0,16,52,68
2068,TSLA  ,2023-02-09,2025-06-20,50.0,141,610,751
2069,TSLA  ,2023-02-09,2025-06-20,55.0,10,43,53
2070,TSLA  ,2023-02-09,2025-06-20,60.0,16,617,633
2071,TSLA  ,2023-02-09,2025-06-20,65.0,19,573,592
2072,TSLA  ,2023-02-09,2025-06-20,70.0,160,124,284
2073,TSLA  ,2023-02-09,2025-06-20,75.0,119,1283,1402
2074,TSLA  ,2023-02-09,2025-06-20,80.0,804,434,1238
2075,TSLA  ,2023-02-09,2025-06-20,85.0,346,243,589
2076,TSLA  ,2023-02-09,2025-06-20,90.0,10297,433,10730
2077,TSLA  ,2023-02-09,2025-06-20,95.0,46407,535,46942
2078,TSLA  ,2023-02-09,2025-06-20,100.0,896,5178,6074
2079,TSLA  ,2023-02-09,2025-06-20,105.0,158,410,568
2080,TSLA  ,2023-02-09,2025-06-20,110.0,351,1607,1958
2081,TSLA  ,2023-02-09,2025-06-20,115.0,435,278,713
2082,TSLA  ,2023-02-09,2025-06-20,120.0,494,948,1442
2083,TSLA  ,2023-02-09,2025-06-20,125.0,508,361,869
2084,TSLA  ,2023-02-09,2025-06-20,130.0,2631,2022,4653
2085,TSLA  ,2023-02-09,2025-06-20,135.0,4714,159,4873
2086,TSLA  ,2023-02-09,2025-06-20,140.0,991,2278,3269
2087,TSLA  ,2023-02-09,2025-06-20,145.0,398,480,878
2088,TSLA  ,2023-02-09,2025-06-20,150.0,1344,1297,2641
2089,TSLA  ,2023-02-09,2025-06-20,155.0,409,133,542
2090,TSLA  ,2023-02-09,2025-06-20,160.0,2121,1133,3254
2091,TSLA  ,2023-02-09,2025-06-20,165.0,921,339,1260
2092,TSLA  ,2023-02-09,2025-06-20,170.0,2791,1429,4220
2093,TSLA  ,2023-02-09,2025-06-20,175.0,729,1080,1809
2094,TSLA  ,2023-02-09,2025-06-20,180.0,617,1100,1717
2095,TSLA  ,2023-02-09,2025-06-20,185.0,2452,165,2617
2096,TSLA  ,2023-02-09,2025-06-20,190.0,452,237,689
2097,TSLA  ,2023-02-09,2025-06-20,195.0,293,323,616
2098,TSLA  ,2023-02-09,2025-06-20,200.0,3746,3239,6985
2099,TSLA  ,2023-02-09,2025-06-20,205.0,170,211,381
2100,TSLA  ,2023-02-09,2025-06-20,210.0,320,40,360
2101,TSLA  ,2023-02-09,2025-06-20,215.0,88,27,115
2102,TSLA  ,2023-02-09,2025-06-20,220.0,664,81,745
2103,TSLA  ,2023-02-09,2025-06-20,225.0,434,183,617
2104,TSLA  ,2023-02-09,2025-06-20,230.0,398,45,443
2105,TSLA  ,2023-02-09,2025-06-20,235.0,322,203,525
2106,TSLA  ,2023-02-09,2025-06-20,240.0,4428,274,4702
2107,TSLA  ,2023-02-09,2025-06-20,250.0,1332,521,1853
2108,TSLA  ,2023-02-09,2025-06-20,260.0,362,314,676
2109,TSLA  ,2023-02-09,2025-06-20,270.0,485,102,587
2110,TSLA  ,2023-02-09,2025-06-20,280.0,186,187,373
2111,TSLA  ,2023-02-09,2025-06-20,290.0,218,188,406
2112,TSLA  ,2023-02-09,2025-06-20,300.0,2500,582,3082
2113,TSLA  ,2023-02-09,2025-06-20,310.0,142,179,321
2114,TSLA  ,2023-02-09,2025-06-20,320.0,892,290,1182
2115,TSLA  ,2023-02-09,2025-06-20,330.0,169,186,355
2116,TSLA  ,2023-02-09,2025-06-20,340.0,98,106,204
2117,TSLA  ,2023-02-09,2025-06-20,350.0,1749,190,1939
2118,TSLA  ,2023-02-09,2025-06-20,360.0,655,196,851
2119,TSLA  ,2023-02-09,2025-06-20,370.0,29,151,180
2120,TSLA  ,2023-02-09,2025-06-20,380.0,29,1,30
2121,TSLA  ,2023-02-09,2025-06-20,390.0,911,8,919
