index,ProductSymbol,DateGen,ExpDate,Strike,Call,Put,TotalOI
0,TSLA  ,2023-02-08,2023-02-10,15.0,21,165,186
1,TSLA  ,2023-02-08,2023-02-10,20.0,19,1,20
2,TSLA  ,2023-02-08,2023-02-10,25.0,1,250,251
3,TSLA  ,2023-02-08,2023-02-10,30.0,7,1498,1505
4,TSLA  ,2023-02-08,2023-02-10,35.0,2,1462,1464
5,TSLA  ,2023-02-08,2023-02-10,40.0,2,934,936
6,TSLA  ,2023-02-08,2023-02-10,45.0,1,1869,1870
7,TSLA  ,2023-02-08,2023-02-10,50.0,78,2204,2282
8,TSLA  ,2023-02-08,2023-02-10,55.0,3,1158,1161
9,TSLA  ,2023-02-08,2023-02-10,60.0,10,2416,2426
10,TSLA  ,2023-02-08,2023-02-10,65.0,5,1705,1710
11,TSLA  ,2023-02-08,2023-02-10,70.0,14,1611,1625
12,TSLA  ,2023-02-08,2023-02-10,75.0,5,657,662
13,TSLA  ,2023-02-08,2023-02-10,80.0,69,1922,1991
14,TSLA  ,2023-02-08,2023-02-10,85.0,24,1032,1056
15,TSLA  ,2023-02-08,2023-02-10,90.0,59,1793,1852
16,TSLA  ,2023-02-08,2023-02-10,95.0,34,1371,1405
17,TSLA  ,2023-02-08,2023-02-10,98.0,42,710,752
18,TSLA  ,2023-02-08,2023-02-10,99.0,36,1228,1264
19,TSLA  ,2023-02-08,2023-02-10,100.0,165,3134,3299
20,TSLA  ,2023-02-08,2023-02-10,101.0,106,1909,2015
21,TSLA  ,2023-02-08,2023-02-10,102.0,51,513,564
22,TSLA  ,2023-02-08,2023-02-10,103.0,62,997,1059
23,TSLA  ,2023-02-08,2023-02-10,104.0,63,864,927
24,TSLA  ,2023-02-08,2023-02-10,105.0,157,3327,3484
25,TSLA  ,2023-02-08,2023-02-10,106.0,27,1778,1805
26,TSLA  ,2023-02-08,2023-02-10,107.0,54,1827,1881
27,TSLA  ,2023-02-08,2023-02-10,108.0,75,1531,1606
28,TSLA  ,2023-02-08,2023-02-10,109.0,96,1131,1227
29,TSLA  ,2023-02-08,2023-02-10,110.0,536,2354,2890
30,TSLA  ,2023-02-08,2023-02-10,111.0,102,383,485
31,TSLA  ,2023-02-08,2023-02-10,112.0,43,2474,2517
32,TSLA  ,2023-02-08,2023-02-10,113.0,176,1096,1272
33,TSLA  ,2023-02-08,2023-02-10,114.0,142,6026,6168
34,TSLA  ,2023-02-08,2023-02-10,115.0,274,2698,2972
35,TSLA  ,2023-02-08,2023-02-10,116.0,104,1084,1188
36,TSLA  ,2023-02-08,2023-02-10,117.0,175,1609,1784
37,TSLA  ,2023-02-08,2023-02-10,118.0,181,2836,3017
38,TSLA  ,2023-02-08,2023-02-10,119.0,146,816,962
39,TSLA  ,2023-02-08,2023-02-10,120.0,727,5087,5814
40,TSLA  ,2023-02-08,2023-02-10,121.0,244,1777,2021
41,TSLA  ,2023-02-08,2023-02-10,122.0,694,1223,1917
42,TSLA  ,2023-02-08,2023-02-10,123.0,271,1633,1904
43,TSLA  ,2023-02-08,2023-02-10,124.0,328,1549,1877
44,TSLA  ,2023-02-08,2023-02-10,125.0,863,4593,5456
45,TSLA  ,2023-02-08,2023-02-10,126.0,235,1114,1349
46,TSLA  ,2023-02-08,2023-02-10,127.0,380,1897,2277
47,TSLA  ,2023-02-08,2023-02-10,128.0,1144,1361,2505
48,TSLA  ,2023-02-08,2023-02-10,129.0,589,3360,3949
49,TSLA  ,2023-02-08,2023-02-10,130.0,1487,6711,8198
50,TSLA  ,2023-02-08,2023-02-10,131.0,544,2479,3023
51,TSLA  ,2023-02-08,2023-02-10,132.0,658,2049,2707
52,TSLA  ,2023-02-08,2023-02-10,133.0,751,949,1700
53,TSLA  ,2023-02-08,2023-02-10,134.0,320,4132,4452
54,TSLA  ,2023-02-08,2023-02-10,135.0,1557,5666,7223
55,TSLA  ,2023-02-08,2023-02-10,136.0,396,2884,3280
56,TSLA  ,2023-02-08,2023-02-10,137.0,614,2568,3182
57,TSLA  ,2023-02-08,2023-02-10,138.0,805,5320,6125
58,TSLA  ,2023-02-08,2023-02-10,139.0,990,6303,7293
59,TSLA  ,2023-02-08,2023-02-10,140.0,2785,8085,10870
60,TSLA  ,2023-02-08,2023-02-10,141.0,737,1602,2339
61,TSLA  ,2023-02-08,2023-02-10,142.0,1286,3738,5024
62,TSLA  ,2023-02-08,2023-02-10,143.0,586,584,1170
63,TSLA  ,2023-02-08,2023-02-10,144.0,376,1287,1663
64,TSLA  ,2023-02-08,2023-02-10,145.0,3031,12986,16017
65,TSLA  ,2023-02-08,2023-02-10,146.0,896,1512,2408
66,TSLA  ,2023-02-08,2023-02-10,147.0,1013,3225,4238
67,TSLA  ,2023-02-08,2023-02-10,148.0,419,1871,2290
68,TSLA  ,2023-02-08,2023-02-10,149.0,322,2160,2482
69,TSLA  ,2023-02-08,2023-02-10,150.0,3986,12694,16680
70,TSLA  ,2023-02-08,2023-02-10,152.5,574,3770,4344
71,TSLA  ,2023-02-08,2023-02-10,155.0,6324,7205,13529
72,TSLA  ,2023-02-08,2023-02-10,157.5,1191,4638,5829
73,TSLA  ,2023-02-08,2023-02-10,160.0,3752,12287,16039
74,TSLA  ,2023-02-08,2023-02-10,162.5,1125,2817,3942
75,TSLA  ,2023-02-08,2023-02-10,165.0,4754,14195,18949
76,TSLA  ,2023-02-08,2023-02-10,167.5,1367,4147,5514
77,TSLA  ,2023-02-08,2023-02-10,170.0,6181,15891,22072
78,TSLA  ,2023-02-08,2023-02-10,172.5,2548,7069,9617
79,TSLA  ,2023-02-08,2023-02-10,175.0,5937,14065,20002
80,TSLA  ,2023-02-08,2023-02-10,177.5,2437,6735,9172
81,TSLA  ,2023-02-08,2023-02-10,180.0,10482,18013,28495
82,TSLA  ,2023-02-08,2023-02-10,182.5,2584,7015,9599
83,TSLA  ,2023-02-08,2023-02-10,185.0,11251,15836,27087
84,TSLA  ,2023-02-08,2023-02-10,187.5,2632,8554,11186
85,TSLA  ,2023-02-08,2023-02-10,190.0,14882,15009,29891
86,TSLA  ,2023-02-08,2023-02-10,192.5,5569,5793,11362
87,TSLA  ,2023-02-08,2023-02-10,195.0,17713,11714,29427
88,TSLA  ,2023-02-08,2023-02-10,197.5,10476,2675,13151
89,TSLA  ,2023-02-08,2023-02-10,200.0,38830,12640,51470
90,TSLA  ,2023-02-08,2023-02-10,202.5,7717,1940,9657
91,TSLA  ,2023-02-08,2023-02-10,205.0,15711,2333,18044
92,TSLA  ,2023-02-08,2023-02-10,207.5,5038,1275,6313
93,TSLA  ,2023-02-08,2023-02-10,210.0,22429,2357,24786
94,TSLA  ,2023-02-08,2023-02-10,212.5,4453,1001,5454
95,TSLA  ,2023-02-08,2023-02-10,215.0,12285,1686,13971
96,TSLA  ,2023-02-08,2023-02-10,217.5,5769,474,6243
97,TSLA  ,2023-02-08,2023-02-10,220.0,20119,2014,22133
98,TSLA  ,2023-02-08,2023-02-10,222.5,4756,226,4982
99,TSLA  ,2023-02-08,2023-02-10,225.0,11018,304,11322
100,TSLA  ,2023-02-08,2023-02-10,227.5,3586,212,3798
101,TSLA  ,2023-02-08,2023-02-10,230.0,23539,694,24233
102,TSLA  ,2023-02-08,2023-02-10,232.5,3969,124,4093
103,TSLA  ,2023-02-08,2023-02-10,235.0,11119,250,11369
104,TSLA  ,2023-02-08,2023-02-10,237.5,1971,109,2080
105,TSLA  ,2023-02-08,2023-02-10,240.0,9089,237,9326
106,TSLA  ,2023-02-08,2023-02-10,242.5,2775,45,2820
107,TSLA  ,2023-02-08,2023-02-10,245.0,7186,63,7249
108,TSLA  ,2023-02-08,2023-02-10,247.5,4826,12,4838
109,TSLA  ,2023-02-08,2023-02-10,250.0,15736,35,15771
110,TSLA  ,2023-02-08,2023-02-10,252.5,1295,7,1302
111,TSLA  ,2023-02-08,2023-02-10,255.0,6268,10,6278
112,TSLA  ,2023-02-08,2023-02-10,257.5,1395,0,1395
113,TSLA  ,2023-02-08,2023-02-10,260.0,9155,0,9155
114,TSLA  ,2023-02-08,2023-02-10,265.0,7428,10,7438
115,TSLA  ,2023-02-08,2023-02-10,270.0,9530,0,9530
116,TSLA  ,2023-02-08,2023-02-10,275.0,7966,0,7966
117,TSLA  ,2023-02-08,2023-02-10,280.0,8388,0,8388
118,TSLA  ,2023-02-08,2023-02-10,285.0,12311,0,12311
119,TSLA  ,2023-02-08,2023-02-10,290.0,4382,20,4402
120,TSLA  ,2023-02-08,2023-02-10,295.0,3496,0,3496
121,TSLA  ,2023-02-08,2023-02-10,300.0,3070,0,3070
122,TSLA  ,2023-02-08,2023-02-10,310.0,1709,0,1709
123,TSLA  ,2023-02-08,2023-02-10,320.0,1522,0,1522
124,TSLA  ,2023-02-08,2023-02-10,330.0,1239,0,1239
125,TSLA  ,2023-02-08,2023-02-10,340.0,1341,0,1341
126,TSLA  ,2023-02-08,2023-02-10,350.0,2083,0,2083
127,TSLA  ,2023-02-08,2023-02-10,360.0,3222,0,3222
128,TSLA  ,2023-02-08,2023-02-17,15.0,172,304,476
129,TSLA  ,2023-02-08,2023-02-17,20.0,34,41,75
130,TSLA  ,2023-02-08,2023-02-17,25.0,4,99,103
131,TSLA  ,2023-02-08,2023-02-17,30.0,71,2723,2794
132,TSLA  ,2023-02-08,2023-02-17,35.0,0,5413,5413
133,TSLA  ,2023-02-08,2023-02-17,40.0,160,10375,10535
134,TSLA  ,2023-02-08,2023-02-17,45.0,0,1739,1739
135,TSLA  ,2023-02-08,2023-02-17,50.0,940,17136,18076
136,TSLA  ,2023-02-08,2023-02-17,55.0,41,5311,5352
137,TSLA  ,2023-02-08,2023-02-17,60.0,489,9040,9529
138,TSLA  ,2023-02-08,2023-02-17,65.0,28,6535,6563
139,TSLA  ,2023-02-08,2023-02-17,70.0,74,53619,53693
140,TSLA  ,2023-02-08,2023-02-17,75.0,128,7661,7789
141,TSLA  ,2023-02-08,2023-02-17,80.0,205,22101,22306
142,TSLA  ,2023-02-08,2023-02-17,85.0,259,13172,13431
143,TSLA  ,2023-02-08,2023-02-17,90.0,285,16879,17164
144,TSLA  ,2023-02-08,2023-02-17,95.0,821,17708,18529
145,TSLA  ,2023-02-08,2023-02-17,100.0,3352,36297,39649
146,TSLA  ,2023-02-08,2023-02-17,105.0,20745,29303,50048
147,TSLA  ,2023-02-08,2023-02-17,110.0,3511,25534,29045
148,TSLA  ,2023-02-08,2023-02-17,115.0,15414,23905,39319
149,TSLA  ,2023-02-08,2023-02-17,118.0,265,1600,1865
150,TSLA  ,2023-02-08,2023-02-17,119.0,13,1379,1392
151,TSLA  ,2023-02-08,2023-02-17,120.0,26426,48768,75194
152,TSLA  ,2023-02-08,2023-02-17,121.0,30,1017,1047
153,TSLA  ,2023-02-08,2023-02-17,122.0,184,1327,1511
154,TSLA  ,2023-02-08,2023-02-17,123.0,97,1451,1548
155,TSLA  ,2023-02-08,2023-02-17,124.0,31,1169,1200
156,TSLA  ,2023-02-08,2023-02-17,125.0,12250,16186,28436
157,TSLA  ,2023-02-08,2023-02-17,126.0,45,1118,1163
158,TSLA  ,2023-02-08,2023-02-17,127.0,50,1219,1269
159,TSLA  ,2023-02-08,2023-02-17,128.0,50,2270,2320
160,TSLA  ,2023-02-08,2023-02-17,129.0,93,1618,1711
161,TSLA  ,2023-02-08,2023-02-17,130.0,13520,14751,28271
162,TSLA  ,2023-02-08,2023-02-17,131.0,150,1226,1376
163,TSLA  ,2023-02-08,2023-02-17,132.0,224,1237,1461
164,TSLA  ,2023-02-08,2023-02-17,133.0,67,1235,1302
165,TSLA  ,2023-02-08,2023-02-17,134.0,361,1011,1372
166,TSLA  ,2023-02-08,2023-02-17,135.0,7766,10846,18612
167,TSLA  ,2023-02-08,2023-02-17,136.0,1421,3159,4580
168,TSLA  ,2023-02-08,2023-02-17,137.0,871,1565,2436
169,TSLA  ,2023-02-08,2023-02-17,138.0,668,1273,1941
170,TSLA  ,2023-02-08,2023-02-17,139.0,911,1021,1932
171,TSLA  ,2023-02-08,2023-02-17,140.0,8086,16071,24157
172,TSLA  ,2023-02-08,2023-02-17,141.0,332,1851,2183
173,TSLA  ,2023-02-08,2023-02-17,142.0,915,1559,2474
174,TSLA  ,2023-02-08,2023-02-17,143.0,276,1281,1557
175,TSLA  ,2023-02-08,2023-02-17,144.0,294,1094,1388
176,TSLA  ,2023-02-08,2023-02-17,145.0,11788,23451,35239
177,TSLA  ,2023-02-08,2023-02-17,146.0,1748,1395,3143
178,TSLA  ,2023-02-08,2023-02-17,147.0,520,4416,4936
179,TSLA  ,2023-02-08,2023-02-17,148.0,242,2085,2327
180,TSLA  ,2023-02-08,2023-02-17,149.0,463,1548,2011
181,TSLA  ,2023-02-08,2023-02-17,150.0,15599,25119,40718
182,TSLA  ,2023-02-08,2023-02-17,152.5,1098,2451,3549
183,TSLA  ,2023-02-08,2023-02-17,155.0,10438,8508,18946
184,TSLA  ,2023-02-08,2023-02-17,157.5,1492,3684,5176
185,TSLA  ,2023-02-08,2023-02-17,160.0,29383,18633,48016
186,TSLA  ,2023-02-08,2023-02-17,162.5,1377,4361,5738
187,TSLA  ,2023-02-08,2023-02-17,165.0,12593,11532,24125
188,TSLA  ,2023-02-08,2023-02-17,167.5,1029,3648,4677
189,TSLA  ,2023-02-08,2023-02-17,170.0,19372,16241,35613
190,TSLA  ,2023-02-08,2023-02-17,172.5,2220,5462,7682
191,TSLA  ,2023-02-08,2023-02-17,175.0,10454,9757,20211
192,TSLA  ,2023-02-08,2023-02-17,177.5,2368,2568,4936
193,TSLA  ,2023-02-08,2023-02-17,180.0,16152,16756,32908
194,TSLA  ,2023-02-08,2023-02-17,182.5,4746,3118,7864
195,TSLA  ,2023-02-08,2023-02-17,185.0,16998,6656,23654
196,TSLA  ,2023-02-08,2023-02-17,187.5,2485,2311,4796
197,TSLA  ,2023-02-08,2023-02-17,190.0,15493,12151,27644
198,TSLA  ,2023-02-08,2023-02-17,192.5,3783,2282,6065
199,TSLA  ,2023-02-08,2023-02-17,195.0,8723,6624,15347
200,TSLA  ,2023-02-08,2023-02-17,197.5,5922,2289,8211
201,TSLA  ,2023-02-08,2023-02-17,200.0,42519,5556,48075
202,TSLA  ,2023-02-08,2023-02-17,202.5,5361,748,6109
203,TSLA  ,2023-02-08,2023-02-17,205.0,7415,1656,9071
204,TSLA  ,2023-02-08,2023-02-17,207.5,965,214,1179
205,TSLA  ,2023-02-08,2023-02-17,210.0,17482,2025,19507
206,TSLA  ,2023-02-08,2023-02-17,212.5,1145,123,1268
207,TSLA  ,2023-02-08,2023-02-17,215.0,13203,1838,15041
208,TSLA  ,2023-02-08,2023-02-17,217.5,847,76,923
209,TSLA  ,2023-02-08,2023-02-17,220.0,32446,1089,33535
210,TSLA  ,2023-02-08,2023-02-17,222.5,881,41,922
211,TSLA  ,2023-02-08,2023-02-17,225.0,9108,531,9639
212,TSLA  ,2023-02-08,2023-02-17,230.0,9455,683,10138
213,TSLA  ,2023-02-08,2023-02-17,235.0,4920,154,5074
214,TSLA  ,2023-02-08,2023-02-17,240.0,6179,78,6257
215,TSLA  ,2023-02-08,2023-02-17,245.0,2408,81,2489
216,TSLA  ,2023-02-08,2023-02-17,250.0,23829,78,23907
217,TSLA  ,2023-02-08,2023-02-17,255.0,9242,23,9265
218,TSLA  ,2023-02-08,2023-02-17,260.0,5775,117,5892
219,TSLA  ,2023-02-08,2023-02-17,265.0,5441,58,5499
220,TSLA  ,2023-02-08,2023-02-17,270.0,6735,64,6799
221,TSLA  ,2023-02-08,2023-02-17,275.0,6018,9,6027
222,TSLA  ,2023-02-08,2023-02-17,280.0,5758,15,5773
223,TSLA  ,2023-02-08,2023-02-17,285.0,7477,0,7477
224,TSLA  ,2023-02-08,2023-02-17,290.0,7027,0,7027
225,TSLA  ,2023-02-08,2023-02-17,295.0,1399,2,1401
226,TSLA  ,2023-02-08,2023-02-17,300.0,6866,11,6877
227,TSLA  ,2023-02-08,2023-02-17,305.0,1661,20,1681
228,TSLA  ,2023-02-08,2023-02-17,310.0,2017,0,2017
229,TSLA  ,2023-02-08,2023-02-17,315.0,1649,0,1649
230,TSLA  ,2023-02-08,2023-02-17,320.0,8483,2,8485
231,TSLA  ,2023-02-08,2023-02-17,325.0,1973,0,1973
232,TSLA  ,2023-02-08,2023-02-17,330.0,1132,0,1132
233,TSLA  ,2023-02-08,2023-02-17,335.0,3826,0,3826
234,TSLA  ,2023-02-08,2023-02-17,340.0,2423,0,2423
235,TSLA  ,2023-02-08,2023-02-17,345.0,2713,0,2713
236,TSLA  ,2023-02-08,2023-02-17,350.0,3857,0,3857
237,TSLA  ,2023-02-08,2023-02-17,355.0,936,0,936
238,TSLA  ,2023-02-08,2023-02-17,360.0,1814,0,1814
239,TSLA  ,2023-02-08,2023-02-17,365.0,1952,0,1952
240,TSLA  ,2023-02-08,2023-02-17,370.0,1366,0,1366
241,TSLA  ,2023-02-08,2023-02-17,375.0,4416,0,4416
242,TSLA  ,2023-02-08,2023-02-17,380.0,1880,0,1880
243,TSLA  ,2023-02-08,2023-02-17,385.0,862,0,862
244,TSLA  ,2023-02-08,2023-02-17,390.0,1205,0,1205
245,TSLA  ,2023-02-08,2023-02-17,395.0,1743,0,1743
246,TSLA  ,2023-02-08,2023-02-17,400.0,4041,0,4041
247,TSLA  ,2023-02-08,2023-02-17,405.0,559,0,559
248,TSLA  ,2023-02-08,2023-02-17,410.0,649,0,649
249,TSLA  ,2023-02-08,2023-02-17,415.0,753,0,753
250,TSLA  ,2023-02-08,2023-02-17,420.0,792,0,792
251,TSLA  ,2023-02-08,2023-02-17,425.0,561,0,561
252,TSLA  ,2023-02-08,2023-02-17,430.0,728,0,728
253,TSLA  ,2023-02-08,2023-02-17,435.0,358,0,358
254,TSLA  ,2023-02-08,2023-02-17,440.0,821,0,821
255,TSLA  ,2023-02-08,2023-02-17,445.0,235,0,235
256,TSLA  ,2023-02-08,2023-02-17,450.0,753,0,753
257,TSLA  ,2023-02-08,2023-02-17,455.0,1720,0,1720
258,TSLA  ,2023-02-08,2023-02-17,460.0,349,0,349
259,TSLA  ,2023-02-08,2023-02-17,465.0,1039,0,1039
260,TSLA  ,2023-02-08,2023-02-17,470.0,1342,0,1342
261,TSLA  ,2023-02-08,2023-02-17,475.0,593,0,593
262,TSLA  ,2023-02-08,2023-02-17,480.0,347,0,347
263,TSLA  ,2023-02-08,2023-02-17,485.0,689,0,689
264,TSLA  ,2023-02-08,2023-02-17,490.0,242,0,242
265,TSLA  ,2023-02-08,2023-02-17,495.0,400,0,400
266,TSLA  ,2023-02-08,2023-02-17,500.0,1989,0,1989
267,TSLA  ,2023-02-08,2023-02-17,505.0,357,0,357
268,TSLA  ,2023-02-08,2023-02-17,510.0,356,0,356
269,TSLA  ,2023-02-08,2023-02-17,515.0,58,0,58
270,TSLA  ,2023-02-08,2023-02-17,520.0,327,0,327
271,TSLA  ,2023-02-08,2023-02-17,525.0,150,0,150
272,TSLA  ,2023-02-08,2023-02-17,530.0,391,0,391
273,TSLA  ,2023-02-08,2023-02-17,535.0,171,0,171
274,TSLA  ,2023-02-08,2023-02-17,540.0,219,0,219
275,TSLA  ,2023-02-08,2023-02-17,545.0,110,0,110
276,TSLA  ,2023-02-08,2023-02-17,550.0,789,0,789
277,TSLA  ,2023-02-08,2023-02-17,555.0,837,0,837
278,TSLA  ,2023-02-08,2023-02-17,560.0,573,0,573
279,TSLA  ,2023-02-08,2023-02-17,565.0,661,0,661
280,TSLA  ,2023-02-08,2023-02-17,570.0,317,0,317
281,TSLA  ,2023-02-08,2023-02-17,575.0,278,0,278
282,TSLA  ,2023-02-08,2023-02-17,580.0,1203,0,1203
283,TSLA  ,2023-02-08,2023-02-17,585.0,955,0,955
284,TSLA  ,2023-02-08,2023-02-17,590.0,297,0,297
285,TSLA  ,2023-02-08,2023-02-17,595.0,2000,0,2000
286,TSLA  ,2023-02-08,2023-02-17,600.0,2677,0,2677
287,TSLA  ,2023-02-08,2023-02-24,15.0,3,8,11
288,TSLA  ,2023-02-08,2023-02-24,20.0,3,1,4
289,TSLA  ,2023-02-08,2023-02-24,25.0,3,3,6
290,TSLA  ,2023-02-08,2023-02-24,30.0,3,748,751
291,TSLA  ,2023-02-08,2023-02-24,35.0,0,20,20
292,TSLA  ,2023-02-08,2023-02-24,40.0,0,439,439
293,TSLA  ,2023-02-08,2023-02-24,45.0,0,2016,2016
294,TSLA  ,2023-02-08,2023-02-24,50.0,0,1898,1898
295,TSLA  ,2023-02-08,2023-02-24,55.0,3,805,808
296,TSLA  ,2023-02-08,2023-02-24,60.0,11,1451,1462
297,TSLA  ,2023-02-08,2023-02-24,65.0,6,697,703
298,TSLA  ,2023-02-08,2023-02-24,70.0,6,545,551
299,TSLA  ,2023-02-08,2023-02-24,75.0,1,823,824
300,TSLA  ,2023-02-08,2023-02-24,80.0,8,920,928
301,TSLA  ,2023-02-08,2023-02-24,85.0,1,637,638
302,TSLA  ,2023-02-08,2023-02-24,90.0,44,1411,1455
303,TSLA  ,2023-02-08,2023-02-24,95.0,19,1826,1845
304,TSLA  ,2023-02-08,2023-02-24,98.0,14,342,356
305,TSLA  ,2023-02-08,2023-02-24,99.0,10,630,640
306,TSLA  ,2023-02-08,2023-02-24,100.0,81,2559,2640
307,TSLA  ,2023-02-08,2023-02-24,101.0,14,336,350
308,TSLA  ,2023-02-08,2023-02-24,102.0,3,243,246
309,TSLA  ,2023-02-08,2023-02-24,103.0,7,129,136
310,TSLA  ,2023-02-08,2023-02-24,104.0,16,336,352
311,TSLA  ,2023-02-08,2023-02-24,105.0,45,1950,1995
312,TSLA  ,2023-02-08,2023-02-24,106.0,15,517,532
313,TSLA  ,2023-02-08,2023-02-24,107.0,8,656,664
314,TSLA  ,2023-02-08,2023-02-24,108.0,9,405,414
315,TSLA  ,2023-02-08,2023-02-24,109.0,9,234,243
316,TSLA  ,2023-02-08,2023-02-24,110.0,317,1624,1941
317,TSLA  ,2023-02-08,2023-02-24,111.0,41,449,490
318,TSLA  ,2023-02-08,2023-02-24,112.0,51,448,499
319,TSLA  ,2023-02-08,2023-02-24,113.0,46,567,613
320,TSLA  ,2023-02-08,2023-02-24,114.0,379,771,1150
321,TSLA  ,2023-02-08,2023-02-24,115.0,380,1105,1485
322,TSLA  ,2023-02-08,2023-02-24,116.0,322,491,813
323,TSLA  ,2023-02-08,2023-02-24,117.0,277,279,556
324,TSLA  ,2023-02-08,2023-02-24,118.0,187,482,669
325,TSLA  ,2023-02-08,2023-02-24,119.0,207,599,806
326,TSLA  ,2023-02-08,2023-02-24,120.0,436,2407,2843
327,TSLA  ,2023-02-08,2023-02-24,121.0,312,835,1147
328,TSLA  ,2023-02-08,2023-02-24,122.0,299,2537,2836
329,TSLA  ,2023-02-08,2023-02-24,123.0,443,546,989
330,TSLA  ,2023-02-08,2023-02-24,124.0,157,257,414
331,TSLA  ,2023-02-08,2023-02-24,125.0,525,2306,2831
332,TSLA  ,2023-02-08,2023-02-24,126.0,171,474,645
333,TSLA  ,2023-02-08,2023-02-24,127.0,86,389,475
334,TSLA  ,2023-02-08,2023-02-24,128.0,215,648,863
335,TSLA  ,2023-02-08,2023-02-24,129.0,237,960,1197
336,TSLA  ,2023-02-08,2023-02-24,130.0,2603,2382,4985
337,TSLA  ,2023-02-08,2023-02-24,131.0,408,143,551
338,TSLA  ,2023-02-08,2023-02-24,132.0,262,764,1026
339,TSLA  ,2023-02-08,2023-02-24,133.0,143,408,551
340,TSLA  ,2023-02-08,2023-02-24,134.0,275,676,951
341,TSLA  ,2023-02-08,2023-02-24,135.0,1925,1527,3452
342,TSLA  ,2023-02-08,2023-02-24,136.0,81,450,531
343,TSLA  ,2023-02-08,2023-02-24,137.0,65,336,401
344,TSLA  ,2023-02-08,2023-02-24,138.0,67,460,527
345,TSLA  ,2023-02-08,2023-02-24,139.0,473,254,727
346,TSLA  ,2023-02-08,2023-02-24,140.0,1711,1949,3660
347,TSLA  ,2023-02-08,2023-02-24,141.0,362,696,1058
348,TSLA  ,2023-02-08,2023-02-24,142.0,392,625,1017
349,TSLA  ,2023-02-08,2023-02-24,143.0,82,236,318
350,TSLA  ,2023-02-08,2023-02-24,144.0,65,283,348
351,TSLA  ,2023-02-08,2023-02-24,145.0,1600,4784,6384
352,TSLA  ,2023-02-08,2023-02-24,146.0,26,527,553
353,TSLA  ,2023-02-08,2023-02-24,147.0,42,279,321
354,TSLA  ,2023-02-08,2023-02-24,148.0,133,192,325
355,TSLA  ,2023-02-08,2023-02-24,149.0,99,1046,1145
356,TSLA  ,2023-02-08,2023-02-24,150.0,2544,5098,7642
357,TSLA  ,2023-02-08,2023-02-24,152.5,90,1239,1329
358,TSLA  ,2023-02-08,2023-02-24,155.0,1632,5610,7242
359,TSLA  ,2023-02-08,2023-02-24,157.5,643,563,1206
360,TSLA  ,2023-02-08,2023-02-24,160.0,2929,2479,5408
361,TSLA  ,2023-02-08,2023-02-24,162.5,409,430,839
362,TSLA  ,2023-02-08,2023-02-24,165.0,2434,1347,3781
363,TSLA  ,2023-02-08,2023-02-24,167.5,986,888,1874
364,TSLA  ,2023-02-08,2023-02-24,170.0,2826,2139,4965
365,TSLA  ,2023-02-08,2023-02-24,172.5,567,332,899
366,TSLA  ,2023-02-08,2023-02-24,175.0,2705,1415,4120
367,TSLA  ,2023-02-08,2023-02-24,177.5,392,2256,2648
368,TSLA  ,2023-02-08,2023-02-24,180.0,2774,2522,5296
369,TSLA  ,2023-02-08,2023-02-24,182.5,475,509,984
370,TSLA  ,2023-02-08,2023-02-24,185.0,1299,2012,3311
371,TSLA  ,2023-02-08,2023-02-24,187.5,443,952,1395
372,TSLA  ,2023-02-08,2023-02-24,190.0,1953,2506,4459
373,TSLA  ,2023-02-08,2023-02-24,192.5,1095,1170,2265
374,TSLA  ,2023-02-08,2023-02-24,195.0,2150,1135,3285
375,TSLA  ,2023-02-08,2023-02-24,197.5,1616,1083,2699
376,TSLA  ,2023-02-08,2023-02-24,200.0,6508,1178,7686
377,TSLA  ,2023-02-08,2023-02-24,202.5,315,259,574
378,TSLA  ,2023-02-08,2023-02-24,205.0,2089,269,2358
379,TSLA  ,2023-02-08,2023-02-24,207.5,325,255,580
380,TSLA  ,2023-02-08,2023-02-24,210.0,3773,198,3971
381,TSLA  ,2023-02-08,2023-02-24,212.5,575,43,618
382,TSLA  ,2023-02-08,2023-02-24,215.0,1165,46,1211
383,TSLA  ,2023-02-08,2023-02-24,217.5,189,33,222
384,TSLA  ,2023-02-08,2023-02-24,220.0,2989,44,3033
385,TSLA  ,2023-02-08,2023-02-24,222.5,244,6,250
386,TSLA  ,2023-02-08,2023-02-24,225.0,2957,32,2989
387,TSLA  ,2023-02-08,2023-02-24,230.0,2634,36,2670
388,TSLA  ,2023-02-08,2023-02-24,235.0,1591,24,1615
389,TSLA  ,2023-02-08,2023-02-24,240.0,3639,8,3647
390,TSLA  ,2023-02-08,2023-02-24,245.0,1650,7,1657
391,TSLA  ,2023-02-08,2023-02-24,250.0,2852,27,2879
392,TSLA  ,2023-02-08,2023-02-24,255.0,686,0,686
393,TSLA  ,2023-02-08,2023-02-24,260.0,1559,4,1563
394,TSLA  ,2023-02-08,2023-02-24,265.0,449,2,451
395,TSLA  ,2023-02-08,2023-02-24,270.0,1004,4,1008
396,TSLA  ,2023-02-08,2023-02-24,275.0,1325,3,1328
397,TSLA  ,2023-02-08,2023-02-24,280.0,993,3,996
398,TSLA  ,2023-02-08,2023-02-24,285.0,2901,0,2901
399,TSLA  ,2023-02-08,2023-02-24,290.0,1061,0,1061
400,TSLA  ,2023-02-08,2023-02-24,295.0,261,0,261
401,TSLA  ,2023-02-08,2023-02-24,300.0,1107,0,1107
402,TSLA  ,2023-02-08,2023-02-24,310.0,1473,0,1473
403,TSLA  ,2023-02-08,2023-02-24,320.0,808,0,808
404,TSLA  ,2023-02-08,2023-02-24,330.0,452,0,452
405,TSLA  ,2023-02-08,2023-02-24,340.0,504,0,504
406,TSLA  ,2023-02-08,2023-02-24,350.0,1112,0,1112
407,TSLA  ,2023-02-08,2023-02-24,360.0,1615,0,1615
408,TSLA  ,2023-02-08,2023-03-03,15.0,8,256,264
409,TSLA  ,2023-02-08,2023-03-03,20.0,1,0,1
410,TSLA  ,2023-02-08,2023-03-03,25.0,1,47,48
411,TSLA  ,2023-02-08,2023-03-03,30.0,3,340,343
412,TSLA  ,2023-02-08,2023-03-03,35.0,3,1,4
413,TSLA  ,2023-02-08,2023-03-03,40.0,0,10,10
414,TSLA  ,2023-02-08,2023-03-03,45.0,0,2456,2456
415,TSLA  ,2023-02-08,2023-03-03,50.0,1,886,887
416,TSLA  ,2023-02-08,2023-03-03,55.0,0,154,154
417,TSLA  ,2023-02-08,2023-03-03,60.0,5,1112,1117
418,TSLA  ,2023-02-08,2023-03-03,65.0,1,52,53
419,TSLA  ,2023-02-08,2023-03-03,70.0,3,642,645
420,TSLA  ,2023-02-08,2023-03-03,75.0,0,258,258
421,TSLA  ,2023-02-08,2023-03-03,80.0,112,784,896
422,TSLA  ,2023-02-08,2023-03-03,85.0,4,541,545
423,TSLA  ,2023-02-08,2023-03-03,90.0,7,1006,1013
424,TSLA  ,2023-02-08,2023-03-03,95.0,7,1788,1795
425,TSLA  ,2023-02-08,2023-03-03,100.0,58,1885,1943
426,TSLA  ,2023-02-08,2023-03-03,105.0,16,632,648
427,TSLA  ,2023-02-08,2023-03-03,108.0,59,489,548
428,TSLA  ,2023-02-08,2023-03-03,109.0,34,359,393
429,TSLA  ,2023-02-08,2023-03-03,110.0,97,2987,3084
430,TSLA  ,2023-02-08,2023-03-03,111.0,7,556,563
431,TSLA  ,2023-02-08,2023-03-03,112.0,36,696,732
432,TSLA  ,2023-02-08,2023-03-03,113.0,28,557,585
433,TSLA  ,2023-02-08,2023-03-03,114.0,155,450,605
434,TSLA  ,2023-02-08,2023-03-03,115.0,168,836,1004
435,TSLA  ,2023-02-08,2023-03-03,116.0,158,385,543
436,TSLA  ,2023-02-08,2023-03-03,117.0,474,728,1202
437,TSLA  ,2023-02-08,2023-03-03,118.0,302,280,582
438,TSLA  ,2023-02-08,2023-03-03,119.0,309,507,816
439,TSLA  ,2023-02-08,2023-03-03,120.0,816,1586,2402
440,TSLA  ,2023-02-08,2023-03-03,121.0,119,499,618
441,TSLA  ,2023-02-08,2023-03-03,122.0,117,906,1023
442,TSLA  ,2023-02-08,2023-03-03,123.0,263,615,878
443,TSLA  ,2023-02-08,2023-03-03,124.0,451,438,889
444,TSLA  ,2023-02-08,2023-03-03,125.0,279,738,1017
445,TSLA  ,2023-02-08,2023-03-03,126.0,670,376,1046
446,TSLA  ,2023-02-08,2023-03-03,127.0,426,247,673
447,TSLA  ,2023-02-08,2023-03-03,128.0,454,911,1365
448,TSLA  ,2023-02-08,2023-03-03,129.0,646,549,1195
449,TSLA  ,2023-02-08,2023-03-03,130.0,684,1535,2219
450,TSLA  ,2023-02-08,2023-03-03,131.0,304,747,1051
451,TSLA  ,2023-02-08,2023-03-03,132.0,817,434,1251
452,TSLA  ,2023-02-08,2023-03-03,133.0,538,109,647
453,TSLA  ,2023-02-08,2023-03-03,134.0,567,1236,1803
454,TSLA  ,2023-02-08,2023-03-03,135.0,881,1068,1949
455,TSLA  ,2023-02-08,2023-03-03,136.0,92,71,163
456,TSLA  ,2023-02-08,2023-03-03,137.0,66,100,166
457,TSLA  ,2023-02-08,2023-03-03,138.0,151,283,434
458,TSLA  ,2023-02-08,2023-03-03,139.0,115,172,287
459,TSLA  ,2023-02-08,2023-03-03,140.0,608,1295,1903
460,TSLA  ,2023-02-08,2023-03-03,141.0,68,103,171
461,TSLA  ,2023-02-08,2023-03-03,142.0,295,193,488
462,TSLA  ,2023-02-08,2023-03-03,143.0,12,28,40
463,TSLA  ,2023-02-08,2023-03-03,144.0,21,69,90
464,TSLA  ,2023-02-08,2023-03-03,145.0,672,3435,4107
465,TSLA  ,2023-02-08,2023-03-03,146.0,26,531,557
466,TSLA  ,2023-02-08,2023-03-03,147.0,46,198,244
467,TSLA  ,2023-02-08,2023-03-03,148.0,28,372,400
468,TSLA  ,2023-02-08,2023-03-03,149.0,255,1658,1913
469,TSLA  ,2023-02-08,2023-03-03,150.0,1019,5237,6256
470,TSLA  ,2023-02-08,2023-03-03,152.5,154,816,970
471,TSLA  ,2023-02-08,2023-03-03,155.0,1218,971,2189
472,TSLA  ,2023-02-08,2023-03-03,157.5,125,349,474
473,TSLA  ,2023-02-08,2023-03-03,160.0,1067,3810,4877
474,TSLA  ,2023-02-08,2023-03-03,162.5,210,4177,4387
475,TSLA  ,2023-02-08,2023-03-03,165.0,1840,1053,2893
476,TSLA  ,2023-02-08,2023-03-03,167.5,249,403,652
477,TSLA  ,2023-02-08,2023-03-03,170.0,2455,3863,6318
478,TSLA  ,2023-02-08,2023-03-03,172.5,1187,707,1894
479,TSLA  ,2023-02-08,2023-03-03,175.0,1248,1611,2859
480,TSLA  ,2023-02-08,2023-03-03,177.5,430,312,742
481,TSLA  ,2023-02-08,2023-03-03,180.0,1990,2035,4025
482,TSLA  ,2023-02-08,2023-03-03,182.5,308,564,872
483,TSLA  ,2023-02-08,2023-03-03,185.0,1221,976,2197
484,TSLA  ,2023-02-08,2023-03-03,187.5,1281,623,1904
485,TSLA  ,2023-02-08,2023-03-03,190.0,2222,1042,3264
486,TSLA  ,2023-02-08,2023-03-03,192.5,656,587,1243
487,TSLA  ,2023-02-08,2023-03-03,195.0,1878,1014,2892
488,TSLA  ,2023-02-08,2023-03-03,197.5,1821,361,2182
489,TSLA  ,2023-02-08,2023-03-03,200.0,5779,1213,6992
490,TSLA  ,2023-02-08,2023-03-03,202.5,377,870,1247
491,TSLA  ,2023-02-08,2023-03-03,205.0,3327,115,3442
492,TSLA  ,2023-02-08,2023-03-03,207.5,235,7,242
493,TSLA  ,2023-02-08,2023-03-03,210.0,2162,49,2211
494,TSLA  ,2023-02-08,2023-03-03,212.5,217,7,224
495,TSLA  ,2023-02-08,2023-03-03,215.0,3182,43,3225
496,TSLA  ,2023-02-08,2023-03-03,217.5,381,58,439
497,TSLA  ,2023-02-08,2023-03-03,220.0,2494,94,2588
498,TSLA  ,2023-02-08,2023-03-03,222.5,100,5,105
499,TSLA  ,2023-02-08,2023-03-03,225.0,1997,52,2049
500,TSLA  ,2023-02-08,2023-03-03,230.0,2105,96,2201
501,TSLA  ,2023-02-08,2023-03-03,235.0,1169,1,1170
502,TSLA  ,2023-02-08,2023-03-03,240.0,2832,36,2868
503,TSLA  ,2023-02-08,2023-03-03,245.0,2080,12,2092
504,TSLA  ,2023-02-08,2023-03-03,250.0,2527,7,2534
505,TSLA  ,2023-02-08,2023-03-03,255.0,790,3,793
506,TSLA  ,2023-02-08,2023-03-03,260.0,525,0,525
507,TSLA  ,2023-02-08,2023-03-03,265.0,470,0,470
508,TSLA  ,2023-02-08,2023-03-03,270.0,584,0,584
509,TSLA  ,2023-02-08,2023-03-03,275.0,547,1,548
510,TSLA  ,2023-02-08,2023-03-03,280.0,864,0,864
511,TSLA  ,2023-02-08,2023-03-03,285.0,353,0,353
512,TSLA  ,2023-02-08,2023-03-03,290.0,1081,1,1082
513,TSLA  ,2023-02-08,2023-03-03,295.0,93,0,93
514,TSLA  ,2023-02-08,2023-03-03,300.0,4582,4,4586
515,TSLA  ,2023-02-08,2023-03-03,310.0,306,0,306
516,TSLA  ,2023-02-08,2023-03-03,320.0,318,6,324
517,TSLA  ,2023-02-08,2023-03-03,330.0,123,0,123
518,TSLA  ,2023-02-08,2023-03-03,340.0,363,0,363
519,TSLA  ,2023-02-08,2023-03-03,350.0,528,1,529
520,TSLA  ,2023-02-08,2023-03-03,360.0,875,0,875
521,TSLA  ,2023-02-08,2023-03-10,15.0,3,36,39
522,TSLA  ,2023-02-08,2023-03-10,20.0,3,0,3
523,TSLA  ,2023-02-08,2023-03-10,25.0,0,0,0
524,TSLA  ,2023-02-08,2023-03-10,30.0,0,0,0
525,TSLA  ,2023-02-08,2023-03-10,35.0,0,0,0
526,TSLA  ,2023-02-08,2023-03-10,40.0,0,0,0
527,TSLA  ,2023-02-08,2023-03-10,45.0,0,0,0
528,TSLA  ,2023-02-08,2023-03-10,50.0,5,17,22
529,TSLA  ,2023-02-08,2023-03-10,55.0,0,1200,1200
530,TSLA  ,2023-02-08,2023-03-10,60.0,0,12,12
531,TSLA  ,2023-02-08,2023-03-10,65.0,0,10,10
532,TSLA  ,2023-02-08,2023-03-10,70.0,0,25,25
533,TSLA  ,2023-02-08,2023-03-10,75.0,0,419,419
534,TSLA  ,2023-02-08,2023-03-10,80.0,0,64,64
535,TSLA  ,2023-02-08,2023-03-10,85.0,0,42,42
536,TSLA  ,2023-02-08,2023-03-10,90.0,0,43,43
537,TSLA  ,2023-02-08,2023-03-10,95.0,1,66,67
538,TSLA  ,2023-02-08,2023-03-10,100.0,0,477,477
539,TSLA  ,2023-02-08,2023-03-10,105.0,4,206,210
540,TSLA  ,2023-02-08,2023-03-10,110.0,16,613,629
541,TSLA  ,2023-02-08,2023-03-10,115.0,4,272,276
542,TSLA  ,2023-02-08,2023-03-10,120.0,2,184,186
543,TSLA  ,2023-02-08,2023-03-10,125.0,15,335,350
544,TSLA  ,2023-02-08,2023-03-10,130.0,76,209,285
545,TSLA  ,2023-02-08,2023-03-10,134.0,8,124,132
546,TSLA  ,2023-02-08,2023-03-10,135.0,33,515,548
547,TSLA  ,2023-02-08,2023-03-10,136.0,10,43,53
548,TSLA  ,2023-02-08,2023-03-10,137.0,7,80,87
549,TSLA  ,2023-02-08,2023-03-10,138.0,10,99,109
550,TSLA  ,2023-02-08,2023-03-10,139.0,3,91,94
551,TSLA  ,2023-02-08,2023-03-10,140.0,47,640,687
552,TSLA  ,2023-02-08,2023-03-10,141.0,140,18,158
553,TSLA  ,2023-02-08,2023-03-10,142.0,10,218,228
554,TSLA  ,2023-02-08,2023-03-10,143.0,4,186,190
555,TSLA  ,2023-02-08,2023-03-10,144.0,3,45,48
556,TSLA  ,2023-02-08,2023-03-10,145.0,99,271,370
557,TSLA  ,2023-02-08,2023-03-10,146.0,19,24,43
558,TSLA  ,2023-02-08,2023-03-10,147.0,82,110,192
559,TSLA  ,2023-02-08,2023-03-10,148.0,85,755,840
560,TSLA  ,2023-02-08,2023-03-10,149.0,3,192,195
561,TSLA  ,2023-02-08,2023-03-10,150.0,247,686,933
562,TSLA  ,2023-02-08,2023-03-10,152.5,101,135,236
563,TSLA  ,2023-02-08,2023-03-10,155.0,261,491,752
564,TSLA  ,2023-02-08,2023-03-10,157.5,52,346,398
565,TSLA  ,2023-02-08,2023-03-10,160.0,204,612,816
566,TSLA  ,2023-02-08,2023-03-10,162.5,92,196,288
567,TSLA  ,2023-02-08,2023-03-10,165.0,303,703,1006
568,TSLA  ,2023-02-08,2023-03-10,167.5,198,220,418
569,TSLA  ,2023-02-08,2023-03-10,170.0,378,1135,1513
570,TSLA  ,2023-02-08,2023-03-10,172.5,169,183,352
571,TSLA  ,2023-02-08,2023-03-10,175.0,433,692,1125
572,TSLA  ,2023-02-08,2023-03-10,177.5,1791,220,2011
573,TSLA  ,2023-02-08,2023-03-10,180.0,591,1031,1622
574,TSLA  ,2023-02-08,2023-03-10,182.5,158,90,248
575,TSLA  ,2023-02-08,2023-03-10,185.0,256,485,741
576,TSLA  ,2023-02-08,2023-03-10,187.5,1019,124,1143
577,TSLA  ,2023-02-08,2023-03-10,190.0,1088,606,1694
578,TSLA  ,2023-02-08,2023-03-10,192.5,472,192,664
579,TSLA  ,2023-02-08,2023-03-10,195.0,596,349,945
580,TSLA  ,2023-02-08,2023-03-10,197.5,394,441,835
581,TSLA  ,2023-02-08,2023-03-10,200.0,1779,289,2068
582,TSLA  ,2023-02-08,2023-03-10,202.5,94,128,222
583,TSLA  ,2023-02-08,2023-03-10,205.0,725,248,973
584,TSLA  ,2023-02-08,2023-03-10,207.5,49,10,59
585,TSLA  ,2023-02-08,2023-03-10,210.0,906,109,1015
586,TSLA  ,2023-02-08,2023-03-10,212.5,51,37,88
587,TSLA  ,2023-02-08,2023-03-10,215.0,222,3,225
588,TSLA  ,2023-02-08,2023-03-10,217.5,134,1,135
589,TSLA  ,2023-02-08,2023-03-10,220.0,737,10,747
590,TSLA  ,2023-02-08,2023-03-10,222.5,160,1,161
591,TSLA  ,2023-02-08,2023-03-10,225.0,580,113,693
592,TSLA  ,2023-02-08,2023-03-10,230.0,297,0,297
593,TSLA  ,2023-02-08,2023-03-10,235.0,362,2,364
594,TSLA  ,2023-02-08,2023-03-10,240.0,687,11,698
595,TSLA  ,2023-02-08,2023-03-10,245.0,288,43,331
596,TSLA  ,2023-02-08,2023-03-10,250.0,1048,16,1064
597,TSLA  ,2023-02-08,2023-03-10,255.0,241,2,243
598,TSLA  ,2023-02-08,2023-03-10,260.0,237,0,237
599,TSLA  ,2023-02-08,2023-03-10,265.0,140,0,140
600,TSLA  ,2023-02-08,2023-03-10,270.0,314,0,314
601,TSLA  ,2023-02-08,2023-03-10,275.0,160,0,160
602,TSLA  ,2023-02-08,2023-03-10,280.0,552,5,557
603,TSLA  ,2023-02-08,2023-03-10,285.0,252,0,252
604,TSLA  ,2023-02-08,2023-03-10,290.0,148,3,151
605,TSLA  ,2023-02-08,2023-03-10,295.0,207,0,207
606,TSLA  ,2023-02-08,2023-03-10,300.0,804,0,804
607,TSLA  ,2023-02-08,2023-03-10,310.0,230,5,235
608,TSLA  ,2023-02-08,2023-03-10,320.0,271,0,271
609,TSLA  ,2023-02-08,2023-03-10,330.0,51,0,51
610,TSLA  ,2023-02-08,2023-03-10,340.0,234,0,234
611,TSLA  ,2023-02-08,2023-03-10,350.0,161,0,161
612,TSLA  ,2023-02-08,2023-03-10,360.0,432,0,432
613,TSLA  ,2023-02-08,2023-03-17,1.67,103,24718,24821
614,TSLA  ,2023-02-08,2023-03-17,3.33,29,6941,6970
615,TSLA  ,2023-02-08,2023-03-17,5.0,2,8008,8010
616,TSLA  ,2023-02-08,2023-03-17,6.67,52,4669,4721
617,TSLA  ,2023-02-08,2023-03-17,8.33,15,1379,1394
618,TSLA  ,2023-02-08,2023-03-17,10.0,842,4105,4947
619,TSLA  ,2023-02-08,2023-03-17,11.67,1711,5414,7125
620,TSLA  ,2023-02-08,2023-03-17,13.33,1657,2125,3782
621,TSLA  ,2023-02-08,2023-03-17,15.0,987,5169,6156
622,TSLA  ,2023-02-08,2023-03-17,16.67,875,15329,16204
623,TSLA  ,2023-02-08,2023-03-17,18.33,467,12018,12485
624,TSLA  ,2023-02-08,2023-03-17,33.33,406,33486,33892
625,TSLA  ,2023-02-08,2023-03-17,50.0,496,21249,21745
626,TSLA  ,2023-02-08,2023-03-17,55.0,33,4651,4684
627,TSLA  ,2023-02-08,2023-03-17,60.0,198,6152,6350
628,TSLA  ,2023-02-08,2023-03-17,65.0,25,2696,2721
629,TSLA  ,2023-02-08,2023-03-17,66.67,903,17805,18708
630,TSLA  ,2023-02-08,2023-03-17,70.0,50,7533,7583
631,TSLA  ,2023-02-08,2023-03-17,75.0,54,5363,5417
632,TSLA  ,2023-02-08,2023-03-17,80.0,220,11975,12195
633,TSLA  ,2023-02-08,2023-03-17,83.33,886,5222,6108
634,TSLA  ,2023-02-08,2023-03-17,85.0,89,3491,3580
635,TSLA  ,2023-02-08,2023-03-17,90.0,665,16003,16668
636,TSLA  ,2023-02-08,2023-03-17,95.0,335,4140,4475
637,TSLA  ,2023-02-08,2023-03-17,100.0,1801,29873,31674
638,TSLA  ,2023-02-08,2023-03-17,105.0,1405,4460,5865
639,TSLA  ,2023-02-08,2023-03-17,110.0,3087,13136,16223
640,TSLA  ,2023-02-08,2023-03-17,115.0,3395,8815,12210
641,TSLA  ,2023-02-08,2023-03-17,116.67,1393,11217,12610
642,TSLA  ,2023-02-08,2023-03-17,120.0,12348,17126,29474
643,TSLA  ,2023-02-08,2023-03-17,123.33,2750,6328,9078
644,TSLA  ,2023-02-08,2023-03-17,125.0,3587,9128,12715
645,TSLA  ,2023-02-08,2023-03-17,126.67,1685,4478,6163
646,TSLA  ,2023-02-08,2023-03-17,130.0,7581,11519,19100
647,TSLA  ,2023-02-08,2023-03-17,133.33,3446,9551,12997
648,TSLA  ,2023-02-08,2023-03-17,135.0,27814,34075,61889
649,TSLA  ,2023-02-08,2023-03-17,136.67,2895,3517,6412
650,TSLA  ,2023-02-08,2023-03-17,140.0,7251,29089,36340
651,TSLA  ,2023-02-08,2023-03-17,143.33,2468,4860,7328
652,TSLA  ,2023-02-08,2023-03-17,145.0,2812,8281,11093
653,TSLA  ,2023-02-08,2023-03-17,146.67,1898,4379,6277
654,TSLA  ,2023-02-08,2023-03-17,150.0,13177,21122,34299
655,TSLA  ,2023-02-08,2023-03-17,153.33,1681,2992,4673
656,TSLA  ,2023-02-08,2023-03-17,155.0,3705,5819,9524
657,TSLA  ,2023-02-08,2023-03-17,156.67,2334,3342,5676
658,TSLA  ,2023-02-08,2023-03-17,160.0,7697,22274,29971
659,TSLA  ,2023-02-08,2023-03-17,163.33,3067,4948,8015
660,TSLA  ,2023-02-08,2023-03-17,165.0,7062,6092,13154
661,TSLA  ,2023-02-08,2023-03-17,166.67,6372,11477,17849
662,TSLA  ,2023-02-08,2023-03-17,170.0,11630,21028,32658
663,TSLA  ,2023-02-08,2023-03-17,173.33,3094,10983,14077
664,TSLA  ,2023-02-08,2023-03-17,175.0,4812,4305,9117
665,TSLA  ,2023-02-08,2023-03-17,176.67,5263,2756,8019
666,TSLA  ,2023-02-08,2023-03-17,180.0,20151,15638,35789
667,TSLA  ,2023-02-08,2023-03-17,183.33,3354,7492,10846
668,TSLA  ,2023-02-08,2023-03-17,185.0,3397,3611,7008
669,TSLA  ,2023-02-08,2023-03-17,186.67,2667,4023,6690
670,TSLA  ,2023-02-08,2023-03-17,190.0,12530,10922,23452
671,TSLA  ,2023-02-08,2023-03-17,193.33,2254,2449,4703
672,TSLA  ,2023-02-08,2023-03-17,195.0,4590,3354,7944
673,TSLA  ,2023-02-08,2023-03-17,196.67,2623,1612,4235
674,TSLA  ,2023-02-08,2023-03-17,198.33,3375,1982,5357
675,TSLA  ,2023-02-08,2023-03-17,200.0,44384,33111,77495
676,TSLA  ,2023-02-08,2023-03-17,201.67,1493,1236,2729
677,TSLA  ,2023-02-08,2023-03-17,203.33,1846,1236,3082
678,TSLA  ,2023-02-08,2023-03-17,205.0,4009,591,4600
679,TSLA  ,2023-02-08,2023-03-17,206.67,1239,1921,3160
680,TSLA  ,2023-02-08,2023-03-17,208.33,2141,613,2754
681,TSLA  ,2023-02-08,2023-03-17,210.0,9182,1200,10382
682,TSLA  ,2023-02-08,2023-03-17,211.67,1402,510,1912
683,TSLA  ,2023-02-08,2023-03-17,213.33,1147,480,1627
684,TSLA  ,2023-02-08,2023-03-17,215.0,10362,542,10904
685,TSLA  ,2023-02-08,2023-03-17,216.67,4522,2772,7294
686,TSLA  ,2023-02-08,2023-03-17,218.33,927,100,1027
687,TSLA  ,2023-02-08,2023-03-17,220.0,10986,783,11769
688,TSLA  ,2023-02-08,2023-03-17,221.67,1267,121,1388
689,TSLA  ,2023-02-08,2023-03-17,223.33,883,105,988
690,TSLA  ,2023-02-08,2023-03-17,225.0,4909,690,5599
691,TSLA  ,2023-02-08,2023-03-17,226.67,1802,168,1970
692,TSLA  ,2023-02-08,2023-03-17,228.33,5183,43,5226
693,TSLA  ,2023-02-08,2023-03-17,230.0,5947,704,6651
694,TSLA  ,2023-02-08,2023-03-17,231.67,1400,52,1452
695,TSLA  ,2023-02-08,2023-03-17,233.33,6799,418,7217
696,TSLA  ,2023-02-08,2023-03-17,235.0,6709,99,6808
697,TSLA  ,2023-02-08,2023-03-17,236.67,1052,53,1105
698,TSLA  ,2023-02-08,2023-03-17,238.33,931,54,985
699,TSLA  ,2023-02-08,2023-03-17,240.0,5176,236,5412
700,TSLA  ,2023-02-08,2023-03-17,241.67,912,40,952
701,TSLA  ,2023-02-08,2023-03-17,243.33,1361,86,1447
702,TSLA  ,2023-02-08,2023-03-17,245.0,1889,27,1916
703,TSLA  ,2023-02-08,2023-03-17,246.67,943,36,979
704,TSLA  ,2023-02-08,2023-03-17,248.33,1050,34,1084
705,TSLA  ,2023-02-08,2023-03-17,250.0,17394,583,17977
706,TSLA  ,2023-02-08,2023-03-17,251.67,1229,76,1305
707,TSLA  ,2023-02-08,2023-03-17,253.33,565,34,599
708,TSLA  ,2023-02-08,2023-03-17,255.0,2952,67,3019
709,TSLA  ,2023-02-08,2023-03-17,256.67,659,24,683
710,TSLA  ,2023-02-08,2023-03-17,258.33,751,25,776
711,TSLA  ,2023-02-08,2023-03-17,260.0,5795,50,5845
712,TSLA  ,2023-02-08,2023-03-17,261.67,1284,13,1297
713,TSLA  ,2023-02-08,2023-03-17,263.33,1045,57,1102
714,TSLA  ,2023-02-08,2023-03-17,265.0,1041,16,1057
715,TSLA  ,2023-02-08,2023-03-17,266.67,9889,374,10263
716,TSLA  ,2023-02-08,2023-03-17,270.0,3927,32,3959
717,TSLA  ,2023-02-08,2023-03-17,273.33,3865,80,3945
718,TSLA  ,2023-02-08,2023-03-17,275.0,362,9,371
719,TSLA  ,2023-02-08,2023-03-17,276.67,1392,38,1430
720,TSLA  ,2023-02-08,2023-03-17,280.0,2568,138,2706
721,TSLA  ,2023-02-08,2023-03-17,283.33,7041,54,7095
722,TSLA  ,2023-02-08,2023-03-17,285.0,173,0,173
723,TSLA  ,2023-02-08,2023-03-17,286.67,1848,17,1865
724,TSLA  ,2023-02-08,2023-03-17,290.0,3103,69,3172
725,TSLA  ,2023-02-08,2023-03-17,293.33,7254,342,7596
726,TSLA  ,2023-02-08,2023-03-17,295.0,2016,11,2027
727,TSLA  ,2023-02-08,2023-03-17,296.67,949,16,965
728,TSLA  ,2023-02-08,2023-03-17,298.33,1134,2,1136
729,TSLA  ,2023-02-08,2023-03-17,300.0,70679,450,71129
730,TSLA  ,2023-02-08,2023-03-17,301.67,1477,17,1494
731,TSLA  ,2023-02-08,2023-03-17,303.33,1307,3,1310
732,TSLA  ,2023-02-08,2023-03-17,305.0,2673,8,2681
733,TSLA  ,2023-02-08,2023-03-17,306.67,1908,3,1911
734,TSLA  ,2023-02-08,2023-03-17,308.33,3819,2,3821
735,TSLA  ,2023-02-08,2023-03-17,310.0,4823,15,4838
736,TSLA  ,2023-02-08,2023-03-17,311.67,2008,5,2013
737,TSLA  ,2023-02-08,2023-03-17,313.33,3783,0,3783
738,TSLA  ,2023-02-08,2023-03-17,316.67,29725,11,29736
739,TSLA  ,2023-02-08,2023-03-17,320.0,14773,202,14975
740,TSLA  ,2023-02-08,2023-03-17,323.33,401,0,401
741,TSLA  ,2023-02-08,2023-03-17,326.67,539,0,539
742,TSLA  ,2023-02-08,2023-03-17,330.0,3321,6,3327
743,TSLA  ,2023-02-08,2023-03-17,333.33,20586,27,20613
744,TSLA  ,2023-02-08,2023-03-17,336.67,833,0,833
745,TSLA  ,2023-02-08,2023-03-17,340.0,5274,0,5274
746,TSLA  ,2023-02-08,2023-03-17,343.33,1906,0,1906
747,TSLA  ,2023-02-08,2023-03-17,346.67,704,0,704
748,TSLA  ,2023-02-08,2023-03-17,350.0,10853,214,11067
749,TSLA  ,2023-02-08,2023-03-17,353.33,669,0,669
750,TSLA  ,2023-02-08,2023-03-17,356.67,500,0,500
751,TSLA  ,2023-02-08,2023-03-17,360.0,2315,0,2315
752,TSLA  ,2023-02-08,2023-03-17,363.33,572,0,572
753,TSLA  ,2023-02-08,2023-03-17,366.67,7822,0,7822
754,TSLA  ,2023-02-08,2023-03-17,370.0,2010,0,2010
755,TSLA  ,2023-02-08,2023-03-17,373.33,688,0,688
756,TSLA  ,2023-02-08,2023-03-17,383.33,12579,0,12579
757,TSLA  ,2023-02-08,2023-03-17,400.0,25582,0,25582
758,TSLA  ,2023-02-08,2023-03-17,416.67,13093,0,13093
759,TSLA  ,2023-02-08,2023-03-17,433.33,19380,0,19380
760,TSLA  ,2023-02-08,2023-03-17,441.67,2058,0,2058
761,TSLA  ,2023-02-08,2023-03-17,450.0,5546,0,5546
762,TSLA  ,2023-02-08,2023-03-17,458.33,2448,0,2448
763,TSLA  ,2023-02-08,2023-03-17,466.67,3812,4,3816
764,TSLA  ,2023-02-08,2023-03-17,475.0,3774,0,3774
765,TSLA  ,2023-02-08,2023-03-17,483.33,1955,0,1955
766,TSLA  ,2023-02-08,2023-03-17,491.67,2608,0,2608
767,TSLA  ,2023-02-08,2023-03-17,500.0,12488,6,12494
768,TSLA  ,2023-02-08,2023-03-17,508.33,1691,0,1691
769,TSLA  ,2023-02-08,2023-03-17,516.67,1062,0,1062
770,TSLA  ,2023-02-08,2023-03-17,525.0,4742,0,4742
771,TSLA  ,2023-02-08,2023-03-17,533.33,4765,0,4765
772,TSLA  ,2023-02-08,2023-03-17,541.67,1031,0,1031
773,TSLA  ,2023-02-08,2023-03-17,550.0,4986,0,4986
774,TSLA  ,2023-02-08,2023-03-17,558.33,3782,0,3782
775,TSLA  ,2023-02-08,2023-03-17,566.67,7757,0,7757
776,TSLA  ,2023-02-08,2023-03-17,575.0,11851,0,11851
777,TSLA  ,2023-02-08,2023-03-17,583.33,2634,0,2634
778,TSLA  ,2023-02-08,2023-03-17,591.67,1274,0,1274
779,TSLA  ,2023-02-08,2023-03-17,600.0,5002,0,5002
780,TSLA  ,2023-02-08,2023-03-17,608.33,530,0,530
781,TSLA  ,2023-02-08,2023-03-17,616.67,3979,0,3979
782,TSLA  ,2023-02-08,2023-03-17,625.0,945,0,945
783,TSLA  ,2023-02-08,2023-03-17,633.33,2366,0,2366
784,TSLA  ,2023-02-08,2023-03-17,641.67,1446,0,1446
785,TSLA  ,2023-02-08,2023-03-17,650.0,8237,0,8237
786,TSLA  ,2023-02-08,2023-03-17,666.67,70151,0,70151
787,TSLA  ,2023-02-08,2023-03-17,675.0,21530,0,21530
788,TSLA  ,2023-02-08,2023-03-17,683.33,3670,0,3670
789,TSLA  ,2023-02-08,2023-03-17,691.67,1109,0,1109
790,TSLA  ,2023-02-08,2023-03-17,700.0,4509,0,4509
791,TSLA  ,2023-02-08,2023-03-17,708.33,483,0,483
792,TSLA  ,2023-02-08,2023-03-17,716.67,664,0,664
793,TSLA  ,2023-02-08,2023-03-17,725.0,789,0,789
794,TSLA  ,2023-02-08,2023-03-17,733.33,1729,0,1729
795,TSLA  ,2023-02-08,2023-03-17,741.67,753,0,753
796,TSLA  ,2023-02-08,2023-03-17,750.0,703,0,703
797,TSLA  ,2023-02-08,2023-03-17,758.33,1235,0,1235
798,TSLA  ,2023-02-08,2023-03-17,766.67,1260,0,1260
799,TSLA  ,2023-02-08,2023-03-17,775.0,846,0,846
800,TSLA  ,2023-02-08,2023-03-17,783.33,1311,0,1311
801,TSLA  ,2023-02-08,2023-03-17,791.67,1447,0,1447
802,TSLA  ,2023-02-08,2023-03-17,800.0,5214,0,5214
803,TSLA  ,2023-02-08,2023-03-17,808.33,1843,0,1843
804,TSLA  ,2023-02-08,2023-03-17,816.67,2466,0,2466
805,TSLA  ,2023-02-08,2023-03-17,825.0,58972,0,58972
806,TSLA  ,2023-02-08,2023-03-24,20.0,6,11,17
807,TSLA  ,2023-02-08,2023-03-24,30.0,0,0,0
808,TSLA  ,2023-02-08,2023-03-24,40.0,0,0,0
809,TSLA  ,2023-02-08,2023-03-24,50.0,0,1543,1543
810,TSLA  ,2023-02-08,2023-03-24,55.0,4,0,4
811,TSLA  ,2023-02-08,2023-03-24,60.0,0,9,9
812,TSLA  ,2023-02-08,2023-03-24,65.0,0,0,0
813,TSLA  ,2023-02-08,2023-03-24,70.0,0,6,6
814,TSLA  ,2023-02-08,2023-03-24,75.0,0,0,0
815,TSLA  ,2023-02-08,2023-03-24,80.0,0,16,16
816,TSLA  ,2023-02-08,2023-03-24,85.0,0,20,20
817,TSLA  ,2023-02-08,2023-03-24,90.0,0,23,23
818,TSLA  ,2023-02-08,2023-03-24,95.0,0,19,19
819,TSLA  ,2023-02-08,2023-03-24,100.0,11,83,94
820,TSLA  ,2023-02-08,2023-03-24,105.0,10,46,56
821,TSLA  ,2023-02-08,2023-03-24,110.0,4,31,35
822,TSLA  ,2023-02-08,2023-03-24,115.0,1,15,16
823,TSLA  ,2023-02-08,2023-03-24,120.0,0,91,91
824,TSLA  ,2023-02-08,2023-03-24,125.0,2,103,105
825,TSLA  ,2023-02-08,2023-03-24,130.0,129,274,403
826,TSLA  ,2023-02-08,2023-03-24,135.0,17,71,88
827,TSLA  ,2023-02-08,2023-03-24,140.0,19,172,191
828,TSLA  ,2023-02-08,2023-03-24,145.0,59,94,153
829,TSLA  ,2023-02-08,2023-03-24,146.0,7,6,13
830,TSLA  ,2023-02-08,2023-03-24,147.0,64,11,75
831,TSLA  ,2023-02-08,2023-03-24,148.0,57,67,124
832,TSLA  ,2023-02-08,2023-03-24,149.0,60,65,125
833,TSLA  ,2023-02-08,2023-03-24,150.0,43,457,500
834,TSLA  ,2023-02-08,2023-03-24,152.5,1,25,26
835,TSLA  ,2023-02-08,2023-03-24,155.0,30,328,358
836,TSLA  ,2023-02-08,2023-03-24,157.5,5,423,428
837,TSLA  ,2023-02-08,2023-03-24,160.0,100,203,303
838,TSLA  ,2023-02-08,2023-03-24,162.5,18,41,59
839,TSLA  ,2023-02-08,2023-03-24,165.0,24,404,428
840,TSLA  ,2023-02-08,2023-03-24,167.5,14,429,443
841,TSLA  ,2023-02-08,2023-03-24,170.0,36,332,368
842,TSLA  ,2023-02-08,2023-03-24,172.5,19,112,131
843,TSLA  ,2023-02-08,2023-03-24,175.0,107,261,368
844,TSLA  ,2023-02-08,2023-03-24,177.5,24,442,466
845,TSLA  ,2023-02-08,2023-03-24,180.0,100,468,568
846,TSLA  ,2023-02-08,2023-03-24,182.5,2,14,16
847,TSLA  ,2023-02-08,2023-03-24,185.0,77,134,211
848,TSLA  ,2023-02-08,2023-03-24,187.5,105,21,126
849,TSLA  ,2023-02-08,2023-03-24,190.0,306,172,478
850,TSLA  ,2023-02-08,2023-03-24,192.5,71,79,150
851,TSLA  ,2023-02-08,2023-03-24,195.0,326,94,420
852,TSLA  ,2023-02-08,2023-03-24,197.5,152,21,173
853,TSLA  ,2023-02-08,2023-03-24,200.0,1109,133,1242
854,TSLA  ,2023-02-08,2023-03-24,202.5,18,55,73
855,TSLA  ,2023-02-08,2023-03-24,205.0,879,20,899
856,TSLA  ,2023-02-08,2023-03-24,207.5,33,1,34
857,TSLA  ,2023-02-08,2023-03-24,210.0,274,16,290
858,TSLA  ,2023-02-08,2023-03-24,212.5,41,0,41
859,TSLA  ,2023-02-08,2023-03-24,215.0,178,1,179
860,TSLA  ,2023-02-08,2023-03-24,217.5,7,37,44
861,TSLA  ,2023-02-08,2023-03-24,220.0,296,309,605
862,TSLA  ,2023-02-08,2023-03-24,222.5,68,5,73
863,TSLA  ,2023-02-08,2023-03-24,225.0,164,76,240
864,TSLA  ,2023-02-08,2023-03-24,230.0,279,101,380
865,TSLA  ,2023-02-08,2023-03-24,235.0,230,59,289
866,TSLA  ,2023-02-08,2023-03-24,240.0,100,123,223
867,TSLA  ,2023-02-08,2023-03-24,245.0,454,14,468
868,TSLA  ,2023-02-08,2023-03-24,250.0,472,12,484
869,TSLA  ,2023-02-08,2023-03-24,255.0,76,13,89
870,TSLA  ,2023-02-08,2023-03-24,260.0,67,0,67
871,TSLA  ,2023-02-08,2023-03-24,265.0,24,1,25
872,TSLA  ,2023-02-08,2023-03-24,270.0,36,0,36
873,TSLA  ,2023-02-08,2023-03-24,275.0,43,0,43
874,TSLA  ,2023-02-08,2023-03-24,280.0,202,0,202
875,TSLA  ,2023-02-08,2023-03-24,285.0,10,0,10
876,TSLA  ,2023-02-08,2023-03-24,290.0,66,0,66
877,TSLA  ,2023-02-08,2023-03-24,300.0,168,0,168
878,TSLA  ,2023-02-08,2023-03-24,310.0,62,0,62
879,TSLA  ,2023-02-08,2023-03-24,320.0,131,0,131
880,TSLA  ,2023-02-08,2023-03-24,330.0,2,0,2
881,TSLA  ,2023-02-08,2023-03-24,340.0,0,0,0
882,TSLA  ,2023-02-08,2023-03-24,350.0,77,0,77
883,TSLA  ,2023-02-08,2023-03-24,360.0,240,0,240
884,TSLA  ,2023-02-08,2023-04-21,5.0,14,101,115
885,TSLA  ,2023-02-08,2023-04-21,10.0,0,8,8
886,TSLA  ,2023-02-08,2023-04-21,15.0,0,41,41
887,TSLA  ,2023-02-08,2023-04-21,20.0,4,320,324
888,TSLA  ,2023-02-08,2023-04-21,25.0,5,2484,2489
889,TSLA  ,2023-02-08,2023-04-21,30.0,0,1680,1680
890,TSLA  ,2023-02-08,2023-04-21,35.0,5,436,441
891,TSLA  ,2023-02-08,2023-04-21,40.0,6,503,509
892,TSLA  ,2023-02-08,2023-04-21,45.0,2,780,782
893,TSLA  ,2023-02-08,2023-04-21,50.0,126,5028,5154
894,TSLA  ,2023-02-08,2023-04-21,55.0,17,2725,2742
895,TSLA  ,2023-02-08,2023-04-21,60.0,20,1894,1914
896,TSLA  ,2023-02-08,2023-04-21,65.0,65,5021,5086
897,TSLA  ,2023-02-08,2023-04-21,70.0,105,4354,4459
898,TSLA  ,2023-02-08,2023-04-21,75.0,124,13174,13298
899,TSLA  ,2023-02-08,2023-04-21,80.0,25226,4518,29744
900,TSLA  ,2023-02-08,2023-04-21,85.0,90,3301,3391
901,TSLA  ,2023-02-08,2023-04-21,90.0,266,2268,2534
902,TSLA  ,2023-02-08,2023-04-21,95.0,151,6172,6323
903,TSLA  ,2023-02-08,2023-04-21,100.0,1632,24149,25781
904,TSLA  ,2023-02-08,2023-04-21,105.0,372,2496,2868
905,TSLA  ,2023-02-08,2023-04-21,108.33,901,4877,5778
906,TSLA  ,2023-02-08,2023-04-21,110.0,1091,5196,6287
907,TSLA  ,2023-02-08,2023-04-21,115.0,1441,3406,4847
908,TSLA  ,2023-02-08,2023-04-21,116.67,2545,9685,12230
909,TSLA  ,2023-02-08,2023-04-21,120.0,7445,6755,14200
910,TSLA  ,2023-02-08,2023-04-21,125.0,11115,12634,23749
911,TSLA  ,2023-02-08,2023-04-21,130.0,1842,5942,7784
912,TSLA  ,2023-02-08,2023-04-21,133.33,4614,3768,8382
913,TSLA  ,2023-02-08,2023-04-21,135.0,1880,2454,4334
914,TSLA  ,2023-02-08,2023-04-21,140.0,2839,8405,11244
915,TSLA  ,2023-02-08,2023-04-21,141.67,6337,3756,10093
916,TSLA  ,2023-02-08,2023-04-21,145.0,1912,2070,3982
917,TSLA  ,2023-02-08,2023-04-21,150.0,6996,13521,20517
918,TSLA  ,2023-02-08,2023-04-21,155.0,1318,988,2306
919,TSLA  ,2023-02-08,2023-04-21,158.33,2962,3780,6742
920,TSLA  ,2023-02-08,2023-04-21,160.0,2448,3965,6413
921,TSLA  ,2023-02-08,2023-04-21,165.0,1526,1118,2644
922,TSLA  ,2023-02-08,2023-04-21,166.67,2757,5371,8128
923,TSLA  ,2023-02-08,2023-04-21,170.0,2206,2602,4808
924,TSLA  ,2023-02-08,2023-04-21,175.0,10719,7064,17783
925,TSLA  ,2023-02-08,2023-04-21,180.0,2871,3295,6166
926,TSLA  ,2023-02-08,2023-04-21,183.33,2650,4167,6817
927,TSLA  ,2023-02-08,2023-04-21,185.0,1717,3150,4867
928,TSLA  ,2023-02-08,2023-04-21,190.0,1841,2556,4397
929,TSLA  ,2023-02-08,2023-04-21,191.67,3187,4663,7850
930,TSLA  ,2023-02-08,2023-04-21,195.0,2765,1799,4564
931,TSLA  ,2023-02-08,2023-04-21,200.0,11273,6822,18095
932,TSLA  ,2023-02-08,2023-04-21,205.0,3971,1311,5282
933,TSLA  ,2023-02-08,2023-04-21,208.33,6308,2180,8488
934,TSLA  ,2023-02-08,2023-04-21,210.0,3737,1275,5012
935,TSLA  ,2023-02-08,2023-04-21,215.0,1604,421,2025
936,TSLA  ,2023-02-08,2023-04-21,216.67,1706,2176,3882
937,TSLA  ,2023-02-08,2023-04-21,220.0,6064,279,6343
938,TSLA  ,2023-02-08,2023-04-21,225.0,8213,1969,10182
939,TSLA  ,2023-02-08,2023-04-21,230.0,1088,200,1288
940,TSLA  ,2023-02-08,2023-04-21,233.33,1563,618,2181
941,TSLA  ,2023-02-08,2023-04-21,235.0,808,241,1049
942,TSLA  ,2023-02-08,2023-04-21,240.0,13121,507,13628
943,TSLA  ,2023-02-08,2023-04-21,241.67,774,56,830
944,TSLA  ,2023-02-08,2023-04-21,243.33,922,39,961
945,TSLA  ,2023-02-08,2023-04-21,245.0,1565,63,1628
946,TSLA  ,2023-02-08,2023-04-21,246.67,1091,29,1120
947,TSLA  ,2023-02-08,2023-04-21,248.33,716,329,1045
948,TSLA  ,2023-02-08,2023-04-21,250.0,7780,697,8477
949,TSLA  ,2023-02-08,2023-04-21,251.67,1637,25,1662
950,TSLA  ,2023-02-08,2023-04-21,253.33,438,13,451
951,TSLA  ,2023-02-08,2023-04-21,255.0,1229,19,1248
952,TSLA  ,2023-02-08,2023-04-21,258.33,701,894,1595
953,TSLA  ,2023-02-08,2023-04-21,260.0,1684,5,1689
954,TSLA  ,2023-02-08,2023-04-21,265.0,145,0,145
955,TSLA  ,2023-02-08,2023-04-21,266.67,1582,195,1777
956,TSLA  ,2023-02-08,2023-04-21,270.0,83,2,85
957,TSLA  ,2023-02-08,2023-04-21,275.0,2020,90,2110
958,TSLA  ,2023-02-08,2023-04-21,280.0,264,206,470
959,TSLA  ,2023-02-08,2023-04-21,283.33,1317,213,1530
960,TSLA  ,2023-02-08,2023-04-21,285.0,37,0,37
961,TSLA  ,2023-02-08,2023-04-21,290.0,28,0,28
962,TSLA  ,2023-02-08,2023-04-21,291.67,3039,30,3069
963,TSLA  ,2023-02-08,2023-04-21,300.0,7787,37,7824
964,TSLA  ,2023-02-08,2023-04-21,308.33,4536,25,4561
965,TSLA  ,2023-02-08,2023-04-21,316.67,21937,1,21938
966,TSLA  ,2023-02-08,2023-04-21,325.0,2364,0,2364
967,TSLA  ,2023-02-08,2023-04-21,333.33,4471,0,4471
968,TSLA  ,2023-02-08,2023-04-21,341.67,741,8,749
969,TSLA  ,2023-02-08,2023-04-21,350.0,3045,0,3045
970,TSLA  ,2023-02-08,2023-04-21,358.33,902,0,902
971,TSLA  ,2023-02-08,2023-04-21,366.67,1066,4,1070
972,TSLA  ,2023-02-08,2023-04-21,375.0,1058,8,1066
973,TSLA  ,2023-02-08,2023-04-21,383.33,649,3,652
974,TSLA  ,2023-02-08,2023-04-21,391.67,373,0,373
975,TSLA  ,2023-02-08,2023-04-21,400.0,2687,0,2687
976,TSLA  ,2023-02-08,2023-04-21,408.33,406,0,406
977,TSLA  ,2023-02-08,2023-04-21,416.67,1140,0,1140
978,TSLA  ,2023-02-08,2023-04-21,425.0,4777,0,4777
979,TSLA  ,2023-02-08,2023-04-21,433.33,2787,0,2787
980,TSLA  ,2023-02-08,2023-04-21,441.67,707,0,707
981,TSLA  ,2023-02-08,2023-04-21,450.0,939,0,939
982,TSLA  ,2023-02-08,2023-04-21,458.33,3203,0,3203
983,TSLA  ,2023-02-08,2023-04-21,466.67,438,0,438
984,TSLA  ,2023-02-08,2023-04-21,475.0,1600,0,1600
985,TSLA  ,2023-02-08,2023-04-21,483.33,844,0,844
986,TSLA  ,2023-02-08,2023-04-21,491.67,175,0,175
987,TSLA  ,2023-02-08,2023-04-21,500.0,2013,0,2013
988,TSLA  ,2023-02-08,2023-04-21,508.33,846,0,846
989,TSLA  ,2023-02-08,2023-04-21,516.67,509,0,509
990,TSLA  ,2023-02-08,2023-04-21,525.0,423,0,423
991,TSLA  ,2023-02-08,2023-04-21,533.33,487,0,487
992,TSLA  ,2023-02-08,2023-04-21,541.67,468,0,468
993,TSLA  ,2023-02-08,2023-04-21,550.0,11884,0,11884
994,TSLA  ,2023-02-08,2023-04-21,558.33,176,0,176
995,TSLA  ,2023-02-08,2023-04-21,566.67,694,0,694
996,TSLA  ,2023-02-08,2023-04-21,575.0,2190,0,2190
997,TSLA  ,2023-02-08,2023-04-21,583.33,868,0,868
998,TSLA  ,2023-02-08,2023-04-21,600.0,18001,0,18001
999,TSLA  ,2023-02-08,2023-05-19,50.0,62,2827,2889
1000,TSLA  ,2023-02-08,2023-05-19,55.0,51,597,648
1001,TSLA  ,2023-02-08,2023-05-19,60.0,156,950,1106
1002,TSLA  ,2023-02-08,2023-05-19,65.0,65,464,529
1003,TSLA  ,2023-02-08,2023-05-19,70.0,178,1351,1529
1004,TSLA  ,2023-02-08,2023-05-19,75.0,135,1677,1812
1005,TSLA  ,2023-02-08,2023-05-19,80.0,85,1636,1721
1006,TSLA  ,2023-02-08,2023-05-19,85.0,63,1674,1737
1007,TSLA  ,2023-02-08,2023-05-19,90.0,243,2763,3006
1008,TSLA  ,2023-02-08,2023-05-19,95.0,135,1635,1770
1009,TSLA  ,2023-02-08,2023-05-19,100.0,1068,24405,25473
1010,TSLA  ,2023-02-08,2023-05-19,105.0,273,6119,6392
1011,TSLA  ,2023-02-08,2023-05-19,110.0,15994,7283,23277
1012,TSLA  ,2023-02-08,2023-05-19,115.0,1353,1897,3250
1013,TSLA  ,2023-02-08,2023-05-19,120.0,2133,7806,9939
1014,TSLA  ,2023-02-08,2023-05-19,125.0,3627,2492,6119
1015,TSLA  ,2023-02-08,2023-05-19,130.0,2748,4936,7684
1016,TSLA  ,2023-02-08,2023-05-19,135.0,1996,2082,4078
1017,TSLA  ,2023-02-08,2023-05-19,140.0,1938,11214,13152
1018,TSLA  ,2023-02-08,2023-05-19,145.0,2317,2411,4728
1019,TSLA  ,2023-02-08,2023-05-19,150.0,4104,4005,8109
1020,TSLA  ,2023-02-08,2023-05-19,155.0,1545,1385,2930
1021,TSLA  ,2023-02-08,2023-05-19,160.0,3100,4557,7657
1022,TSLA  ,2023-02-08,2023-05-19,165.0,1374,1361,2735
1023,TSLA  ,2023-02-08,2023-05-19,170.0,2795,2929,5724
1024,TSLA  ,2023-02-08,2023-05-19,175.0,2059,1511,3570
1025,TSLA  ,2023-02-08,2023-05-19,180.0,8171,5771,13942
1026,TSLA  ,2023-02-08,2023-05-19,185.0,1772,1362,3134
1027,TSLA  ,2023-02-08,2023-05-19,190.0,2441,3060,5501
1028,TSLA  ,2023-02-08,2023-05-19,195.0,2438,2075,4513
1029,TSLA  ,2023-02-08,2023-05-19,200.0,6321,1826,8147
1030,TSLA  ,2023-02-08,2023-05-19,205.0,3830,1148,4978
1031,TSLA  ,2023-02-08,2023-05-19,210.0,9356,454,9810
1032,TSLA  ,2023-02-08,2023-05-19,215.0,2160,728,2888
1033,TSLA  ,2023-02-08,2023-05-19,220.0,2202,650,2852
1034,TSLA  ,2023-02-08,2023-05-19,225.0,949,15,964
1035,TSLA  ,2023-02-08,2023-05-19,230.0,1639,38,1677
1036,TSLA  ,2023-02-08,2023-05-19,235.0,976,104,1080
1037,TSLA  ,2023-02-08,2023-05-19,240.0,2227,83,2310
1038,TSLA  ,2023-02-08,2023-05-19,245.0,314,127,441
1039,TSLA  ,2023-02-08,2023-05-19,250.0,1372,38,1410
1040,TSLA  ,2023-02-08,2023-05-19,260.0,520,107,627
1041,TSLA  ,2023-02-08,2023-05-19,270.0,1542,121,1663
1042,TSLA  ,2023-02-08,2023-05-19,280.0,347,22,369
1043,TSLA  ,2023-02-08,2023-05-19,290.0,339,367,706
1044,TSLA  ,2023-02-08,2023-05-19,300.0,996,538,1534
1045,TSLA  ,2023-02-08,2023-05-19,310.0,317,5254,5571
1046,TSLA  ,2023-02-08,2023-05-19,320.0,530,1169,1699
1047,TSLA  ,2023-02-08,2023-05-19,330.0,288,26,314
1048,TSLA  ,2023-02-08,2023-05-19,340.0,189,1,190
1049,TSLA  ,2023-02-08,2023-05-19,350.0,229,0,229
1050,TSLA  ,2023-02-08,2023-05-19,360.0,705,1,706
1051,TSLA  ,2023-02-08,2023-05-19,370.0,84,0,84
1052,TSLA  ,2023-02-08,2023-05-19,380.0,18,0,18
1053,TSLA  ,2023-02-08,2023-05-19,390.0,736,0,736
1054,TSLA  ,2023-02-08,2023-06-16,1.67,108,41907,42015
1055,TSLA  ,2023-02-08,2023-06-16,3.33,402,5010,5412
1056,TSLA  ,2023-02-08,2023-06-16,5.0,108,1684,1792
1057,TSLA  ,2023-02-08,2023-06-16,6.67,75,1309,1384
1058,TSLA  ,2023-02-08,2023-06-16,8.33,425,2371,2796
1059,TSLA  ,2023-02-08,2023-06-16,10.0,3234,3724,6958
1060,TSLA  ,2023-02-08,2023-06-16,11.67,155,8573,8728
1061,TSLA  ,2023-02-08,2023-06-16,13.33,1234,5641,6875
1062,TSLA  ,2023-02-08,2023-06-16,15.0,168,4019,4187
1063,TSLA  ,2023-02-08,2023-06-16,16.67,489,9827,10316
1064,TSLA  ,2023-02-08,2023-06-16,18.33,88,4924,5012
1065,TSLA  ,2023-02-08,2023-06-16,33.33,862,16381,17243
1066,TSLA  ,2023-02-08,2023-06-16,50.0,1109,17351,18460
1067,TSLA  ,2023-02-08,2023-06-16,55.0,31,7326,7357
1068,TSLA  ,2023-02-08,2023-06-16,60.0,15,2270,2285
1069,TSLA  ,2023-02-08,2023-06-16,65.0,4,617,621
1070,TSLA  ,2023-02-08,2023-06-16,66.67,1036,14226,15262
1071,TSLA  ,2023-02-08,2023-06-16,70.0,54,4041,4095
1072,TSLA  ,2023-02-08,2023-06-16,75.0,86,6568,6654
1073,TSLA  ,2023-02-08,2023-06-16,80.0,189,3705,3894
1074,TSLA  ,2023-02-08,2023-06-16,83.33,716,5091,5807
1075,TSLA  ,2023-02-08,2023-06-16,85.0,86,4255,4341
1076,TSLA  ,2023-02-08,2023-06-16,90.0,202,3210,3412
1077,TSLA  ,2023-02-08,2023-06-16,95.0,173,1608,1781
1078,TSLA  ,2023-02-08,2023-06-16,100.0,3477,27138,30615
1079,TSLA  ,2023-02-08,2023-06-16,105.0,368,5365,5733
1080,TSLA  ,2023-02-08,2023-06-16,110.0,1167,5767,6934
1081,TSLA  ,2023-02-08,2023-06-16,115.0,588,2909,3497
1082,TSLA  ,2023-02-08,2023-06-16,116.67,1785,5250,7035
1083,TSLA  ,2023-02-08,2023-06-16,120.0,3450,8805,12255
1084,TSLA  ,2023-02-08,2023-06-16,123.33,448,1151,1599
1085,TSLA  ,2023-02-08,2023-06-16,125.0,4108,7466,11574
1086,TSLA  ,2023-02-08,2023-06-16,126.67,867,1325,2192
1087,TSLA  ,2023-02-08,2023-06-16,130.0,3727,8605,12332
1088,TSLA  ,2023-02-08,2023-06-16,133.33,2540,9930,12470
1089,TSLA  ,2023-02-08,2023-06-16,135.0,2776,2726,5502
1090,TSLA  ,2023-02-08,2023-06-16,136.67,1079,2571,3650
1091,TSLA  ,2023-02-08,2023-06-16,140.0,7835,5882,13717
1092,TSLA  ,2023-02-08,2023-06-16,143.33,1278,3393,4671
1093,TSLA  ,2023-02-08,2023-06-16,145.0,2183,3412,5595
1094,TSLA  ,2023-02-08,2023-06-16,146.67,1596,1914,3510
1095,TSLA  ,2023-02-08,2023-06-16,150.0,13079,11279,24358
1096,TSLA  ,2023-02-08,2023-06-16,153.33,2469,3368,5837
1097,TSLA  ,2023-02-08,2023-06-16,155.0,1243,3082,4325
1098,TSLA  ,2023-02-08,2023-06-16,156.67,1688,789,2477
1099,TSLA  ,2023-02-08,2023-06-16,160.0,6689,6861,13550
1100,TSLA  ,2023-02-08,2023-06-16,163.33,954,1204,2158
1101,TSLA  ,2023-02-08,2023-06-16,165.0,1829,2710,4539
1102,TSLA  ,2023-02-08,2023-06-16,166.67,3729,13440,17169
1103,TSLA  ,2023-02-08,2023-06-16,170.0,2980,3723,6703
1104,TSLA  ,2023-02-08,2023-06-16,173.33,1454,6862,8316
1105,TSLA  ,2023-02-08,2023-06-16,175.0,3151,4306,7457
1106,TSLA  ,2023-02-08,2023-06-16,180.0,9437,6299,15736
1107,TSLA  ,2023-02-08,2023-06-16,183.33,10212,10164,20376
1108,TSLA  ,2023-02-08,2023-06-16,185.0,8232,5918,14150
1109,TSLA  ,2023-02-08,2023-06-16,186.67,904,1826,2730
1110,TSLA  ,2023-02-08,2023-06-16,190.0,5907,4647,10554
1111,TSLA  ,2023-02-08,2023-06-16,193.33,2108,7853,9961
1112,TSLA  ,2023-02-08,2023-06-16,195.0,2985,2534,5519
1113,TSLA  ,2023-02-08,2023-06-16,200.0,25307,23717,49024
1114,TSLA  ,2023-02-08,2023-06-16,205.0,2667,895,3562
1115,TSLA  ,2023-02-08,2023-06-16,206.67,2160,3413,5573
1116,TSLA  ,2023-02-08,2023-06-16,210.0,4413,969,5382
1117,TSLA  ,2023-02-08,2023-06-16,213.33,1579,2597,4176
1118,TSLA  ,2023-02-08,2023-06-16,215.0,3267,1066,4333
1119,TSLA  ,2023-02-08,2023-06-16,216.67,6963,6140,13103
1120,TSLA  ,2023-02-08,2023-06-16,220.0,7457,6641,14098
1121,TSLA  ,2023-02-08,2023-06-16,225.0,1975,1190,3165
1122,TSLA  ,2023-02-08,2023-06-16,226.67,1358,1920,3278
1123,TSLA  ,2023-02-08,2023-06-16,230.0,6545,2913,9458
1124,TSLA  ,2023-02-08,2023-06-16,233.33,10800,7298,18098
1125,TSLA  ,2023-02-08,2023-06-16,235.0,2510,662,3172
1126,TSLA  ,2023-02-08,2023-06-16,240.0,6395,3164,9559
1127,TSLA  ,2023-02-08,2023-06-16,243.33,1319,1697,3016
1128,TSLA  ,2023-02-08,2023-06-16,245.0,1532,63,1595
1129,TSLA  ,2023-02-08,2023-06-16,246.67,3021,89,3110
1130,TSLA  ,2023-02-08,2023-06-16,250.0,14089,3364,17453
1131,TSLA  ,2023-02-08,2023-06-16,253.33,1227,195,1422
1132,TSLA  ,2023-02-08,2023-06-16,255.0,1005,73,1078
1133,TSLA  ,2023-02-08,2023-06-16,260.0,4841,80,4921
1134,TSLA  ,2023-02-08,2023-06-16,265.0,1939,51,1990
1135,TSLA  ,2023-02-08,2023-06-16,266.67,7294,408,7702
1136,TSLA  ,2023-02-08,2023-06-16,270.0,1338,9,1347
1137,TSLA  ,2023-02-08,2023-06-16,273.33,972,1051,2023
1138,TSLA  ,2023-02-08,2023-06-16,275.0,2253,5,2258
1139,TSLA  ,2023-02-08,2023-06-16,280.0,3577,84,3661
1140,TSLA  ,2023-02-08,2023-06-16,283.33,4541,51,4592
1141,TSLA  ,2023-02-08,2023-06-16,285.0,940,2,942
1142,TSLA  ,2023-02-08,2023-06-16,286.67,766,30,796
1143,TSLA  ,2023-02-08,2023-06-16,290.0,705,823,1528
1144,TSLA  ,2023-02-08,2023-06-16,293.33,1685,62,1747
1145,TSLA  ,2023-02-08,2023-06-16,295.0,319,258,577
1146,TSLA  ,2023-02-08,2023-06-16,300.0,17378,90,17468
1147,TSLA  ,2023-02-08,2023-06-16,305.0,3119,5,3124
1148,TSLA  ,2023-02-08,2023-06-16,306.67,1458,31,1489
1149,TSLA  ,2023-02-08,2023-06-16,310.0,1498,46,1544
1150,TSLA  ,2023-02-08,2023-06-16,313.33,517,36,553
1151,TSLA  ,2023-02-08,2023-06-16,315.0,274,82,356
1152,TSLA  ,2023-02-08,2023-06-16,316.67,6690,241,6931
1153,TSLA  ,2023-02-08,2023-06-16,320.0,2329,3,2332
1154,TSLA  ,2023-02-08,2023-06-16,326.67,9684,6,9690
1155,TSLA  ,2023-02-08,2023-06-16,330.0,1088,48,1136
1156,TSLA  ,2023-02-08,2023-06-16,333.33,33586,231,33817
1157,TSLA  ,2023-02-08,2023-06-16,340.0,1599,3,1602
1158,TSLA  ,2023-02-08,2023-06-16,346.67,1064,0,1064
1159,TSLA  ,2023-02-08,2023-06-16,350.0,8428,331,8759
1160,TSLA  ,2023-02-08,2023-06-16,353.33,837,0,837
1161,TSLA  ,2023-02-08,2023-06-16,360.0,2036,1,2037
1162,TSLA  ,2023-02-08,2023-06-16,366.67,10870,450,11320
1163,TSLA  ,2023-02-08,2023-06-16,370.0,787,0,787
1164,TSLA  ,2023-02-08,2023-06-16,383.33,11768,0,11768
1165,TSLA  ,2023-02-08,2023-06-16,400.0,18830,904,19734
1166,TSLA  ,2023-02-08,2023-06-16,416.67,3609,0,3609
1167,TSLA  ,2023-02-08,2023-06-16,433.33,9614,0,9614
1168,TSLA  ,2023-02-08,2023-06-16,450.0,8023,0,8023
1169,TSLA  ,2023-02-08,2023-06-16,466.67,20796,0,20796
1170,TSLA  ,2023-02-08,2023-06-16,483.33,8271,0,8271
1171,TSLA  ,2023-02-08,2023-06-16,500.0,23866,0,23866
1172,TSLA  ,2023-02-08,2023-06-16,516.67,2502,0,2502
1173,TSLA  ,2023-02-08,2023-06-16,533.33,4883,0,4883
1174,TSLA  ,2023-02-08,2023-06-16,550.0,6226,0,6226
1175,TSLA  ,2023-02-08,2023-06-16,558.33,1712,0,1712
1176,TSLA  ,2023-02-08,2023-06-16,566.67,1359,0,1359
1177,TSLA  ,2023-02-08,2023-06-16,575.0,697,0,697
1178,TSLA  ,2023-02-08,2023-06-16,583.33,1212,0,1212
1179,TSLA  ,2023-02-08,2023-06-16,591.67,401,0,401
1180,TSLA  ,2023-02-08,2023-06-16,600.0,6324,0,6324
1181,TSLA  ,2023-02-08,2023-06-16,608.33,1090,0,1090
1182,TSLA  ,2023-02-08,2023-06-16,616.67,811,0,811
1183,TSLA  ,2023-02-08,2023-06-16,625.0,2164,0,2164
1184,TSLA  ,2023-02-08,2023-06-16,633.33,5537,0,5537
1185,TSLA  ,2023-02-08,2023-06-16,641.67,436,0,436
1186,TSLA  ,2023-02-08,2023-06-16,650.0,532,0,532
1187,TSLA  ,2023-02-08,2023-06-16,666.67,18021,0,18021
1188,TSLA  ,2023-02-08,2023-06-16,675.0,941,0,941
1189,TSLA  ,2023-02-08,2023-06-16,683.33,556,0,556
1190,TSLA  ,2023-02-08,2023-06-16,691.67,885,0,885
1191,TSLA  ,2023-02-08,2023-06-16,700.0,2642,0,2642
1192,TSLA  ,2023-02-08,2023-06-16,708.33,537,0,537
1193,TSLA  ,2023-02-08,2023-06-16,716.67,713,0,713
1194,TSLA  ,2023-02-08,2023-06-16,725.0,1138,0,1138
1195,TSLA  ,2023-02-08,2023-06-16,733.33,2267,0,2267
1196,TSLA  ,2023-02-08,2023-06-16,741.67,768,0,768
1197,TSLA  ,2023-02-08,2023-06-16,750.0,12302,0,12302
1198,TSLA  ,2023-02-08,2023-06-16,758.33,1292,0,1292
1199,TSLA  ,2023-02-08,2023-06-16,766.67,1267,0,1267
1200,TSLA  ,2023-02-08,2023-06-16,775.0,1087,0,1087
1201,TSLA  ,2023-02-08,2023-06-16,783.33,2174,0,2174
1202,TSLA  ,2023-02-08,2023-06-16,791.67,1830,0,1830
1203,TSLA  ,2023-02-08,2023-06-16,800.0,8969,0,8969
1204,TSLA  ,2023-02-08,2023-06-16,808.33,1317,0,1317
1205,TSLA  ,2023-02-08,2023-06-16,816.67,1854,0,1854
1206,TSLA  ,2023-02-08,2023-06-16,825.0,38906,0,38906
1207,TSLA  ,2023-02-08,2023-07-21,5.0,32,721,753
1208,TSLA  ,2023-02-08,2023-07-21,10.0,5,906,911
1209,TSLA  ,2023-02-08,2023-07-21,15.0,4,329,333
1210,TSLA  ,2023-02-08,2023-07-21,20.0,12,1216,1228
1211,TSLA  ,2023-02-08,2023-07-21,25.0,27,1000,1027
1212,TSLA  ,2023-02-08,2023-07-21,30.0,111,1210,1321
1213,TSLA  ,2023-02-08,2023-07-21,35.0,45,777,822
1214,TSLA  ,2023-02-08,2023-07-21,40.0,22,1138,1160
1215,TSLA  ,2023-02-08,2023-07-21,45.0,38,405,443
1216,TSLA  ,2023-02-08,2023-07-21,50.0,66,5088,5154
1217,TSLA  ,2023-02-08,2023-07-21,55.0,86,1848,1934
1218,TSLA  ,2023-02-08,2023-07-21,60.0,94,3325,3419
1219,TSLA  ,2023-02-08,2023-07-21,65.0,86,394,480
1220,TSLA  ,2023-02-08,2023-07-21,70.0,25,2593,2618
1221,TSLA  ,2023-02-08,2023-07-21,75.0,63,4165,4228
1222,TSLA  ,2023-02-08,2023-07-21,80.0,79,3662,3741
1223,TSLA  ,2023-02-08,2023-07-21,85.0,54,1380,1434
1224,TSLA  ,2023-02-08,2023-07-21,90.0,125,3328,3453
1225,TSLA  ,2023-02-08,2023-07-21,95.0,59,1614,1673
1226,TSLA  ,2023-02-08,2023-07-21,100.0,295,5494,5789
1227,TSLA  ,2023-02-08,2023-07-21,105.0,333,2485,2818
1228,TSLA  ,2023-02-08,2023-07-21,110.0,1126,2966,4092
1229,TSLA  ,2023-02-08,2023-07-21,115.0,466,1007,1473
1230,TSLA  ,2023-02-08,2023-07-21,120.0,1220,4455,5675
1231,TSLA  ,2023-02-08,2023-07-21,125.0,1409,2040,3449
1232,TSLA  ,2023-02-08,2023-07-21,130.0,1514,1681,3195
1233,TSLA  ,2023-02-08,2023-07-21,135.0,1148,3018,4166
1234,TSLA  ,2023-02-08,2023-07-21,140.0,1527,2887,4414
1235,TSLA  ,2023-02-08,2023-07-21,145.0,1075,2152,3227
1236,TSLA  ,2023-02-08,2023-07-21,150.0,3229,3398,6627
1237,TSLA  ,2023-02-08,2023-07-21,155.0,1654,2873,4527
1238,TSLA  ,2023-02-08,2023-07-21,160.0,1686,1338,3024
1239,TSLA  ,2023-02-08,2023-07-21,165.0,605,1322,1927
1240,TSLA  ,2023-02-08,2023-07-21,170.0,1762,1931,3693
1241,TSLA  ,2023-02-08,2023-07-21,175.0,1711,1246,2957
1242,TSLA  ,2023-02-08,2023-07-21,180.0,2062,1444,3506
1243,TSLA  ,2023-02-08,2023-07-21,185.0,3919,12868,16787
1244,TSLA  ,2023-02-08,2023-07-21,190.0,2104,2159,4263
1245,TSLA  ,2023-02-08,2023-07-21,195.0,1360,1916,3276
1246,TSLA  ,2023-02-08,2023-07-21,200.0,5247,2099,7346
1247,TSLA  ,2023-02-08,2023-07-21,205.0,2131,648,2779
1248,TSLA  ,2023-02-08,2023-07-21,210.0,5134,764,5898
1249,TSLA  ,2023-02-08,2023-07-21,215.0,3199,797,3996
1250,TSLA  ,2023-02-08,2023-07-21,220.0,2906,1348,4254
1251,TSLA  ,2023-02-08,2023-07-21,225.0,2715,1717,4432
1252,TSLA  ,2023-02-08,2023-07-21,230.0,2487,746,3233
1253,TSLA  ,2023-02-08,2023-07-21,235.0,942,519,1461
1254,TSLA  ,2023-02-08,2023-07-21,240.0,1258,1614,2872
1255,TSLA  ,2023-02-08,2023-07-21,245.0,753,663,1416
1256,TSLA  ,2023-02-08,2023-07-21,250.0,24352,1575,25927
1257,TSLA  ,2023-02-08,2023-07-21,255.0,842,641,1483
1258,TSLA  ,2023-02-08,2023-07-21,260.0,620,69,689
1259,TSLA  ,2023-02-08,2023-07-21,265.0,239,9,248
1260,TSLA  ,2023-02-08,2023-07-21,270.0,416,126,542
1261,TSLA  ,2023-02-08,2023-07-21,275.0,266,76,342
1262,TSLA  ,2023-02-08,2023-07-21,280.0,1212,141,1353
1263,TSLA  ,2023-02-08,2023-07-21,285.0,828,142,970
1264,TSLA  ,2023-02-08,2023-07-21,290.0,461,31,492
1265,TSLA  ,2023-02-08,2023-07-21,295.0,134,11,145
1266,TSLA  ,2023-02-08,2023-07-21,300.0,1362,4,1366
1267,TSLA  ,2023-02-08,2023-07-21,305.0,197,5,202
1268,TSLA  ,2023-02-08,2023-07-21,310.0,728,6,734
1269,TSLA  ,2023-02-08,2023-07-21,315.0,275,1,276
1270,TSLA  ,2023-02-08,2023-07-21,320.0,450,0,450
1271,TSLA  ,2023-02-08,2023-07-21,325.0,604,0,604
1272,TSLA  ,2023-02-08,2023-07-21,330.0,436,26,462
1273,TSLA  ,2023-02-08,2023-07-21,335.0,150,7,157
1274,TSLA  ,2023-02-08,2023-07-21,340.0,428,16,444
1275,TSLA  ,2023-02-08,2023-07-21,345.0,155,0,155
1276,TSLA  ,2023-02-08,2023-07-21,350.0,613,1,614
1277,TSLA  ,2023-02-08,2023-07-21,355.0,264,1,265
1278,TSLA  ,2023-02-08,2023-07-21,360.0,641,0,641
1279,TSLA  ,2023-02-08,2023-07-21,365.0,955,0,955
1280,TSLA  ,2023-02-08,2023-07-21,370.0,951,0,951
1281,TSLA  ,2023-02-08,2023-07-21,375.0,3212,0,3212
1282,TSLA  ,2023-02-08,2023-07-21,380.0,123,0,123
1283,TSLA  ,2023-02-08,2023-07-21,390.0,200,0,200
1284,TSLA  ,2023-02-08,2023-09-15,1.67,861,20021,20882
1285,TSLA  ,2023-02-08,2023-09-15,3.33,1086,2849,3935
1286,TSLA  ,2023-02-08,2023-09-15,5.0,25,942,967
1287,TSLA  ,2023-02-08,2023-09-15,6.67,29,3364,3393
1288,TSLA  ,2023-02-08,2023-09-15,8.33,32,1175,1207
1289,TSLA  ,2023-02-08,2023-09-15,10.0,26,2172,2198
1290,TSLA  ,2023-02-08,2023-09-15,11.67,49,617,666
1291,TSLA  ,2023-02-08,2023-09-15,13.33,83,230,313
1292,TSLA  ,2023-02-08,2023-09-15,15.0,0,116,116
1293,TSLA  ,2023-02-08,2023-09-15,16.67,143,4180,4323
1294,TSLA  ,2023-02-08,2023-09-15,30.0,0,66,66
1295,TSLA  ,2023-02-08,2023-09-15,33.33,3118,11373,14491
1296,TSLA  ,2023-02-08,2023-09-15,35.0,2,32,34
1297,TSLA  ,2023-02-08,2023-09-15,40.0,3,182,185
1298,TSLA  ,2023-02-08,2023-09-15,45.0,3,47,50
1299,TSLA  ,2023-02-08,2023-09-15,50.0,411,7472,7883
1300,TSLA  ,2023-02-08,2023-09-15,55.0,22,2386,2408
1301,TSLA  ,2023-02-08,2023-09-15,60.0,30,4731,4761
1302,TSLA  ,2023-02-08,2023-09-15,65.0,4,2016,2020
1303,TSLA  ,2023-02-08,2023-09-15,66.67,442,5666,6108
1304,TSLA  ,2023-02-08,2023-09-15,70.0,83,658,741
1305,TSLA  ,2023-02-08,2023-09-15,75.0,26,539,565
1306,TSLA  ,2023-02-08,2023-09-15,80.0,259,793,1052
1307,TSLA  ,2023-02-08,2023-09-15,83.33,407,4454,4861
1308,TSLA  ,2023-02-08,2023-09-15,85.0,50,314,364
1309,TSLA  ,2023-02-08,2023-09-15,90.0,485,2625,3110
1310,TSLA  ,2023-02-08,2023-09-15,95.0,70,2440,2510
1311,TSLA  ,2023-02-08,2023-09-15,100.0,3260,11983,15243
1312,TSLA  ,2023-02-08,2023-09-15,105.0,87,2148,2235
1313,TSLA  ,2023-02-08,2023-09-15,108.33,400,1883,2283
1314,TSLA  ,2023-02-08,2023-09-15,110.0,1369,1476,2845
1315,TSLA  ,2023-02-08,2023-09-15,115.0,180,2991,3171
1316,TSLA  ,2023-02-08,2023-09-15,116.67,569,12245,12814
1317,TSLA  ,2023-02-08,2023-09-15,120.0,353,1622,1975
1318,TSLA  ,2023-02-08,2023-09-15,123.33,544,1344,1888
1319,TSLA  ,2023-02-08,2023-09-15,125.0,1741,7082,8823
1320,TSLA  ,2023-02-08,2023-09-15,126.67,125,1074,1199
1321,TSLA  ,2023-02-08,2023-09-15,130.0,1397,4992,6389
1322,TSLA  ,2023-02-08,2023-09-15,133.33,201,2371,2572
1323,TSLA  ,2023-02-08,2023-09-15,135.0,214,1194,1408
1324,TSLA  ,2023-02-08,2023-09-15,136.67,283,923,1206
1325,TSLA  ,2023-02-08,2023-09-15,140.0,1788,1945,3733
1326,TSLA  ,2023-02-08,2023-09-15,141.67,769,1685,2454
1327,TSLA  ,2023-02-08,2023-09-15,143.33,274,1539,1813
1328,TSLA  ,2023-02-08,2023-09-15,145.0,352,2673,3025
1329,TSLA  ,2023-02-08,2023-09-15,146.67,1373,1081,2454
1330,TSLA  ,2023-02-08,2023-09-15,150.0,33842,9218,43060
1331,TSLA  ,2023-02-08,2023-09-15,153.33,30482,1831,32313
1332,TSLA  ,2023-02-08,2023-09-15,155.0,415,384,799
1333,TSLA  ,2023-02-08,2023-09-15,156.67,395,650,1045
1334,TSLA  ,2023-02-08,2023-09-15,158.33,319,573,892
1335,TSLA  ,2023-02-08,2023-09-15,160.0,3742,5702,9444
1336,TSLA  ,2023-02-08,2023-09-15,163.33,416,1493,1909
1337,TSLA  ,2023-02-08,2023-09-15,165.0,1298,718,2016
1338,TSLA  ,2023-02-08,2023-09-15,166.67,1398,3090,4488
1339,TSLA  ,2023-02-08,2023-09-15,170.0,648,703,1351
1340,TSLA  ,2023-02-08,2023-09-15,173.33,10322,3028,13350
1341,TSLA  ,2023-02-08,2023-09-15,175.0,10900,7643,18543
1342,TSLA  ,2023-02-08,2023-09-15,180.0,33735,6348,40083
1343,TSLA  ,2023-02-08,2023-09-15,183.33,32295,5269,37564
1344,TSLA  ,2023-02-08,2023-09-15,185.0,328,243,571
1345,TSLA  ,2023-02-08,2023-09-15,186.67,528,3351,3879
1346,TSLA  ,2023-02-08,2023-09-15,190.0,851,1382,2233
1347,TSLA  ,2023-02-08,2023-09-15,191.67,492,1178,1670
1348,TSLA  ,2023-02-08,2023-09-15,193.33,950,2814,3764
1349,TSLA  ,2023-02-08,2023-09-15,195.0,336,553,889
1350,TSLA  ,2023-02-08,2023-09-15,200.0,11811,17091,28902
1351,TSLA  ,2023-02-08,2023-09-15,205.0,329,138,467
1352,TSLA  ,2023-02-08,2023-09-15,206.67,982,423,1405
1353,TSLA  ,2023-02-08,2023-09-15,208.33,567,2165,2732
1354,TSLA  ,2023-02-08,2023-09-15,210.0,674,229,903
1355,TSLA  ,2023-02-08,2023-09-15,213.33,591,1272,1863
1356,TSLA  ,2023-02-08,2023-09-15,215.0,613,126,739
1357,TSLA  ,2023-02-08,2023-09-15,216.67,2287,4251,6538
1358,TSLA  ,2023-02-08,2023-09-15,220.0,7457,3126,10583
1359,TSLA  ,2023-02-08,2023-09-15,225.0,2476,3312,5788
1360,TSLA  ,2023-02-08,2023-09-15,226.67,1245,1438,2683
1361,TSLA  ,2023-02-08,2023-09-15,230.0,2046,688,2734
1362,TSLA  ,2023-02-08,2023-09-15,233.33,2792,2845,5637
1363,TSLA  ,2023-02-08,2023-09-15,235.0,226,240,466
1364,TSLA  ,2023-02-08,2023-09-15,240.0,1240,2032,3272
1365,TSLA  ,2023-02-08,2023-09-15,241.67,1110,719,1829
1366,TSLA  ,2023-02-08,2023-09-15,245.0,63,208,271
1367,TSLA  ,2023-02-08,2023-09-15,246.67,507,440,947
1368,TSLA  ,2023-02-08,2023-09-15,250.0,10551,4150,14701
1369,TSLA  ,2023-02-08,2023-09-15,253.33,840,521,1361
1370,TSLA  ,2023-02-08,2023-09-15,255.0,45,11,56
1371,TSLA  ,2023-02-08,2023-09-15,258.33,729,2408,3137
1372,TSLA  ,2023-02-08,2023-09-15,260.0,11774,1418,13192
1373,TSLA  ,2023-02-08,2023-09-15,265.0,58,118,176
1374,TSLA  ,2023-02-08,2023-09-15,266.67,2417,319,2736
1375,TSLA  ,2023-02-08,2023-09-15,270.0,313,162,475
1376,TSLA  ,2023-02-08,2023-09-15,273.33,723,355,1078
1377,TSLA  ,2023-02-08,2023-09-15,275.0,2825,344,3169
1378,TSLA  ,2023-02-08,2023-09-15,280.0,2050,553,2603
1379,TSLA  ,2023-02-08,2023-09-15,283.33,1230,264,1494
1380,TSLA  ,2023-02-08,2023-09-15,286.67,535,96,631
1381,TSLA  ,2023-02-08,2023-09-15,290.0,21,0,21
1382,TSLA  ,2023-02-08,2023-09-15,291.67,948,332,1280
1383,TSLA  ,2023-02-08,2023-09-15,293.33,1318,389,1707
1384,TSLA  ,2023-02-08,2023-09-15,300.0,8192,1006,9198
1385,TSLA  ,2023-02-08,2023-09-15,306.67,2670,328,2998
1386,TSLA  ,2023-02-08,2023-09-15,308.33,781,334,1115
1387,TSLA  ,2023-02-08,2023-09-15,313.33,885,286,1171
1388,TSLA  ,2023-02-08,2023-09-15,316.67,1582,161,1743
1389,TSLA  ,2023-02-08,2023-09-15,320.0,1757,168,1925
1390,TSLA  ,2023-02-08,2023-09-15,325.0,2738,75,2813
1391,TSLA  ,2023-02-08,2023-09-15,326.67,1108,5,1113
1392,TSLA  ,2023-02-08,2023-09-15,333.33,6449,84,6533
1393,TSLA  ,2023-02-08,2023-09-15,340.0,23039,147,23186
1394,TSLA  ,2023-02-08,2023-09-15,341.67,177,187,364
1395,TSLA  ,2023-02-08,2023-09-15,346.67,520,135,655
1396,TSLA  ,2023-02-08,2023-09-15,350.0,17686,318,18004
1397,TSLA  ,2023-02-08,2023-09-15,353.33,22091,149,22240
1398,TSLA  ,2023-02-08,2023-09-15,358.33,430,287,717
1399,TSLA  ,2023-02-08,2023-09-15,360.0,3297,341,3638
1400,TSLA  ,2023-02-08,2023-09-15,366.67,2931,489,3420
1401,TSLA  ,2023-02-08,2023-09-15,375.0,3211,161,3372
1402,TSLA  ,2023-02-08,2023-09-15,383.33,4532,15,4547
1403,TSLA  ,2023-02-08,2023-09-15,391.67,826,1,827
1404,TSLA  ,2023-02-08,2023-09-15,400.0,5685,67,5752
1405,TSLA  ,2023-02-08,2023-09-15,408.33,1516,0,1516
1406,TSLA  ,2023-02-08,2023-09-15,416.67,969,0,969
1407,TSLA  ,2023-02-08,2023-09-15,425.0,3263,0,3263
1408,TSLA  ,2023-02-08,2023-09-15,433.33,4954,8,4962
1409,TSLA  ,2023-02-08,2023-09-15,441.67,1019,0,1019
1410,TSLA  ,2023-02-08,2023-09-15,450.0,2359,0,2359
1411,TSLA  ,2023-02-08,2023-09-15,458.33,402,0,402
1412,TSLA  ,2023-02-08,2023-09-15,466.67,2691,9,2700
1413,TSLA  ,2023-02-08,2023-09-15,475.0,330,0,330
1414,TSLA  ,2023-02-08,2023-09-15,483.33,662,0,662
1415,TSLA  ,2023-02-08,2023-09-15,491.67,1097,0,1097
1416,TSLA  ,2023-02-08,2023-09-15,500.0,4976,0,4976
1417,TSLA  ,2023-02-08,2023-09-15,508.33,811,0,811
1418,TSLA  ,2023-02-08,2023-09-15,516.67,1262,0,1262
1419,TSLA  ,2023-02-08,2023-09-15,525.0,1191,0,1191
1420,TSLA  ,2023-02-08,2023-09-15,533.33,1601,6,1607
1421,TSLA  ,2023-02-08,2023-09-15,541.67,1161,0,1161
1422,TSLA  ,2023-02-08,2023-09-15,550.0,11713,0,11713
1423,TSLA  ,2023-02-08,2023-09-15,558.33,188,0,188
1424,TSLA  ,2023-02-08,2023-09-15,566.67,4082,0,4082
1425,TSLA  ,2023-02-08,2023-09-15,575.0,348,0,348
1426,TSLA  ,2023-02-08,2023-09-15,583.33,510,0,510
1427,TSLA  ,2023-02-08,2023-09-15,591.67,2091,0,2091
1428,TSLA  ,2023-02-08,2023-09-15,600.0,8634,0,8634
1429,TSLA  ,2023-02-08,2023-09-15,608.33,672,0,672
1430,TSLA  ,2023-02-08,2023-09-15,616.67,1025,0,1025
1431,TSLA  ,2023-02-08,2023-09-15,625.0,1052,0,1052
1432,TSLA  ,2023-02-08,2023-09-15,633.33,639,0,639
1433,TSLA  ,2023-02-08,2023-09-15,641.67,428,0,428
1434,TSLA  ,2023-02-08,2023-09-15,650.0,27276,0,27276
1435,TSLA  ,2023-02-08,2023-09-15,658.33,1206,0,1206
1436,TSLA  ,2023-02-08,2023-09-15,666.67,1303,0,1303
1437,TSLA  ,2023-02-08,2023-09-15,675.0,490,0,490
1438,TSLA  ,2023-02-08,2023-09-15,683.33,360,0,360
1439,TSLA  ,2023-02-08,2023-09-15,700.0,1534,0,1534
1440,TSLA  ,2023-02-08,2023-09-15,716.67,1139,0,1139
1441,TSLA  ,2023-02-08,2023-09-15,733.33,2327,0,2327
1442,TSLA  ,2023-02-08,2023-09-15,750.0,8206,0,8206
1443,TSLA  ,2023-02-08,2023-09-15,758.33,71282,0,71282
1444,TSLA  ,2023-02-08,2023-12-15,50.0,1277,3368,4645
1445,TSLA  ,2023-02-08,2023-12-15,55.0,64,1127,1191
1446,TSLA  ,2023-02-08,2023-12-15,60.0,37,1116,1153
1447,TSLA  ,2023-02-08,2023-12-15,65.0,4,292,296
1448,TSLA  ,2023-02-08,2023-12-15,70.0,27,3825,3852
1449,TSLA  ,2023-02-08,2023-12-15,75.0,19,3987,4006
1450,TSLA  ,2023-02-08,2023-12-15,80.0,157,840,997
1451,TSLA  ,2023-02-08,2023-12-15,85.0,2577,2372,4949
1452,TSLA  ,2023-02-08,2023-12-15,90.0,1644,5570,7214
1453,TSLA  ,2023-02-08,2023-12-15,95.0,831,467,1298
1454,TSLA  ,2023-02-08,2023-12-15,100.0,2132,5726,7858
1455,TSLA  ,2023-02-08,2023-12-15,105.0,325,634,959
1456,TSLA  ,2023-02-08,2023-12-15,110.0,737,2144,2881
1457,TSLA  ,2023-02-08,2023-12-15,115.0,1721,1056,2777
1458,TSLA  ,2023-02-08,2023-12-15,120.0,1020,1057,2077
1459,TSLA  ,2023-02-08,2023-12-15,125.0,505,965,1470
1460,TSLA  ,2023-02-08,2023-12-15,130.0,791,10694,11485
1461,TSLA  ,2023-02-08,2023-12-15,135.0,794,5867,6661
1462,TSLA  ,2023-02-08,2023-12-15,140.0,971,1317,2288
1463,TSLA  ,2023-02-08,2023-12-15,145.0,633,835,1468
1464,TSLA  ,2023-02-08,2023-12-15,150.0,1537,11890,13427
1465,TSLA  ,2023-02-08,2023-12-15,155.0,408,979,1387
1466,TSLA  ,2023-02-08,2023-12-15,160.0,2827,10770,13597
1467,TSLA  ,2023-02-08,2023-12-15,165.0,1476,458,1934
1468,TSLA  ,2023-02-08,2023-12-15,170.0,785,4423,5208
1469,TSLA  ,2023-02-08,2023-12-15,175.0,2124,372,2496
1470,TSLA  ,2023-02-08,2023-12-15,180.0,1678,314,1992
1471,TSLA  ,2023-02-08,2023-12-15,185.0,532,555,1087
1472,TSLA  ,2023-02-08,2023-12-15,190.0,1176,521,1697
1473,TSLA  ,2023-02-08,2023-12-15,195.0,753,516,1269
1474,TSLA  ,2023-02-08,2023-12-15,200.0,8753,1250,10003
1475,TSLA  ,2023-02-08,2023-12-15,205.0,6706,312,7018
1476,TSLA  ,2023-02-08,2023-12-15,210.0,2594,378,2972
1477,TSLA  ,2023-02-08,2023-12-15,215.0,1210,266,1476
1478,TSLA  ,2023-02-08,2023-12-15,220.0,1531,1074,2605
1479,TSLA  ,2023-02-08,2023-12-15,225.0,1270,244,1514
1480,TSLA  ,2023-02-08,2023-12-15,230.0,1593,674,2267
1481,TSLA  ,2023-02-08,2023-12-15,235.0,484,428,912
1482,TSLA  ,2023-02-08,2023-12-15,240.0,5744,527,6271
1483,TSLA  ,2023-02-08,2023-12-15,245.0,1866,421,2287
1484,TSLA  ,2023-02-08,2023-12-15,250.0,15701,3123,18824
1485,TSLA  ,2023-02-08,2023-12-15,260.0,10049,450,10499
1486,TSLA  ,2023-02-08,2023-12-15,270.0,3815,493,4308
1487,TSLA  ,2023-02-08,2023-12-15,280.0,365,634,999
1488,TSLA  ,2023-02-08,2023-12-15,290.0,278,412,690
1489,TSLA  ,2023-02-08,2023-12-15,300.0,890,979,1869
1490,TSLA  ,2023-02-08,2023-12-15,310.0,768,582,1350
1491,TSLA  ,2023-02-08,2023-12-15,320.0,545,500,1045
1492,TSLA  ,2023-02-08,2023-12-15,330.0,294,213,507
1493,TSLA  ,2023-02-08,2023-12-15,340.0,262,65,327
1494,TSLA  ,2023-02-08,2023-12-15,350.0,576,159,735
1495,TSLA  ,2023-02-08,2023-12-15,360.0,520,116,636
1496,TSLA  ,2023-02-08,2023-12-15,370.0,15,240,255
1497,TSLA  ,2023-02-08,2023-12-15,380.0,41,310,351
1498,TSLA  ,2023-02-08,2023-12-15,390.0,202,104,306
1499,TSLA  ,2023-02-08,2024-01-19,1.67,2469,29233,31702
1500,TSLA  ,2023-02-08,2024-01-19,3.33,966,5840,6806
1501,TSLA  ,2023-02-08,2024-01-19,5.0,256,9988,10244
1502,TSLA  ,2023-02-08,2024-01-19,6.67,75,3249,3324
1503,TSLA  ,2023-02-08,2024-01-19,8.33,3902,2746,6648
1504,TSLA  ,2023-02-08,2024-01-19,10.0,294,3992,4286
1505,TSLA  ,2023-02-08,2024-01-19,11.67,253,3172,3425
1506,TSLA  ,2023-02-08,2024-01-19,13.33,819,507,1326
1507,TSLA  ,2023-02-08,2024-01-19,15.0,279,2066,2345
1508,TSLA  ,2023-02-08,2024-01-19,16.67,486,4561,5047
1509,TSLA  ,2023-02-08,2024-01-19,18.33,393,6128,6521
1510,TSLA  ,2023-02-08,2024-01-19,20.0,260,7588,7848
1511,TSLA  ,2023-02-08,2024-01-19,21.67,108,842,950
1512,TSLA  ,2023-02-08,2024-01-19,23.33,382,3837,4219
1513,TSLA  ,2023-02-08,2024-01-19,25.0,369,2799,3168
1514,TSLA  ,2023-02-08,2024-01-19,26.67,833,1193,2026
1515,TSLA  ,2023-02-08,2024-01-19,28.33,341,850,1191
1516,TSLA  ,2023-02-08,2024-01-19,30.0,228,8801,9029
1517,TSLA  ,2023-02-08,2024-01-19,31.67,1328,1353,2681
1518,TSLA  ,2023-02-08,2024-01-19,33.33,4315,32843,37158
1519,TSLA  ,2023-02-08,2024-01-19,50.0,2159,30015,32174
1520,TSLA  ,2023-02-08,2024-01-19,55.0,81,1225,1306
1521,TSLA  ,2023-02-08,2024-01-19,60.0,250,2636,2886
1522,TSLA  ,2023-02-08,2024-01-19,65.0,266,829,1095
1523,TSLA  ,2023-02-08,2024-01-19,66.67,4705,14633,19338
1524,TSLA  ,2023-02-08,2024-01-19,70.0,143,882,1025
1525,TSLA  ,2023-02-08,2024-01-19,75.0,92,2699,2791
1526,TSLA  ,2023-02-08,2024-01-19,80.0,414,1754,2168
1527,TSLA  ,2023-02-08,2024-01-19,83.33,1066,7949,9015
1528,TSLA  ,2023-02-08,2024-01-19,85.0,513,535,1048
1529,TSLA  ,2023-02-08,2024-01-19,90.0,3540,1379,4919
1530,TSLA  ,2023-02-08,2024-01-19,95.0,3022,1374,4396
1531,TSLA  ,2023-02-08,2024-01-19,100.0,13888,38583,52471
1532,TSLA  ,2023-02-08,2024-01-19,105.0,1286,1910,3196
1533,TSLA  ,2023-02-08,2024-01-19,110.0,5031,7097,12128
1534,TSLA  ,2023-02-08,2024-01-19,115.0,4701,5576,10277
1535,TSLA  ,2023-02-08,2024-01-19,116.67,1937,8294,10231
1536,TSLA  ,2023-02-08,2024-01-19,120.0,3485,4714,8199
1537,TSLA  ,2023-02-08,2024-01-19,123.33,1985,2364,4349
1538,TSLA  ,2023-02-08,2024-01-19,125.0,2421,12636,15057
1539,TSLA  ,2023-02-08,2024-01-19,126.67,1742,6575,8317
1540,TSLA  ,2023-02-08,2024-01-19,130.0,5073,11916,16989
1541,TSLA  ,2023-02-08,2024-01-19,133.33,2438,10985,13423
1542,TSLA  ,2023-02-08,2024-01-19,135.0,1340,1285,2625
1543,TSLA  ,2023-02-08,2024-01-19,136.67,2441,2297,4738
1544,TSLA  ,2023-02-08,2024-01-19,140.0,5061,4483,9544
1545,TSLA  ,2023-02-08,2024-01-19,143.33,1687,2273,3960
1546,TSLA  ,2023-02-08,2024-01-19,145.0,763,842,1605
1547,TSLA  ,2023-02-08,2024-01-19,146.67,1026,983,2009
1548,TSLA  ,2023-02-08,2024-01-19,150.0,17521,22137,39658
1549,TSLA  ,2023-02-08,2024-01-19,153.33,10749,1044,11793
1550,TSLA  ,2023-02-08,2024-01-19,155.0,539,1456,1995
1551,TSLA  ,2023-02-08,2024-01-19,156.67,1732,803,2535
1552,TSLA  ,2023-02-08,2024-01-19,160.0,3606,12311,15917
1553,TSLA  ,2023-02-08,2024-01-19,163.33,506,7393,7899
1554,TSLA  ,2023-02-08,2024-01-19,165.0,679,453,1132
1555,TSLA  ,2023-02-08,2024-01-19,166.67,6753,6863,13616
1556,TSLA  ,2023-02-08,2024-01-19,170.0,3120,6868,9988
1557,TSLA  ,2023-02-08,2024-01-19,173.33,861,2583,3444
1558,TSLA  ,2023-02-08,2024-01-19,175.0,1714,2116,3830
1559,TSLA  ,2023-02-08,2024-01-19,176.67,1018,1262,2280
1560,TSLA  ,2023-02-08,2024-01-19,180.0,39199,9656,48855
1561,TSLA  ,2023-02-08,2024-01-19,183.33,34399,7357,41756
1562,TSLA  ,2023-02-08,2024-01-19,185.0,1621,719,2340
1563,TSLA  ,2023-02-08,2024-01-19,186.67,1255,2281,3536
1564,TSLA  ,2023-02-08,2024-01-19,190.0,1633,411,2044
1565,TSLA  ,2023-02-08,2024-01-19,193.33,2293,9732,12025
1566,TSLA  ,2023-02-08,2024-01-19,195.0,434,287,721
1567,TSLA  ,2023-02-08,2024-01-19,200.0,33317,23995,57312
1568,TSLA  ,2023-02-08,2024-01-19,203.33,6274,2220,8494
1569,TSLA  ,2023-02-08,2024-01-19,206.67,1632,1191,2823
1570,TSLA  ,2023-02-08,2024-01-19,210.0,10949,6383,17332
1571,TSLA  ,2023-02-08,2024-01-19,213.33,1566,2694,4260
1572,TSLA  ,2023-02-08,2024-01-19,216.67,9180,7347,16527
1573,TSLA  ,2023-02-08,2024-01-19,220.0,6658,7031,13689
1574,TSLA  ,2023-02-08,2024-01-19,223.33,5764,1402,7166
1575,TSLA  ,2023-02-08,2024-01-19,226.67,19991,2982,22973
1576,TSLA  ,2023-02-08,2024-01-19,230.0,14005,19006,33011
1577,TSLA  ,2023-02-08,2024-01-19,233.33,37161,13918,51079
1578,TSLA  ,2023-02-08,2024-01-19,236.67,1960,1679,3639
1579,TSLA  ,2023-02-08,2024-01-19,240.0,2415,3934,6349
1580,TSLA  ,2023-02-08,2024-01-19,243.33,1146,1969,3115
1581,TSLA  ,2023-02-08,2024-01-19,246.67,976,2115,3091
1582,TSLA  ,2023-02-08,2024-01-19,250.0,22306,5228,27534
1583,TSLA  ,2023-02-08,2024-01-19,253.33,2804,2101,4905
1584,TSLA  ,2023-02-08,2024-01-19,256.67,2829,1560,4389
1585,TSLA  ,2023-02-08,2024-01-19,260.0,7299,3162,10461
1586,TSLA  ,2023-02-08,2024-01-19,263.33,7808,2224,10032
1587,TSLA  ,2023-02-08,2024-01-19,266.67,10337,8939,19276
1588,TSLA  ,2023-02-08,2024-01-19,270.0,4569,5193,9762
1589,TSLA  ,2023-02-08,2024-01-19,273.33,3247,3091,6338
1590,TSLA  ,2023-02-08,2024-01-19,276.67,1745,1773,3518
1591,TSLA  ,2023-02-08,2024-01-19,280.0,9294,6496,15790
1592,TSLA  ,2023-02-08,2024-01-19,283.33,3102,2982,6084
1593,TSLA  ,2023-02-08,2024-01-19,286.67,2486,1503,3989
1594,TSLA  ,2023-02-08,2024-01-19,290.0,9077,556,9633
1595,TSLA  ,2023-02-08,2024-01-19,293.33,2086,1988,4074
1596,TSLA  ,2023-02-08,2024-01-19,296.67,2034,1734,3768
1597,TSLA  ,2023-02-08,2024-01-19,300.0,26252,6494,32746
1598,TSLA  ,2023-02-08,2024-01-19,303.33,3402,74,3476
1599,TSLA  ,2023-02-08,2024-01-19,306.67,6576,132,6708
1600,TSLA  ,2023-02-08,2024-01-19,310.0,3729,974,4703
1601,TSLA  ,2023-02-08,2024-01-19,313.33,1160,22,1182
1602,TSLA  ,2023-02-08,2024-01-19,316.67,4154,306,4460
1603,TSLA  ,2023-02-08,2024-01-19,320.0,5919,314,6233
1604,TSLA  ,2023-02-08,2024-01-19,323.33,467,246,713
1605,TSLA  ,2023-02-08,2024-01-19,325.0,10269,113,10382
1606,TSLA  ,2023-02-08,2024-01-19,326.67,1348,633,1981
1607,TSLA  ,2023-02-08,2024-01-19,330.0,7292,11,7303
1608,TSLA  ,2023-02-08,2024-01-19,333.33,29857,1694,31551
1609,TSLA  ,2023-02-08,2024-01-19,336.67,1466,7,1473
1610,TSLA  ,2023-02-08,2024-01-19,340.0,3882,3,3885
1611,TSLA  ,2023-02-08,2024-01-19,341.67,888,8,896
1612,TSLA  ,2023-02-08,2024-01-19,343.33,526,0,526
1613,TSLA  ,2023-02-08,2024-01-19,346.67,2389,3,2392
1614,TSLA  ,2023-02-08,2024-01-19,350.0,15351,314,15665
1615,TSLA  ,2023-02-08,2024-01-19,353.33,1154,0,1154
1616,TSLA  ,2023-02-08,2024-01-19,356.67,878,0,878
1617,TSLA  ,2023-02-08,2024-01-19,358.33,1324,3,1327
1618,TSLA  ,2023-02-08,2024-01-19,360.0,9197,600,9797
1619,TSLA  ,2023-02-08,2024-01-19,363.33,394,7,401
1620,TSLA  ,2023-02-08,2024-01-19,366.67,38773,2843,41616
1621,TSLA  ,2023-02-08,2024-01-19,370.0,6862,4,6866
1622,TSLA  ,2023-02-08,2024-01-19,373.33,1035,11,1046
1623,TSLA  ,2023-02-08,2024-01-19,375.0,11341,8,11349
1624,TSLA  ,2023-02-08,2024-01-19,376.67,525,106,631
1625,TSLA  ,2023-02-08,2024-01-19,380.0,1031,1,1032
1626,TSLA  ,2023-02-08,2024-01-19,383.33,3079,2,3081
1627,TSLA  ,2023-02-08,2024-01-19,386.67,401,203,604
1628,TSLA  ,2023-02-08,2024-01-19,390.0,877,1,878
1629,TSLA  ,2023-02-08,2024-01-19,391.67,2188,1,2189
1630,TSLA  ,2023-02-08,2024-01-19,393.33,555,4,559
1631,TSLA  ,2023-02-08,2024-01-19,396.67,2639,0,2639
1632,TSLA  ,2023-02-08,2024-01-19,400.0,38140,963,39103
1633,TSLA  ,2023-02-08,2024-01-19,408.33,5125,1,5126
1634,TSLA  ,2023-02-08,2024-01-19,416.67,3792,2140,5932
1635,TSLA  ,2023-02-08,2024-01-19,425.0,4655,2,4657
1636,TSLA  ,2023-02-08,2024-01-19,433.33,5651,3,5654
1637,TSLA  ,2023-02-08,2024-01-19,441.67,1146,0,1146
1638,TSLA  ,2023-02-08,2024-01-19,450.0,7982,2303,10285
1639,TSLA  ,2023-02-08,2024-01-19,458.33,1997,0,1997
1640,TSLA  ,2023-02-08,2024-01-19,466.67,28968,0,28968
1641,TSLA  ,2023-02-08,2024-01-19,475.0,4820,10,4830
1642,TSLA  ,2023-02-08,2024-01-19,483.33,1593,0,1593
1643,TSLA  ,2023-02-08,2024-01-19,491.67,2142,0,2142
1644,TSLA  ,2023-02-08,2024-01-19,500.0,36878,80,36958
1645,TSLA  ,2023-02-08,2024-01-19,516.67,4791,0,4791
1646,TSLA  ,2023-02-08,2024-01-19,533.33,20830,0,20830
1647,TSLA  ,2023-02-08,2024-01-19,550.0,16426,9,16435
1648,TSLA  ,2023-02-08,2024-01-19,558.33,1182,0,1182
1649,TSLA  ,2023-02-08,2024-01-19,566.67,11374,0,11374
1650,TSLA  ,2023-02-08,2024-01-19,575.0,13957,0,13957
1651,TSLA  ,2023-02-08,2024-01-19,583.33,13826,0,13826
1652,TSLA  ,2023-02-08,2024-01-19,591.67,2265,0,2265
1653,TSLA  ,2023-02-08,2024-01-19,600.0,18336,0,18336
1654,TSLA  ,2023-02-08,2024-01-19,608.33,2278,0,2278
1655,TSLA  ,2023-02-08,2024-01-19,616.67,11851,0,11851
1656,TSLA  ,2023-02-08,2024-01-19,625.0,2406,0,2406
1657,TSLA  ,2023-02-08,2024-01-19,633.33,5724,0,5724
1658,TSLA  ,2023-02-08,2024-01-19,641.67,927,0,927
1659,TSLA  ,2023-02-08,2024-01-19,650.0,3205,0,3205
1660,TSLA  ,2023-02-08,2024-01-19,666.67,41092,0,41092
1661,TSLA  ,2023-02-08,2024-01-19,675.0,4348,0,4348
1662,TSLA  ,2023-02-08,2024-01-19,683.33,7135,0,7135
1663,TSLA  ,2023-02-08,2024-01-19,691.67,1592,0,1592
1664,TSLA  ,2023-02-08,2024-01-19,700.0,5487,0,5487
1665,TSLA  ,2023-02-08,2024-01-19,708.33,761,0,761
1666,TSLA  ,2023-02-08,2024-01-19,716.67,6045,0,6045
1667,TSLA  ,2023-02-08,2024-01-19,725.0,2696,3,2699
1668,TSLA  ,2023-02-08,2024-01-19,733.33,3420,0,3420
1669,TSLA  ,2023-02-08,2024-01-19,741.67,795,0,795
1670,TSLA  ,2023-02-08,2024-01-19,750.0,2359,0,2359
1671,TSLA  ,2023-02-08,2024-01-19,758.33,942,0,942
1672,TSLA  ,2023-02-08,2024-01-19,766.67,2137,0,2137
1673,TSLA  ,2023-02-08,2024-01-19,775.0,2921,0,2921
1674,TSLA  ,2023-02-08,2024-01-19,783.33,692,0,692
1675,TSLA  ,2023-02-08,2024-01-19,791.67,3179,0,3179
1676,TSLA  ,2023-02-08,2024-01-19,800.0,13697,0,13697
1677,TSLA  ,2023-02-08,2024-01-19,808.33,3928,0,3928
1678,TSLA  ,2023-02-08,2024-01-19,816.67,5810,0,5810
1679,TSLA  ,2023-02-08,2024-01-19,825.0,75673,0,75673
1680,TSLA  ,2023-02-08,2024-03-15,1.67,107,1887,1994
1681,TSLA  ,2023-02-08,2024-03-15,3.33,22,769,791
1682,TSLA  ,2023-02-08,2024-03-15,5.0,64,892,956
1683,TSLA  ,2023-02-08,2024-03-15,6.67,6,93,99
1684,TSLA  ,2023-02-08,2024-03-15,8.33,16,42,58
1685,TSLA  ,2023-02-08,2024-03-15,10.0,6,307,313
1686,TSLA  ,2023-02-08,2024-03-15,11.67,11,189,200
1687,TSLA  ,2023-02-08,2024-03-15,13.33,18,35,53
1688,TSLA  ,2023-02-08,2024-03-15,15.0,24,192,216
1689,TSLA  ,2023-02-08,2024-03-15,16.67,124,234,358
1690,TSLA  ,2023-02-08,2024-03-15,33.33,809,1944,2753
1691,TSLA  ,2023-02-08,2024-03-15,50.0,447,5527,5974
1692,TSLA  ,2023-02-08,2024-03-15,55.0,28,300,328
1693,TSLA  ,2023-02-08,2024-03-15,60.0,44,817,861
1694,TSLA  ,2023-02-08,2024-03-15,65.0,22,713,735
1695,TSLA  ,2023-02-08,2024-03-15,66.67,2035,1005,3040
1696,TSLA  ,2023-02-08,2024-03-15,70.0,51,235,286
1697,TSLA  ,2023-02-08,2024-03-15,75.0,20,398,418
1698,TSLA  ,2023-02-08,2024-03-15,80.0,191,472,663
1699,TSLA  ,2023-02-08,2024-03-15,83.33,999,4513,5512
1700,TSLA  ,2023-02-08,2024-03-15,85.0,291,210,501
1701,TSLA  ,2023-02-08,2024-03-15,90.0,742,394,1136
1702,TSLA  ,2023-02-08,2024-03-15,95.0,1558,410,1968
1703,TSLA  ,2023-02-08,2024-03-15,100.0,3365,3027,6392
1704,TSLA  ,2023-02-08,2024-03-15,105.0,818,717,1535
1705,TSLA  ,2023-02-08,2024-03-15,110.0,912,2490,3402
1706,TSLA  ,2023-02-08,2024-03-15,115.0,2033,183,2216
1707,TSLA  ,2023-02-08,2024-03-15,116.67,609,929,1538
1708,TSLA  ,2023-02-08,2024-03-15,120.0,328,576,904
1709,TSLA  ,2023-02-08,2024-03-15,125.0,664,676,1340
1710,TSLA  ,2023-02-08,2024-03-15,130.0,1571,444,2015
1711,TSLA  ,2023-02-08,2024-03-15,133.33,588,5692,6280
1712,TSLA  ,2023-02-08,2024-03-15,135.0,214,191,405
1713,TSLA  ,2023-02-08,2024-03-15,140.0,178,270,448
1714,TSLA  ,2023-02-08,2024-03-15,141.67,515,326,841
1715,TSLA  ,2023-02-08,2024-03-15,145.0,265,307,572
1716,TSLA  ,2023-02-08,2024-03-15,150.0,1293,4401,5694
1717,TSLA  ,2023-02-08,2024-03-15,155.0,84,205,289
1718,TSLA  ,2023-02-08,2024-03-15,158.33,172,581,753
1719,TSLA  ,2023-02-08,2024-03-15,160.0,213,4382,4595
1720,TSLA  ,2023-02-08,2024-03-15,165.0,147,3868,4015
1721,TSLA  ,2023-02-08,2024-03-15,166.67,588,1199,1787
1722,TSLA  ,2023-02-08,2024-03-15,170.0,277,8784,9061
1723,TSLA  ,2023-02-08,2024-03-15,175.0,676,1939,2615
1724,TSLA  ,2023-02-08,2024-03-15,180.0,301,434,735
1725,TSLA  ,2023-02-08,2024-03-15,183.33,530,1146,1676
1726,TSLA  ,2023-02-08,2024-03-15,185.0,218,143,361
1727,TSLA  ,2023-02-08,2024-03-15,190.0,166,208,374
1728,TSLA  ,2023-02-08,2024-03-15,191.67,631,1383,2014
1729,TSLA  ,2023-02-08,2024-03-15,195.0,562,123,685
1730,TSLA  ,2023-02-08,2024-03-15,200.0,5032,4663,9695
1731,TSLA  ,2023-02-08,2024-03-15,208.33,1150,732,1882
1732,TSLA  ,2023-02-08,2024-03-15,210.0,461,126,587
1733,TSLA  ,2023-02-08,2024-03-15,216.67,1167,996,2163
1734,TSLA  ,2023-02-08,2024-03-15,220.0,457,5,462
1735,TSLA  ,2023-02-08,2024-03-15,225.0,1466,2420,3886
1736,TSLA  ,2023-02-08,2024-03-15,230.0,198,17,215
1737,TSLA  ,2023-02-08,2024-03-15,233.33,1614,1230,2844
1738,TSLA  ,2023-02-08,2024-03-15,240.0,112,11,123
1739,TSLA  ,2023-02-08,2024-03-15,241.67,1126,955,2081
1740,TSLA  ,2023-02-08,2024-03-15,250.0,2035,1514,3549
1741,TSLA  ,2023-02-08,2024-03-15,258.33,4134,1106,5240
1742,TSLA  ,2023-02-08,2024-03-15,260.0,345,34,379
1743,TSLA  ,2023-02-08,2024-03-15,266.67,4453,810,5263
1744,TSLA  ,2023-02-08,2024-03-15,270.0,8,1,9
1745,TSLA  ,2023-02-08,2024-03-15,275.0,8959,1006,9965
1746,TSLA  ,2023-02-08,2024-03-15,280.0,36,8,44
1747,TSLA  ,2023-02-08,2024-03-15,283.33,1168,709,1877
1748,TSLA  ,2023-02-08,2024-03-15,290.0,0,2,2
1749,TSLA  ,2023-02-08,2024-03-15,291.67,1289,142,1431
1750,TSLA  ,2023-02-08,2024-03-15,300.0,4707,638,5345
1751,TSLA  ,2023-02-08,2024-03-15,308.33,407,37,444
1752,TSLA  ,2023-02-08,2024-03-15,316.67,928,389,1317
1753,TSLA  ,2023-02-08,2024-03-15,325.0,1561,16,1577
1754,TSLA  ,2023-02-08,2024-03-15,333.33,867,24,891
1755,TSLA  ,2023-02-08,2024-03-15,341.67,285,24,309
1756,TSLA  ,2023-02-08,2024-03-15,350.0,853,42,895
1757,TSLA  ,2023-02-08,2024-03-15,358.33,377,68,445
1758,TSLA  ,2023-02-08,2024-03-15,366.67,542,161,703
1759,TSLA  ,2023-02-08,2024-03-15,375.0,706,2,708
1760,TSLA  ,2023-02-08,2024-03-15,383.33,202,1334,1536
1761,TSLA  ,2023-02-08,2024-03-15,391.67,321,8,329
1762,TSLA  ,2023-02-08,2024-03-15,400.0,1119,21,1140
1763,TSLA  ,2023-02-08,2024-03-15,408.33,598,2,600
1764,TSLA  ,2023-02-08,2024-03-15,416.67,367,314,681
1765,TSLA  ,2023-02-08,2024-03-15,425.0,927,1,928
1766,TSLA  ,2023-02-08,2024-03-15,433.33,590,0,590
1767,TSLA  ,2023-02-08,2024-03-15,441.67,170,0,170
1768,TSLA  ,2023-02-08,2024-03-15,450.0,1458,0,1458
1769,TSLA  ,2023-02-08,2024-03-15,458.33,256,0,256
1770,TSLA  ,2023-02-08,2024-03-15,466.67,799,0,799
1771,TSLA  ,2023-02-08,2024-03-15,475.0,422,0,422
1772,TSLA  ,2023-02-08,2024-03-15,483.33,486,0,486
1773,TSLA  ,2023-02-08,2024-03-15,491.67,319,0,319
1774,TSLA  ,2023-02-08,2024-03-15,500.0,2815,0,2815
1775,TSLA  ,2023-02-08,2024-03-15,508.33,228,0,228
1776,TSLA  ,2023-02-08,2024-03-15,516.67,697,0,697
1777,TSLA  ,2023-02-08,2024-03-15,525.0,118,0,118
1778,TSLA  ,2023-02-08,2024-03-15,533.33,156,0,156
1779,TSLA  ,2023-02-08,2024-03-15,541.67,165,0,165
1780,TSLA  ,2023-02-08,2024-03-15,550.0,423,0,423
1781,TSLA  ,2023-02-08,2024-03-15,558.33,265,0,265
1782,TSLA  ,2023-02-08,2024-03-15,566.67,381,0,381
1783,TSLA  ,2023-02-08,2024-03-15,575.0,676,0,676
1784,TSLA  ,2023-02-08,2024-03-15,583.33,465,0,465
1785,TSLA  ,2023-02-08,2024-03-15,600.0,3562,1,3563
1786,TSLA  ,2023-02-08,2024-06-21,1.67,630,16474,17104
1787,TSLA  ,2023-02-08,2024-06-21,3.33,149,3270,3419
1788,TSLA  ,2023-02-08,2024-06-21,5.0,20,1503,1523
1789,TSLA  ,2023-02-08,2024-06-21,6.67,219,1208,1427
1790,TSLA  ,2023-02-08,2024-06-21,8.33,121,368,489
1791,TSLA  ,2023-02-08,2024-06-21,10.0,275,1826,2101
1792,TSLA  ,2023-02-08,2024-06-21,11.67,540,314,854
1793,TSLA  ,2023-02-08,2024-06-21,13.33,39,218,257
1794,TSLA  ,2023-02-08,2024-06-21,16.67,1406,3533,4939
1795,TSLA  ,2023-02-08,2024-06-21,33.33,7803,5382,13185
1796,TSLA  ,2023-02-08,2024-06-21,50.0,1914,3746,5660
1797,TSLA  ,2023-02-08,2024-06-21,55.0,6,376,382
1798,TSLA  ,2023-02-08,2024-06-21,60.0,57,517,574
1799,TSLA  ,2023-02-08,2024-06-21,65.0,111,2098,2209
1800,TSLA  ,2023-02-08,2024-06-21,66.67,1877,4344,6221
1801,TSLA  ,2023-02-08,2024-06-21,70.0,47,252,299
1802,TSLA  ,2023-02-08,2024-06-21,75.0,70,123,193
1803,TSLA  ,2023-02-08,2024-06-21,80.0,111,1171,1282
1804,TSLA  ,2023-02-08,2024-06-21,83.33,30599,4211,34810
1805,TSLA  ,2023-02-08,2024-06-21,85.0,60,857,917
1806,TSLA  ,2023-02-08,2024-06-21,90.0,535,1149,1684
1807,TSLA  ,2023-02-08,2024-06-21,95.0,363,352,715
1808,TSLA  ,2023-02-08,2024-06-21,100.0,5356,9771,15127
1809,TSLA  ,2023-02-08,2024-06-21,105.0,796,803,1599
1810,TSLA  ,2023-02-08,2024-06-21,110.0,497,2174,2671
1811,TSLA  ,2023-02-08,2024-06-21,115.0,413,251,664
1812,TSLA  ,2023-02-08,2024-06-21,116.67,2427,1017,3444
1813,TSLA  ,2023-02-08,2024-06-21,120.0,560,1207,1767
1814,TSLA  ,2023-02-08,2024-06-21,123.33,644,3492,4136
1815,TSLA  ,2023-02-08,2024-06-21,125.0,135,2431,2566
1816,TSLA  ,2023-02-08,2024-06-21,126.67,689,1278,1967
1817,TSLA  ,2023-02-08,2024-06-21,130.0,842,1510,2352
1818,TSLA  ,2023-02-08,2024-06-21,133.33,1923,2853,4776
1819,TSLA  ,2023-02-08,2024-06-21,135.0,66,354,420
1820,TSLA  ,2023-02-08,2024-06-21,136.67,443,1886,2329
1821,TSLA  ,2023-02-08,2024-06-21,140.0,1460,2360,3820
1822,TSLA  ,2023-02-08,2024-06-21,143.33,1356,1748,3104
1823,TSLA  ,2023-02-08,2024-06-21,145.0,586,214,800
1824,TSLA  ,2023-02-08,2024-06-21,146.67,1614,565,2179
1825,TSLA  ,2023-02-08,2024-06-21,150.0,4348,9883,14231
1826,TSLA  ,2023-02-08,2024-06-21,153.33,257,836,1093
1827,TSLA  ,2023-02-08,2024-06-21,155.0,92,437,529
1828,TSLA  ,2023-02-08,2024-06-21,156.67,393,226,619
1829,TSLA  ,2023-02-08,2024-06-21,160.0,906,2719,3625
1830,TSLA  ,2023-02-08,2024-06-21,163.33,184,1422,1606
1831,TSLA  ,2023-02-08,2024-06-21,165.0,345,891,1236
1832,TSLA  ,2023-02-08,2024-06-21,166.67,1729,5488,7217
1833,TSLA  ,2023-02-08,2024-06-21,170.0,308,822,1130
1834,TSLA  ,2023-02-08,2024-06-21,173.33,525,5883,6408
1835,TSLA  ,2023-02-08,2024-06-21,175.0,1043,352,1395
1836,TSLA  ,2023-02-08,2024-06-21,180.0,1403,6085,7488
1837,TSLA  ,2023-02-08,2024-06-21,183.33,952,3703,4655
1838,TSLA  ,2023-02-08,2024-06-21,185.0,299,228,527
1839,TSLA  ,2023-02-08,2024-06-21,186.67,1326,1750,3076
1840,TSLA  ,2023-02-08,2024-06-21,190.0,310,85,395
1841,TSLA  ,2023-02-08,2024-06-21,193.33,1020,4285,5305
1842,TSLA  ,2023-02-08,2024-06-21,195.0,241,850,1091
1843,TSLA  ,2023-02-08,2024-06-21,200.0,4611,9766,14377
1844,TSLA  ,2023-02-08,2024-06-21,206.67,977,2853,3830
1845,TSLA  ,2023-02-08,2024-06-21,210.0,371,91,462
1846,TSLA  ,2023-02-08,2024-06-21,213.33,770,1498,2268
1847,TSLA  ,2023-02-08,2024-06-21,216.67,1514,5267,6781
1848,TSLA  ,2023-02-08,2024-06-21,220.0,2038,2386,4424
1849,TSLA  ,2023-02-08,2024-06-21,226.67,2326,3403,5729
1850,TSLA  ,2023-02-08,2024-06-21,230.0,295,71,366
1851,TSLA  ,2023-02-08,2024-06-21,233.33,6563,7139,13702
1852,TSLA  ,2023-02-08,2024-06-21,240.0,1380,4867,6247
1853,TSLA  ,2023-02-08,2024-06-21,246.67,2026,1307,3333
1854,TSLA  ,2023-02-08,2024-06-21,250.0,5457,3526,8983
1855,TSLA  ,2023-02-08,2024-06-21,253.33,1279,853,2132
1856,TSLA  ,2023-02-08,2024-06-21,260.0,2050,953,3003
1857,TSLA  ,2023-02-08,2024-06-21,266.67,10073,3359,13432
1858,TSLA  ,2023-02-08,2024-06-21,270.0,1459,1818,3277
1859,TSLA  ,2023-02-08,2024-06-21,273.33,1227,792,2019
1860,TSLA  ,2023-02-08,2024-06-21,276.67,1010,790,1800
1861,TSLA  ,2023-02-08,2024-06-21,280.0,1182,1544,2726
1862,TSLA  ,2023-02-08,2024-06-21,283.33,3568,1347,4915
1863,TSLA  ,2023-02-08,2024-06-21,286.67,973,760,1733
1864,TSLA  ,2023-02-08,2024-06-21,290.0,2241,1161,3402
1865,TSLA  ,2023-02-08,2024-06-21,293.33,1029,968,1997
1866,TSLA  ,2023-02-08,2024-06-21,296.67,826,360,1186
1867,TSLA  ,2023-02-08,2024-06-21,300.0,9216,894,10110
1868,TSLA  ,2023-02-08,2024-06-21,303.33,1340,645,1985
1869,TSLA  ,2023-02-08,2024-06-21,306.67,1501,237,1738
1870,TSLA  ,2023-02-08,2024-06-21,310.0,1717,518,2235
1871,TSLA  ,2023-02-08,2024-06-21,313.33,901,719,1620
1872,TSLA  ,2023-02-08,2024-06-21,316.67,2289,12,2301
1873,TSLA  ,2023-02-08,2024-06-21,320.0,690,691,1381
1874,TSLA  ,2023-02-08,2024-06-21,323.33,395,308,703
1875,TSLA  ,2023-02-08,2024-06-21,326.67,582,274,856
1876,TSLA  ,2023-02-08,2024-06-21,330.0,2697,123,2820
1877,TSLA  ,2023-02-08,2024-06-21,333.33,7573,1092,8665
1878,TSLA  ,2023-02-08,2024-06-21,336.67,2289,238,2527
1879,TSLA  ,2023-02-08,2024-06-21,340.0,780,29,809
1880,TSLA  ,2023-02-08,2024-06-21,343.33,1158,89,1247
1881,TSLA  ,2023-02-08,2024-06-21,346.67,397,41,438
1882,TSLA  ,2023-02-08,2024-06-21,350.0,3407,6,3413
1883,TSLA  ,2023-02-08,2024-06-21,353.33,199,69,268
1884,TSLA  ,2023-02-08,2024-06-21,356.67,493,0,493
1885,TSLA  ,2023-02-08,2024-06-21,360.0,2620,12,2632
1886,TSLA  ,2023-02-08,2024-06-21,363.33,366,0,366
1887,TSLA  ,2023-02-08,2024-06-21,366.67,4715,0,4715
1888,TSLA  ,2023-02-08,2024-06-21,370.0,3050,9,3059
1889,TSLA  ,2023-02-08,2024-06-21,373.33,556,0,556
1890,TSLA  ,2023-02-08,2024-06-21,376.67,816,0,816
1891,TSLA  ,2023-02-08,2024-06-21,380.0,683,0,683
1892,TSLA  ,2023-02-08,2024-06-21,383.33,1028,11,1039
1893,TSLA  ,2023-02-08,2024-06-21,386.67,316,5,321
1894,TSLA  ,2023-02-08,2024-06-21,390.0,448,1,449
1895,TSLA  ,2023-02-08,2024-06-21,393.33,884,1,885
1896,TSLA  ,2023-02-08,2024-06-21,396.67,720,0,720
1897,TSLA  ,2023-02-08,2024-06-21,400.0,38919,34,38953
1898,TSLA  ,2023-02-08,2024-06-21,416.67,3090,1,3091
1899,TSLA  ,2023-02-08,2024-06-21,433.33,3268,0,3268
1900,TSLA  ,2023-02-08,2024-06-21,450.0,3185,0,3185
1901,TSLA  ,2023-02-08,2024-06-21,466.67,5345,0,5345
1902,TSLA  ,2023-02-08,2024-06-21,483.33,1100,0,1100
1903,TSLA  ,2023-02-08,2024-06-21,500.0,10926,0,10926
1904,TSLA  ,2023-02-08,2024-06-21,516.67,2087,0,2087
1905,TSLA  ,2023-02-08,2024-06-21,533.33,3138,0,3138
1906,TSLA  ,2023-02-08,2024-06-21,550.0,2606,0,2606
1907,TSLA  ,2023-02-08,2024-06-21,566.67,1010,0,1010
1908,TSLA  ,2023-02-08,2024-06-21,583.33,1040,0,1040
1909,TSLA  ,2023-02-08,2024-06-21,600.0,17155,0,17155
1910,TSLA  ,2023-02-08,2024-06-21,616.67,14011,0,14011
1911,TSLA  ,2023-02-08,2024-06-21,633.33,4574,0,4574
1912,TSLA  ,2023-02-08,2024-06-21,650.0,609,0,609
1913,TSLA  ,2023-02-08,2024-06-21,666.67,6572,0,6572
1914,TSLA  ,2023-02-08,2024-06-21,683.33,1688,0,1688
1915,TSLA  ,2023-02-08,2024-06-21,700.0,3765,0,3765
1916,TSLA  ,2023-02-08,2024-06-21,716.67,890,0,890
1917,TSLA  ,2023-02-08,2024-06-21,733.33,2247,0,2247
1918,TSLA  ,2023-02-08,2024-06-21,750.0,6263,1,6264
1919,TSLA  ,2023-02-08,2024-06-21,758.33,13939,0,13939
1920,TSLA  ,2023-02-08,2024-09-20,50.0,44,908,952
1921,TSLA  ,2023-02-08,2024-09-20,55.0,29,53,82
1922,TSLA  ,2023-02-08,2024-09-20,60.0,10,153,163
1923,TSLA  ,2023-02-08,2024-09-20,65.0,32,69,101
1924,TSLA  ,2023-02-08,2024-09-20,70.0,9,134,143
1925,TSLA  ,2023-02-08,2024-09-20,75.0,10,2322,2332
1926,TSLA  ,2023-02-08,2024-09-20,80.0,63,152,215
1927,TSLA  ,2023-02-08,2024-09-20,85.0,985,454,1439
1928,TSLA  ,2023-02-08,2024-09-20,90.0,47,188,235
1929,TSLA  ,2023-02-08,2024-09-20,95.0,22,452,474
1930,TSLA  ,2023-02-08,2024-09-20,100.0,377,2209,2586
1931,TSLA  ,2023-02-08,2024-09-20,105.0,189,692,881
1932,TSLA  ,2023-02-08,2024-09-20,110.0,170,1015,1185
1933,TSLA  ,2023-02-08,2024-09-20,115.0,558,592,1150
1934,TSLA  ,2023-02-08,2024-09-20,120.0,738,550,1288
1935,TSLA  ,2023-02-08,2024-09-20,125.0,324,1196,1520
1936,TSLA  ,2023-02-08,2024-09-20,130.0,607,841,1448
1937,TSLA  ,2023-02-08,2024-09-20,135.0,598,286,884
1938,TSLA  ,2023-02-08,2024-09-20,140.0,1097,355,1452
1939,TSLA  ,2023-02-08,2024-09-20,145.0,1280,347,1627
1940,TSLA  ,2023-02-08,2024-09-20,150.0,1429,2725,4154
1941,TSLA  ,2023-02-08,2024-09-20,155.0,532,292,824
1942,TSLA  ,2023-02-08,2024-09-20,160.0,323,830,1153
1943,TSLA  ,2023-02-08,2024-09-20,165.0,254,109,363
1944,TSLA  ,2023-02-08,2024-09-20,170.0,191,240,431
1945,TSLA  ,2023-02-08,2024-09-20,175.0,221,132,353
1946,TSLA  ,2023-02-08,2024-09-20,180.0,743,84,827
1947,TSLA  ,2023-02-08,2024-09-20,185.0,829,999,1828
1948,TSLA  ,2023-02-08,2024-09-20,190.0,1485,94,1579
1949,TSLA  ,2023-02-08,2024-09-20,195.0,1405,117,1522
1950,TSLA  ,2023-02-08,2024-09-20,200.0,1742,1408,3150
1951,TSLA  ,2023-02-08,2024-09-20,210.0,730,262,992
1952,TSLA  ,2023-02-08,2024-09-20,220.0,1485,404,1889
1953,TSLA  ,2023-02-08,2024-09-20,230.0,502,139,641
1954,TSLA  ,2023-02-08,2024-09-20,240.0,331,290,621
1955,TSLA  ,2023-02-08,2024-09-20,250.0,731,347,1078
1956,TSLA  ,2023-02-08,2024-09-20,260.0,898,100,998
1957,TSLA  ,2023-02-08,2024-09-20,270.0,497,534,1031
1958,TSLA  ,2023-02-08,2024-09-20,280.0,325,496,821
1959,TSLA  ,2023-02-08,2024-09-20,290.0,452,2774,3226
1960,TSLA  ,2023-02-08,2024-09-20,300.0,1050,1141,2191
1961,TSLA  ,2023-02-08,2024-09-20,310.0,123,713,836
1962,TSLA  ,2023-02-08,2024-09-20,320.0,108,205,313
1963,TSLA  ,2023-02-08,2024-09-20,330.0,81,117,198
1964,TSLA  ,2023-02-08,2024-09-20,340.0,698,109,807
1965,TSLA  ,2023-02-08,2024-09-20,350.0,1410,109,1519
1966,TSLA  ,2023-02-08,2024-09-20,360.0,58,63,121
1967,TSLA  ,2023-02-08,2024-09-20,370.0,1,2,3
1968,TSLA  ,2023-02-08,2024-09-20,380.0,20,2,22
1969,TSLA  ,2023-02-08,2024-09-20,390.0,10,16,26
1970,TSLA  ,2023-02-08,2025-01-17,5.0,671,11157,11828
1971,TSLA  ,2023-02-08,2025-01-17,10.0,138,812,950
1972,TSLA  ,2023-02-08,2025-01-17,15.0,29,882,911
1973,TSLA  ,2023-02-08,2025-01-17,20.0,386,5810,6196
1974,TSLA  ,2023-02-08,2025-01-17,25.0,103,2458,2561
1975,TSLA  ,2023-02-08,2025-01-17,30.0,13816,16535,30351
1976,TSLA  ,2023-02-08,2025-01-17,35.0,266,1092,1358
1977,TSLA  ,2023-02-08,2025-01-17,40.0,14712,15779,30491
1978,TSLA  ,2023-02-08,2025-01-17,45.0,2979,3219,6198
1979,TSLA  ,2023-02-08,2025-01-17,50.0,2746,9148,11894
1980,TSLA  ,2023-02-08,2025-01-17,55.0,2004,4212,6216
1981,TSLA  ,2023-02-08,2025-01-17,60.0,590,2030,2620
1982,TSLA  ,2023-02-08,2025-01-17,65.0,1649,1576,3225
1983,TSLA  ,2023-02-08,2025-01-17,70.0,2479,2154,4633
1984,TSLA  ,2023-02-08,2025-01-17,75.0,187,4382,4569
1985,TSLA  ,2023-02-08,2025-01-17,80.0,1309,1855,3164
1986,TSLA  ,2023-02-08,2025-01-17,85.0,1827,1489,3316
1987,TSLA  ,2023-02-08,2025-01-17,90.0,1139,5571,6710
1988,TSLA  ,2023-02-08,2025-01-17,95.0,131,401,532
1989,TSLA  ,2023-02-08,2025-01-17,100.0,5461,17488,22949
1990,TSLA  ,2023-02-08,2025-01-17,105.0,312,1577,1889
1991,TSLA  ,2023-02-08,2025-01-17,110.0,5440,7069,12509
1992,TSLA  ,2023-02-08,2025-01-17,115.0,3623,3541,7164
1993,TSLA  ,2023-02-08,2025-01-17,120.0,8512,6139,14651
1994,TSLA  ,2023-02-08,2025-01-17,125.0,2159,1167,3326
1995,TSLA  ,2023-02-08,2025-01-17,130.0,5690,7172,12862
1996,TSLA  ,2023-02-08,2025-01-17,135.0,5699,714,6413
1997,TSLA  ,2023-02-08,2025-01-17,140.0,8553,4610,13163
1998,TSLA  ,2023-02-08,2025-01-17,145.0,767,680,1447
1999,TSLA  ,2023-02-08,2025-01-17,150.0,11898,11794,23692
2000,TSLA  ,2023-02-08,2025-01-17,155.0,236,469,705
2001,TSLA  ,2023-02-08,2025-01-17,160.0,4605,5544,10149
2002,TSLA  ,2023-02-08,2025-01-17,165.0,246,843,1089
2003,TSLA  ,2023-02-08,2025-01-17,170.0,35451,9684,45135
2004,TSLA  ,2023-02-08,2025-01-17,175.0,33521,4549,38070
2005,TSLA  ,2023-02-08,2025-01-17,180.0,3672,8252,11924
2006,TSLA  ,2023-02-08,2025-01-17,185.0,1327,4494,5821
2007,TSLA  ,2023-02-08,2025-01-17,190.0,5706,4788,10494
2008,TSLA  ,2023-02-08,2025-01-17,195.0,3234,1725,4959
2009,TSLA  ,2023-02-08,2025-01-17,200.0,27908,12380,40288
2010,TSLA  ,2023-02-08,2025-01-17,210.0,4914,2647,7561
2011,TSLA  ,2023-02-08,2025-01-17,220.0,3079,4159,7238
2012,TSLA  ,2023-02-08,2025-01-17,230.0,4064,3263,7327
2013,TSLA  ,2023-02-08,2025-01-17,240.0,4623,4364,8987
2014,TSLA  ,2023-02-08,2025-01-17,250.0,11698,5031,16729
2015,TSLA  ,2023-02-08,2025-01-17,260.0,5667,1777,7444
2016,TSLA  ,2023-02-08,2025-01-17,270.0,3039,1232,4271
2017,TSLA  ,2023-02-08,2025-01-17,280.0,2261,3347,5608
2018,TSLA  ,2023-02-08,2025-01-17,290.0,3445,2809,6254
2019,TSLA  ,2023-02-08,2025-01-17,300.0,31155,3116,34271
2020,TSLA  ,2023-02-08,2025-01-17,310.0,4401,687,5088
2021,TSLA  ,2023-02-08,2025-01-17,320.0,1696,792,2488
2022,TSLA  ,2023-02-08,2025-01-17,330.0,2396,938,3334
2023,TSLA  ,2023-02-08,2025-01-17,340.0,1260,411,1671
2024,TSLA  ,2023-02-08,2025-01-17,350.0,6972,566,7538
2025,TSLA  ,2023-02-08,2025-01-17,360.0,2060,153,2213
2026,TSLA  ,2023-02-08,2025-01-17,370.0,2074,297,2371
2027,TSLA  ,2023-02-08,2025-01-17,380.0,1546,46,1592
2028,TSLA  ,2023-02-08,2025-01-17,390.0,2071,64,2135
2029,TSLA  ,2023-02-08,2025-01-17,400.0,18838,98,18936
2030,TSLA  ,2023-02-08,2025-01-17,410.0,4202,2,4204
2031,TSLA  ,2023-02-08,2025-01-17,420.0,2904,8,2912
2032,TSLA  ,2023-02-08,2025-01-17,430.0,553,2,555
2033,TSLA  ,2023-02-08,2025-01-17,440.0,637,7,644
2034,TSLA  ,2023-02-08,2025-01-17,450.0,3584,3,3587
2035,TSLA  ,2023-02-08,2025-01-17,460.0,908,4,912
2036,TSLA  ,2023-02-08,2025-01-17,470.0,1551,1,1552
2037,TSLA  ,2023-02-08,2025-01-17,480.0,1248,1,1249
2038,TSLA  ,2023-02-08,2025-01-17,490.0,701,0,701
2039,TSLA  ,2023-02-08,2025-01-17,500.0,10803,2,10805
2040,TSLA  ,2023-02-08,2025-01-17,510.0,1150,1,1151
2041,TSLA  ,2023-02-08,2025-01-17,520.0,8333,1,8334
2042,TSLA  ,2023-02-08,2025-01-17,530.0,644,0,644
2043,TSLA  ,2023-02-08,2025-01-17,540.0,605,0,605
2044,TSLA  ,2023-02-08,2025-01-17,550.0,3043,0,3043
2045,TSLA  ,2023-02-08,2025-01-17,560.0,629,0,629
2046,TSLA  ,2023-02-08,2025-01-17,570.0,674,2,676
2047,TSLA  ,2023-02-08,2025-01-17,580.0,846,0,846
2048,TSLA  ,2023-02-08,2025-01-17,590.0,811,0,811
2049,TSLA  ,2023-02-08,2025-01-17,600.0,15200,0,15200
2050,TSLA  ,2023-02-08,2025-01-17,610.0,18150,0,18150
2051,TSLA  ,2023-02-08,2025-06-20,5.0,190,808,998
2052,TSLA  ,2023-02-08,2025-06-20,10.0,3,84,87
2053,TSLA  ,2023-02-08,2025-06-20,15.0,7,4786,4793
2054,TSLA  ,2023-02-08,2025-06-20,20.0,38,301,339
2055,TSLA  ,2023-02-08,2025-06-20,25.0,9,113,122
2056,TSLA  ,2023-02-08,2025-06-20,30.0,83,221,304
2057,TSLA  ,2023-02-08,2025-06-20,35.0,11,179,190
2058,TSLA  ,2023-02-08,2025-06-20,40.0,8,287,295
2059,TSLA  ,2023-02-08,2025-06-20,45.0,16,52,68
2060,TSLA  ,2023-02-08,2025-06-20,50.0,141,602,743
2061,TSLA  ,2023-02-08,2025-06-20,55.0,10,43,53
2062,TSLA  ,2023-02-08,2025-06-20,60.0,16,617,633
2063,TSLA  ,2023-02-08,2025-06-20,65.0,20,572,592
2064,TSLA  ,2023-02-08,2025-06-20,70.0,160,124,284
2065,TSLA  ,2023-02-08,2025-06-20,75.0,119,1284,1403
2066,TSLA  ,2023-02-08,2025-06-20,80.0,804,435,1239
2067,TSLA  ,2023-02-08,2025-06-20,85.0,346,242,588
2068,TSLA  ,2023-02-08,2025-06-20,90.0,10298,433,10731
2069,TSLA  ,2023-02-08,2025-06-20,95.0,46406,538,46944
2070,TSLA  ,2023-02-08,2025-06-20,100.0,889,4586,5475
2071,TSLA  ,2023-02-08,2025-06-20,105.0,158,410,568
2072,TSLA  ,2023-02-08,2025-06-20,110.0,348,1624,1972
2073,TSLA  ,2023-02-08,2025-06-20,115.0,434,278,712
2074,TSLA  ,2023-02-08,2025-06-20,120.0,461,955,1416
2075,TSLA  ,2023-02-08,2025-06-20,125.0,510,364,874
2076,TSLA  ,2023-02-08,2025-06-20,130.0,2641,2121,4762
2077,TSLA  ,2023-02-08,2025-06-20,135.0,4714,156,4870
2078,TSLA  ,2023-02-08,2025-06-20,140.0,992,2273,3265
2079,TSLA  ,2023-02-08,2025-06-20,145.0,396,477,873
2080,TSLA  ,2023-02-08,2025-06-20,150.0,1291,1373,2664
2081,TSLA  ,2023-02-08,2025-06-20,155.0,408,133,541
2082,TSLA  ,2023-02-08,2025-06-20,160.0,2118,1135,3253
2083,TSLA  ,2023-02-08,2025-06-20,165.0,908,343,1251
2084,TSLA  ,2023-02-08,2025-06-20,170.0,2791,1432,4223
2085,TSLA  ,2023-02-08,2025-06-20,175.0,723,1095,1818
2086,TSLA  ,2023-02-08,2025-06-20,180.0,620,1070,1690
2087,TSLA  ,2023-02-08,2025-06-20,185.0,2451,161,2612
2088,TSLA  ,2023-02-08,2025-06-20,190.0,437,252,689
2089,TSLA  ,2023-02-08,2025-06-20,195.0,294,320,614
2090,TSLA  ,2023-02-08,2025-06-20,200.0,3641,2764,6405
2091,TSLA  ,2023-02-08,2025-06-20,205.0,159,210,369
2092,TSLA  ,2023-02-08,2025-06-20,210.0,321,40,361
2093,TSLA  ,2023-02-08,2025-06-20,215.0,87,27,114
2094,TSLA  ,2023-02-08,2025-06-20,220.0,629,78,707
2095,TSLA  ,2023-02-08,2025-06-20,225.0,435,137,572
2096,TSLA  ,2023-02-08,2025-06-20,230.0,315,46,361
2097,TSLA  ,2023-02-08,2025-06-20,235.0,319,167,486
2098,TSLA  ,2023-02-08,2025-06-20,240.0,4348,238,4586
2099,TSLA  ,2023-02-08,2025-06-20,250.0,1262,436,1698
2100,TSLA  ,2023-02-08,2025-06-20,260.0,307,279,586
2101,TSLA  ,2023-02-08,2025-06-20,270.0,463,102,565
2102,TSLA  ,2023-02-08,2025-06-20,280.0,178,187,365
2103,TSLA  ,2023-02-08,2025-06-20,290.0,215,182,397
2104,TSLA  ,2023-02-08,2025-06-20,300.0,2268,581,2849
2105,TSLA  ,2023-02-08,2025-06-20,310.0,139,179,318
2106,TSLA  ,2023-02-08,2025-06-20,320.0,845,284,1129
2107,TSLA  ,2023-02-08,2025-06-20,330.0,105,186,291
2108,TSLA  ,2023-02-08,2025-06-20,340.0,85,106,191
2109,TSLA  ,2023-02-08,2025-06-20,350.0,1703,190,1893
2110,TSLA  ,2023-02-08,2025-06-20,360.0,654,196,850
2111,TSLA  ,2023-02-08,2025-06-20,370.0,7,149,156
2112,TSLA  ,2023-02-08,2025-06-20,380.0,28,1,29
2113,TSLA  ,2023-02-08,2025-06-20,390.0,462,3,465
