index,ProductSymbol,DateGen,ExpDate,Strike,Call,Put,TotalOI
0,TSLA  ,2023-02-16,2023-02-17,15.0,371,313,684
1,TSLA  ,2023-02-16,2023-02-17,20.0,70,46,116
2,TSLA  ,2023-02-16,2023-02-17,25.0,3,99,102
3,TSLA  ,2023-02-16,2023-02-17,30.0,34,2723,2757
4,TSLA  ,2023-02-16,2023-02-17,35.0,0,5414,5414
5,TSLA  ,2023-02-16,2023-02-17,40.0,104,10382,10486
6,TSLA  ,2023-02-16,2023-02-17,45.0,1,1739,1740
7,TSLA  ,2023-02-16,2023-02-17,50.0,850,17127,17977
8,TSLA  ,2023-02-16,2023-02-17,55.0,11,5311,5322
9,TSLA  ,2023-02-16,2023-02-17,60.0,318,9057,9375
10,TSLA  ,2023-02-16,2023-02-17,65.0,28,6534,6562
11,TSLA  ,2023-02-16,2023-02-17,70.0,19,54688,54707
12,TSLA  ,2023-02-16,2023-02-17,75.0,65,7668,7733
13,TSLA  ,2023-02-16,2023-02-17,80.0,90,52812,52902
14,TSLA  ,2023-02-16,2023-02-17,85.0,22,14034,14056
15,TSLA  ,2023-02-16,2023-02-17,90.0,150,17200,17350
16,TSLA  ,2023-02-16,2023-02-17,95.0,502,20276,20778
17,TSLA  ,2023-02-16,2023-02-17,100.0,3226,39625,42851
18,TSLA  ,2023-02-16,2023-02-17,105.0,20615,29903,50518
19,TSLA  ,2023-02-16,2023-02-17,110.0,2700,26867,29567
20,TSLA  ,2023-02-16,2023-02-17,115.0,13177,29287,42464
21,TSLA  ,2023-02-16,2023-02-17,118.0,282,2550,2832
22,TSLA  ,2023-02-16,2023-02-17,119.0,15,5305,5320
23,TSLA  ,2023-02-16,2023-02-17,120.0,23100,64688,87788
24,TSLA  ,2023-02-16,2023-02-17,121.0,41,2003,2044
25,TSLA  ,2023-02-16,2023-02-17,122.0,186,1734,1920
26,TSLA  ,2023-02-16,2023-02-17,123.0,123,2977,3100
27,TSLA  ,2023-02-16,2023-02-17,124.0,43,3636,3679
28,TSLA  ,2023-02-16,2023-02-17,125.0,12060,17963,30023
29,TSLA  ,2023-02-16,2023-02-17,126.0,43,1289,1332
30,TSLA  ,2023-02-16,2023-02-17,127.0,87,1631,1718
31,TSLA  ,2023-02-16,2023-02-17,128.0,50,9273,9323
32,TSLA  ,2023-02-16,2023-02-17,129.0,107,2380,2487
33,TSLA  ,2023-02-16,2023-02-17,130.0,13381,16034,29415
34,TSLA  ,2023-02-16,2023-02-17,131.0,147,1400,1547
35,TSLA  ,2023-02-16,2023-02-17,132.0,222,2540,2762
36,TSLA  ,2023-02-16,2023-02-17,133.0,63,1963,2026
37,TSLA  ,2023-02-16,2023-02-17,134.0,436,3450,3886
38,TSLA  ,2023-02-16,2023-02-17,135.0,7604,11919,19523
39,TSLA  ,2023-02-16,2023-02-17,136.0,1416,4088,5504
40,TSLA  ,2023-02-16,2023-02-17,137.0,868,1967,2835
41,TSLA  ,2023-02-16,2023-02-17,138.0,1246,3867,5113
42,TSLA  ,2023-02-16,2023-02-17,139.0,903,1776,2679
43,TSLA  ,2023-02-16,2023-02-17,140.0,7382,16464,23846
44,TSLA  ,2023-02-16,2023-02-17,141.0,673,3608,4281
45,TSLA  ,2023-02-16,2023-02-17,142.0,1006,2660,3666
46,TSLA  ,2023-02-16,2023-02-17,143.0,382,1666,2048
47,TSLA  ,2023-02-16,2023-02-17,144.0,323,2824,3147
48,TSLA  ,2023-02-16,2023-02-17,145.0,11377,24043,35420
49,TSLA  ,2023-02-16,2023-02-17,146.0,1802,3019,4821
50,TSLA  ,2023-02-16,2023-02-17,147.0,545,5818,6363
51,TSLA  ,2023-02-16,2023-02-17,148.0,242,3663,3905
52,TSLA  ,2023-02-16,2023-02-17,149.0,448,4660,5108
53,TSLA  ,2023-02-16,2023-02-17,150.0,14794,36904,51698
54,TSLA  ,2023-02-16,2023-02-17,152.5,1017,4823,5840
55,TSLA  ,2023-02-16,2023-02-17,155.0,8892,14573,23465
56,TSLA  ,2023-02-16,2023-02-17,157.5,1412,5801,7213
57,TSLA  ,2023-02-16,2023-02-17,160.0,36996,40128,77124
58,TSLA  ,2023-02-16,2023-02-17,162.5,1246,6973,8219
59,TSLA  ,2023-02-16,2023-02-17,165.0,12433,18897,31330
60,TSLA  ,2023-02-16,2023-02-17,167.5,1030,5122,6152
61,TSLA  ,2023-02-16,2023-02-17,170.0,19416,34701,54117
62,TSLA  ,2023-02-16,2023-02-17,172.5,2253,7140,9393
63,TSLA  ,2023-02-16,2023-02-17,175.0,8586,17440,26026
64,TSLA  ,2023-02-16,2023-02-17,177.5,2593,6835,9428
65,TSLA  ,2023-02-16,2023-02-17,180.0,15841,34721,50562
66,TSLA  ,2023-02-16,2023-02-17,182.5,4728,4753,9481
67,TSLA  ,2023-02-16,2023-02-17,185.0,16563,22031,38594
68,TSLA  ,2023-02-16,2023-02-17,187.5,2749,9911,12660
69,TSLA  ,2023-02-16,2023-02-17,190.0,20659,47947,68606
70,TSLA  ,2023-02-16,2023-02-17,192.5,5112,10866,15978
71,TSLA  ,2023-02-16,2023-02-17,195.0,12567,19330,31897
72,TSLA  ,2023-02-16,2023-02-17,197.5,5295,9473,14768
73,TSLA  ,2023-02-16,2023-02-17,200.0,48525,29147,77672
74,TSLA  ,2023-02-16,2023-02-17,202.5,9866,8360,18226
75,TSLA  ,2023-02-16,2023-02-17,205.0,13222,14347,27569
76,TSLA  ,2023-02-16,2023-02-17,207.5,8345,7324,15669
77,TSLA  ,2023-02-16,2023-02-17,210.0,36752,19356,56108
78,TSLA  ,2023-02-16,2023-02-17,212.5,14221,6103,20324
79,TSLA  ,2023-02-16,2023-02-17,215.0,27146,4961,32107
80,TSLA  ,2023-02-16,2023-02-17,217.5,15280,1762,17042
81,TSLA  ,2023-02-16,2023-02-17,220.0,47412,3649,51061
82,TSLA  ,2023-02-16,2023-02-17,222.5,7595,1321,8916
83,TSLA  ,2023-02-16,2023-02-17,225.0,20463,2610,23073
84,TSLA  ,2023-02-16,2023-02-17,227.5,8077,224,8301
85,TSLA  ,2023-02-16,2023-02-17,230.0,26284,2559,28843
86,TSLA  ,2023-02-16,2023-02-17,232.5,7856,180,8036
87,TSLA  ,2023-02-16,2023-02-17,235.0,16944,650,17594
88,TSLA  ,2023-02-16,2023-02-17,237.5,4524,152,4676
89,TSLA  ,2023-02-16,2023-02-17,240.0,16313,1136,17449
90,TSLA  ,2023-02-16,2023-02-17,242.5,4595,43,4638
91,TSLA  ,2023-02-16,2023-02-17,245.0,8775,27,8802
92,TSLA  ,2023-02-16,2023-02-17,247.5,3103,53,3156
93,TSLA  ,2023-02-16,2023-02-17,250.0,43497,194,43691
94,TSLA  ,2023-02-16,2023-02-17,252.5,2784,2,2786
95,TSLA  ,2023-02-16,2023-02-17,255.0,13926,18,13944
96,TSLA  ,2023-02-16,2023-02-17,257.5,3238,0,3238
97,TSLA  ,2023-02-16,2023-02-17,260.0,11716,77,11793
98,TSLA  ,2023-02-16,2023-02-17,262.5,2805,1,2806
99,TSLA  ,2023-02-16,2023-02-17,265.0,8768,50,8818
100,TSLA  ,2023-02-16,2023-02-17,267.5,2526,1,2527
101,TSLA  ,2023-02-16,2023-02-17,270.0,13655,41,13696
102,TSLA  ,2023-02-16,2023-02-17,272.5,3851,1,3852
103,TSLA  ,2023-02-16,2023-02-17,275.0,9986,0,9986
104,TSLA  ,2023-02-16,2023-02-17,277.5,1281,0,1281
105,TSLA  ,2023-02-16,2023-02-17,280.0,5719,17,5736
106,TSLA  ,2023-02-16,2023-02-17,285.0,10935,0,10935
107,TSLA  ,2023-02-16,2023-02-17,290.0,7563,0,7563
108,TSLA  ,2023-02-16,2023-02-17,295.0,4556,0,4556
109,TSLA  ,2023-02-16,2023-02-17,300.0,16465,10,16475
110,TSLA  ,2023-02-16,2023-02-17,305.0,4642,0,4642
111,TSLA  ,2023-02-16,2023-02-17,310.0,3519,0,3519
112,TSLA  ,2023-02-16,2023-02-17,315.0,3665,0,3665
113,TSLA  ,2023-02-16,2023-02-17,320.0,11789,1,11790
114,TSLA  ,2023-02-16,2023-02-17,325.0,2039,0,2039
115,TSLA  ,2023-02-16,2023-02-17,330.0,1789,0,1789
116,TSLA  ,2023-02-16,2023-02-17,335.0,4078,0,4078
117,TSLA  ,2023-02-16,2023-02-17,340.0,3191,0,3191
118,TSLA  ,2023-02-16,2023-02-17,345.0,2801,7,2808
119,TSLA  ,2023-02-16,2023-02-17,350.0,4074,0,4074
120,TSLA  ,2023-02-16,2023-02-17,355.0,1313,0,1313
121,TSLA  ,2023-02-16,2023-02-17,360.0,2052,0,2052
122,TSLA  ,2023-02-16,2023-02-17,365.0,2038,0,2038
123,TSLA  ,2023-02-16,2023-02-17,370.0,1373,0,1373
124,TSLA  ,2023-02-16,2023-02-17,375.0,4634,0,4634
125,TSLA  ,2023-02-16,2023-02-17,380.0,2162,0,2162
126,TSLA  ,2023-02-16,2023-02-17,385.0,963,0,963
127,TSLA  ,2023-02-16,2023-02-17,390.0,1494,0,1494
128,TSLA  ,2023-02-16,2023-02-17,395.0,2035,0,2035
129,TSLA  ,2023-02-16,2023-02-17,400.0,4208,0,4208
130,TSLA  ,2023-02-16,2023-02-17,405.0,560,0,560
131,TSLA  ,2023-02-16,2023-02-17,410.0,801,0,801
132,TSLA  ,2023-02-16,2023-02-17,415.0,755,0,755
133,TSLA  ,2023-02-16,2023-02-17,420.0,794,0,794
134,TSLA  ,2023-02-16,2023-02-17,425.0,674,0,674
135,TSLA  ,2023-02-16,2023-02-17,430.0,728,0,728
136,TSLA  ,2023-02-16,2023-02-17,435.0,358,0,358
137,TSLA  ,2023-02-16,2023-02-17,440.0,822,0,822
138,TSLA  ,2023-02-16,2023-02-17,445.0,235,0,235
139,TSLA  ,2023-02-16,2023-02-17,450.0,753,0,753
140,TSLA  ,2023-02-16,2023-02-17,455.0,1720,0,1720
141,TSLA  ,2023-02-16,2023-02-17,460.0,350,0,350
142,TSLA  ,2023-02-16,2023-02-17,465.0,1039,0,1039
143,TSLA  ,2023-02-16,2023-02-17,470.0,1347,0,1347
144,TSLA  ,2023-02-16,2023-02-17,475.0,589,0,589
145,TSLA  ,2023-02-16,2023-02-17,480.0,347,0,347
146,TSLA  ,2023-02-16,2023-02-17,485.0,689,0,689
147,TSLA  ,2023-02-16,2023-02-17,490.0,242,0,242
148,TSLA  ,2023-02-16,2023-02-17,495.0,400,0,400
149,TSLA  ,2023-02-16,2023-02-17,500.0,3739,0,3739
150,TSLA  ,2023-02-16,2023-02-17,505.0,357,0,357
151,TSLA  ,2023-02-16,2023-02-17,510.0,356,0,356
152,TSLA  ,2023-02-16,2023-02-17,515.0,58,0,58
153,TSLA  ,2023-02-16,2023-02-17,520.0,327,0,327
154,TSLA  ,2023-02-16,2023-02-17,525.0,150,0,150
155,TSLA  ,2023-02-16,2023-02-17,530.0,391,0,391
156,TSLA  ,2023-02-16,2023-02-17,535.0,171,0,171
157,TSLA  ,2023-02-16,2023-02-17,540.0,219,0,219
158,TSLA  ,2023-02-16,2023-02-17,545.0,110,0,110
159,TSLA  ,2023-02-16,2023-02-17,550.0,799,0,799
160,TSLA  ,2023-02-16,2023-02-17,555.0,837,0,837
161,TSLA  ,2023-02-16,2023-02-17,560.0,573,0,573
162,TSLA  ,2023-02-16,2023-02-17,565.0,661,0,661
163,TSLA  ,2023-02-16,2023-02-17,570.0,317,0,317
164,TSLA  ,2023-02-16,2023-02-17,575.0,278,0,278
165,TSLA  ,2023-02-16,2023-02-17,580.0,1203,0,1203
166,TSLA  ,2023-02-16,2023-02-17,585.0,956,0,956
167,TSLA  ,2023-02-16,2023-02-17,590.0,297,0,297
168,TSLA  ,2023-02-16,2023-02-17,595.0,2011,0,2011
169,TSLA  ,2023-02-16,2023-02-17,600.0,2979,7,2986
170,TSLA  ,2023-02-16,2023-02-24,15.0,24,9,33
171,TSLA  ,2023-02-16,2023-02-24,20.0,3,1,4
172,TSLA  ,2023-02-16,2023-02-24,25.0,3,3,6
173,TSLA  ,2023-02-16,2023-02-24,30.0,3,748,751
174,TSLA  ,2023-02-16,2023-02-24,35.0,0,20,20
175,TSLA  ,2023-02-16,2023-02-24,40.0,0,439,439
176,TSLA  ,2023-02-16,2023-02-24,45.0,0,2046,2046
177,TSLA  ,2023-02-16,2023-02-24,50.0,0,1898,1898
178,TSLA  ,2023-02-16,2023-02-24,55.0,3,806,809
179,TSLA  ,2023-02-16,2023-02-24,60.0,14,1451,1465
180,TSLA  ,2023-02-16,2023-02-24,65.0,6,698,704
181,TSLA  ,2023-02-16,2023-02-24,70.0,6,599,605
182,TSLA  ,2023-02-16,2023-02-24,75.0,1,851,852
183,TSLA  ,2023-02-16,2023-02-24,80.0,7,1111,1118
184,TSLA  ,2023-02-16,2023-02-24,85.0,38,639,677
185,TSLA  ,2023-02-16,2023-02-24,90.0,41,1412,1453
186,TSLA  ,2023-02-16,2023-02-24,95.0,19,1849,1868
187,TSLA  ,2023-02-16,2023-02-24,98.0,14,465,479
188,TSLA  ,2023-02-16,2023-02-24,99.0,17,626,643
189,TSLA  ,2023-02-16,2023-02-24,100.0,75,2493,2568
190,TSLA  ,2023-02-16,2023-02-24,101.0,18,340,358
191,TSLA  ,2023-02-16,2023-02-24,102.0,12,241,253
192,TSLA  ,2023-02-16,2023-02-24,103.0,8,227,235
193,TSLA  ,2023-02-16,2023-02-24,104.0,15,345,360
194,TSLA  ,2023-02-16,2023-02-24,105.0,109,1938,2047
195,TSLA  ,2023-02-16,2023-02-24,106.0,14,545,559
196,TSLA  ,2023-02-16,2023-02-24,107.0,12,664,676
197,TSLA  ,2023-02-16,2023-02-24,108.0,9,411,420
198,TSLA  ,2023-02-16,2023-02-24,109.0,12,489,501
199,TSLA  ,2023-02-16,2023-02-24,110.0,336,1589,1925
200,TSLA  ,2023-02-16,2023-02-24,111.0,60,490,550
201,TSLA  ,2023-02-16,2023-02-24,112.0,51,527,578
202,TSLA  ,2023-02-16,2023-02-24,113.0,45,676,721
203,TSLA  ,2023-02-16,2023-02-24,114.0,355,937,1292
204,TSLA  ,2023-02-16,2023-02-24,115.0,354,1198,1552
205,TSLA  ,2023-02-16,2023-02-24,116.0,320,740,1060
206,TSLA  ,2023-02-16,2023-02-24,117.0,271,548,819
207,TSLA  ,2023-02-16,2023-02-24,118.0,196,596,792
208,TSLA  ,2023-02-16,2023-02-24,119.0,207,647,854
209,TSLA  ,2023-02-16,2023-02-24,120.0,463,2700,3163
210,TSLA  ,2023-02-16,2023-02-24,121.0,315,745,1060
211,TSLA  ,2023-02-16,2023-02-24,122.0,294,2502,2796
212,TSLA  ,2023-02-16,2023-02-24,123.0,430,607,1037
213,TSLA  ,2023-02-16,2023-02-24,124.0,162,499,661
214,TSLA  ,2023-02-16,2023-02-24,125.0,585,2714,3299
215,TSLA  ,2023-02-16,2023-02-24,126.0,199,562,761
216,TSLA  ,2023-02-16,2023-02-24,127.0,99,1155,1254
217,TSLA  ,2023-02-16,2023-02-24,128.0,159,763,922
218,TSLA  ,2023-02-16,2023-02-24,129.0,235,1308,1543
219,TSLA  ,2023-02-16,2023-02-24,130.0,2694,2660,5354
220,TSLA  ,2023-02-16,2023-02-24,131.0,423,502,925
221,TSLA  ,2023-02-16,2023-02-24,132.0,255,1206,1461
222,TSLA  ,2023-02-16,2023-02-24,133.0,145,472,617
223,TSLA  ,2023-02-16,2023-02-24,134.0,267,786,1053
224,TSLA  ,2023-02-16,2023-02-24,135.0,1920,1970,3890
225,TSLA  ,2023-02-16,2023-02-24,136.0,79,510,589
226,TSLA  ,2023-02-16,2023-02-24,137.0,134,636,770
227,TSLA  ,2023-02-16,2023-02-24,138.0,415,494,909
228,TSLA  ,2023-02-16,2023-02-24,139.0,522,448,970
229,TSLA  ,2023-02-16,2023-02-24,140.0,2038,2939,4977
230,TSLA  ,2023-02-16,2023-02-24,141.0,343,1300,1643
231,TSLA  ,2023-02-16,2023-02-24,142.0,440,938,1378
232,TSLA  ,2023-02-16,2023-02-24,143.0,86,429,515
233,TSLA  ,2023-02-16,2023-02-24,144.0,68,1507,1575
234,TSLA  ,2023-02-16,2023-02-24,145.0,1784,4605,6389
235,TSLA  ,2023-02-16,2023-02-24,146.0,71,994,1065
236,TSLA  ,2023-02-16,2023-02-24,147.0,45,497,542
237,TSLA  ,2023-02-16,2023-02-24,148.0,148,2840,2988
238,TSLA  ,2023-02-16,2023-02-24,149.0,110,1255,1365
239,TSLA  ,2023-02-16,2023-02-24,150.0,3303,7394,10697
240,TSLA  ,2023-02-16,2023-02-24,152.5,103,1622,1725
241,TSLA  ,2023-02-16,2023-02-24,155.0,3022,7805,10827
242,TSLA  ,2023-02-16,2023-02-24,157.5,910,922,1832
243,TSLA  ,2023-02-16,2023-02-24,160.0,2967,6738,9705
244,TSLA  ,2023-02-16,2023-02-24,162.5,363,1482,1845
245,TSLA  ,2023-02-16,2023-02-24,165.0,2290,2590,4880
246,TSLA  ,2023-02-16,2023-02-24,167.5,1030,2299,3329
247,TSLA  ,2023-02-16,2023-02-24,170.0,6369,6568,12937
248,TSLA  ,2023-02-16,2023-02-24,172.5,743,1419,2162
249,TSLA  ,2023-02-16,2023-02-24,175.0,4080,3878,7958
250,TSLA  ,2023-02-16,2023-02-24,177.5,403,4443,4846
251,TSLA  ,2023-02-16,2023-02-24,180.0,4949,12751,17700
252,TSLA  ,2023-02-16,2023-02-24,182.5,487,2972,3459
253,TSLA  ,2023-02-16,2023-02-24,185.0,1664,5533,7197
254,TSLA  ,2023-02-16,2023-02-24,187.5,745,2471,3216
255,TSLA  ,2023-02-16,2023-02-24,190.0,9341,14432,23773
256,TSLA  ,2023-02-16,2023-02-24,192.5,2025,5829,7854
257,TSLA  ,2023-02-16,2023-02-24,195.0,5965,5956,11921
258,TSLA  ,2023-02-16,2023-02-24,197.5,1786,2964,4750
259,TSLA  ,2023-02-16,2023-02-24,200.0,22229,11548,33777
260,TSLA  ,2023-02-16,2023-02-24,202.5,2057,1494,3551
261,TSLA  ,2023-02-16,2023-02-24,205.0,4392,6651,11043
262,TSLA  ,2023-02-16,2023-02-24,207.5,2848,1802,4650
263,TSLA  ,2023-02-16,2023-02-24,210.0,25368,5204,30572
264,TSLA  ,2023-02-16,2023-02-24,212.5,3876,1902,5778
265,TSLA  ,2023-02-16,2023-02-24,215.0,7569,1407,8976
266,TSLA  ,2023-02-16,2023-02-24,217.5,2035,508,2543
267,TSLA  ,2023-02-16,2023-02-24,220.0,19840,1349,21189
268,TSLA  ,2023-02-16,2023-02-24,222.5,2474,170,2644
269,TSLA  ,2023-02-16,2023-02-24,225.0,8242,317,8559
270,TSLA  ,2023-02-16,2023-02-24,227.5,2098,81,2179
271,TSLA  ,2023-02-16,2023-02-24,230.0,10556,653,11209
272,TSLA  ,2023-02-16,2023-02-24,232.5,2253,67,2320
273,TSLA  ,2023-02-16,2023-02-24,235.0,3653,94,3747
274,TSLA  ,2023-02-16,2023-02-24,237.5,787,191,978
275,TSLA  ,2023-02-16,2023-02-24,240.0,13472,1073,14545
276,TSLA  ,2023-02-16,2023-02-24,242.5,884,145,1029
277,TSLA  ,2023-02-16,2023-02-24,245.0,4483,189,4672
278,TSLA  ,2023-02-16,2023-02-24,247.5,478,15,493
279,TSLA  ,2023-02-16,2023-02-24,250.0,9106,366,9472
280,TSLA  ,2023-02-16,2023-02-24,252.5,451,11,462
281,TSLA  ,2023-02-16,2023-02-24,255.0,3891,10,3901
282,TSLA  ,2023-02-16,2023-02-24,257.5,509,37,546
283,TSLA  ,2023-02-16,2023-02-24,260.0,7098,6,7104
284,TSLA  ,2023-02-16,2023-02-24,262.5,562,4,566
285,TSLA  ,2023-02-16,2023-02-24,265.0,3327,4,3331
286,TSLA  ,2023-02-16,2023-02-24,270.0,4976,56,5032
287,TSLA  ,2023-02-16,2023-02-24,275.0,6922,6,6928
288,TSLA  ,2023-02-16,2023-02-24,280.0,3804,1,3805
289,TSLA  ,2023-02-16,2023-02-24,285.0,6712,0,6712
290,TSLA  ,2023-02-16,2023-02-24,290.0,3304,0,3304
291,TSLA  ,2023-02-16,2023-02-24,295.0,6236,0,6236
292,TSLA  ,2023-02-16,2023-02-24,300.0,3323,1,3324
293,TSLA  ,2023-02-16,2023-02-24,310.0,2007,0,2007
294,TSLA  ,2023-02-16,2023-02-24,320.0,1587,0,1587
295,TSLA  ,2023-02-16,2023-02-24,330.0,937,0,937
296,TSLA  ,2023-02-16,2023-02-24,340.0,1479,0,1479
297,TSLA  ,2023-02-16,2023-02-24,350.0,3018,0,3018
298,TSLA  ,2023-02-16,2023-02-24,360.0,9444,0,9444
299,TSLA  ,2023-02-16,2023-03-03,15.0,11,256,267
300,TSLA  ,2023-02-16,2023-03-03,20.0,2,0,2
301,TSLA  ,2023-02-16,2023-03-03,25.0,4,47,51
302,TSLA  ,2023-02-16,2023-03-03,30.0,3,340,343
303,TSLA  ,2023-02-16,2023-03-03,35.0,3,1,4
304,TSLA  ,2023-02-16,2023-03-03,40.0,0,10,10
305,TSLA  ,2023-02-16,2023-03-03,45.0,0,2457,2457
306,TSLA  ,2023-02-16,2023-03-03,50.0,1,886,887
307,TSLA  ,2023-02-16,2023-03-03,55.0,0,156,156
308,TSLA  ,2023-02-16,2023-03-03,60.0,2,1118,1120
309,TSLA  ,2023-02-16,2023-03-03,65.0,1,99,100
310,TSLA  ,2023-02-16,2023-03-03,70.0,2,692,694
311,TSLA  ,2023-02-16,2023-03-03,75.0,1,276,277
312,TSLA  ,2023-02-16,2023-03-03,80.0,112,1893,2005
313,TSLA  ,2023-02-16,2023-03-03,85.0,4,577,581
314,TSLA  ,2023-02-16,2023-03-03,90.0,7,1027,1034
315,TSLA  ,2023-02-16,2023-03-03,95.0,7,1997,2004
316,TSLA  ,2023-02-16,2023-03-03,100.0,111,2030,2141
317,TSLA  ,2023-02-16,2023-03-03,105.0,19,892,911
318,TSLA  ,2023-02-16,2023-03-03,108.0,51,513,564
319,TSLA  ,2023-02-16,2023-03-03,109.0,34,324,358
320,TSLA  ,2023-02-16,2023-03-03,110.0,110,3172,3282
321,TSLA  ,2023-02-16,2023-03-03,111.0,7,565,572
322,TSLA  ,2023-02-16,2023-03-03,112.0,43,602,645
323,TSLA  ,2023-02-16,2023-03-03,113.0,33,743,776
324,TSLA  ,2023-02-16,2023-03-03,114.0,154,504,658
325,TSLA  ,2023-02-16,2023-03-03,115.0,186,894,1080
326,TSLA  ,2023-02-16,2023-03-03,116.0,158,425,583
327,TSLA  ,2023-02-16,2023-03-03,117.0,472,750,1222
328,TSLA  ,2023-02-16,2023-03-03,118.0,309,376,685
329,TSLA  ,2023-02-16,2023-03-03,119.0,318,528,846
330,TSLA  ,2023-02-16,2023-03-03,120.0,920,2818,3738
331,TSLA  ,2023-02-16,2023-03-03,121.0,91,547,638
332,TSLA  ,2023-02-16,2023-03-03,122.0,121,921,1042
333,TSLA  ,2023-02-16,2023-03-03,123.0,264,604,868
334,TSLA  ,2023-02-16,2023-03-03,124.0,447,827,1274
335,TSLA  ,2023-02-16,2023-03-03,125.0,257,931,1188
336,TSLA  ,2023-02-16,2023-03-03,126.0,669,383,1052
337,TSLA  ,2023-02-16,2023-03-03,127.0,426,263,689
338,TSLA  ,2023-02-16,2023-03-03,128.0,455,766,1221
339,TSLA  ,2023-02-16,2023-03-03,129.0,646,610,1256
340,TSLA  ,2023-02-16,2023-03-03,130.0,679,1922,2601
341,TSLA  ,2023-02-16,2023-03-03,131.0,305,759,1064
342,TSLA  ,2023-02-16,2023-03-03,132.0,806,709,1515
343,TSLA  ,2023-02-16,2023-03-03,133.0,558,113,671
344,TSLA  ,2023-02-16,2023-03-03,134.0,569,1200,1769
345,TSLA  ,2023-02-16,2023-03-03,135.0,870,1260,2130
346,TSLA  ,2023-02-16,2023-03-03,136.0,94,94,188
347,TSLA  ,2023-02-16,2023-03-03,137.0,75,151,226
348,TSLA  ,2023-02-16,2023-03-03,138.0,149,437,586
349,TSLA  ,2023-02-16,2023-03-03,139.0,109,180,289
350,TSLA  ,2023-02-16,2023-03-03,140.0,644,1815,2459
351,TSLA  ,2023-02-16,2023-03-03,141.0,60,555,615
352,TSLA  ,2023-02-16,2023-03-03,142.0,295,306,601
353,TSLA  ,2023-02-16,2023-03-03,143.0,49,156,205
354,TSLA  ,2023-02-16,2023-03-03,144.0,25,3164,3189
355,TSLA  ,2023-02-16,2023-03-03,145.0,627,2070,2697
356,TSLA  ,2023-02-16,2023-03-03,146.0,36,690,726
357,TSLA  ,2023-02-16,2023-03-03,147.0,40,270,310
358,TSLA  ,2023-02-16,2023-03-03,148.0,37,492,529
359,TSLA  ,2023-02-16,2023-03-03,149.0,299,1733,2032
360,TSLA  ,2023-02-16,2023-03-03,150.0,1049,9780,10829
361,TSLA  ,2023-02-16,2023-03-03,152.5,194,1369,1563
362,TSLA  ,2023-02-16,2023-03-03,155.0,1459,1311,2770
363,TSLA  ,2023-02-16,2023-03-03,157.5,148,1375,1523
364,TSLA  ,2023-02-16,2023-03-03,160.0,1191,11264,12455
365,TSLA  ,2023-02-16,2023-03-03,162.5,367,2765,3132
366,TSLA  ,2023-02-16,2023-03-03,165.0,1921,1831,3752
367,TSLA  ,2023-02-16,2023-03-03,167.5,260,1271,1531
368,TSLA  ,2023-02-16,2023-03-03,170.0,2446,4921,7367
369,TSLA  ,2023-02-16,2023-03-03,172.5,1194,830,2024
370,TSLA  ,2023-02-16,2023-03-03,175.0,1169,2384,3553
371,TSLA  ,2023-02-16,2023-03-03,177.5,489,412,901
372,TSLA  ,2023-02-16,2023-03-03,180.0,2424,3203,5627
373,TSLA  ,2023-02-16,2023-03-03,182.5,357,857,1214
374,TSLA  ,2023-02-16,2023-03-03,185.0,1653,2134,3787
375,TSLA  ,2023-02-16,2023-03-03,187.5,1466,775,2241
376,TSLA  ,2023-02-16,2023-03-03,190.0,2743,2517,5260
377,TSLA  ,2023-02-16,2023-03-03,192.5,1085,1124,2209
378,TSLA  ,2023-02-16,2023-03-03,195.0,3914,2287,6201
379,TSLA  ,2023-02-16,2023-03-03,197.5,3006,1143,4149
380,TSLA  ,2023-02-16,2023-03-03,200.0,8263,3518,11781
381,TSLA  ,2023-02-16,2023-03-03,202.5,2358,1555,3913
382,TSLA  ,2023-02-16,2023-03-03,205.0,3792,1611,5403
383,TSLA  ,2023-02-16,2023-03-03,207.5,2476,1174,3650
384,TSLA  ,2023-02-16,2023-03-03,210.0,4654,1140,5794
385,TSLA  ,2023-02-16,2023-03-03,212.5,1830,725,2555
386,TSLA  ,2023-02-16,2023-03-03,215.0,4794,554,5348
387,TSLA  ,2023-02-16,2023-03-03,217.5,1111,391,1502
388,TSLA  ,2023-02-16,2023-03-03,220.0,6038,784,6822
389,TSLA  ,2023-02-16,2023-03-03,222.5,987,62,1049
390,TSLA  ,2023-02-16,2023-03-03,225.0,3499,73,3572
391,TSLA  ,2023-02-16,2023-03-03,227.5,596,9,605
392,TSLA  ,2023-02-16,2023-03-03,230.0,8803,315,9118
393,TSLA  ,2023-02-16,2023-03-03,235.0,3455,53,3508
394,TSLA  ,2023-02-16,2023-03-03,240.0,4940,441,5381
395,TSLA  ,2023-02-16,2023-03-03,245.0,3682,143,3825
396,TSLA  ,2023-02-16,2023-03-03,250.0,6635,101,6736
397,TSLA  ,2023-02-16,2023-03-03,255.0,1898,11,1909
398,TSLA  ,2023-02-16,2023-03-03,260.0,2056,22,2078
399,TSLA  ,2023-02-16,2023-03-03,265.0,3824,40,3864
400,TSLA  ,2023-02-16,2023-03-03,270.0,3037,31,3068
401,TSLA  ,2023-02-16,2023-03-03,275.0,3208,32,3240
402,TSLA  ,2023-02-16,2023-03-03,280.0,1469,19,1488
403,TSLA  ,2023-02-16,2023-03-03,285.0,803,47,850
404,TSLA  ,2023-02-16,2023-03-03,290.0,2560,15,2575
405,TSLA  ,2023-02-16,2023-03-03,295.0,606,22,628
406,TSLA  ,2023-02-16,2023-03-03,300.0,6731,48,6779
407,TSLA  ,2023-02-16,2023-03-03,310.0,1410,0,1410
408,TSLA  ,2023-02-16,2023-03-03,320.0,2550,5,2555
409,TSLA  ,2023-02-16,2023-03-03,330.0,441,0,441
410,TSLA  ,2023-02-16,2023-03-03,340.0,3580,0,3580
411,TSLA  ,2023-02-16,2023-03-03,350.0,891,2,893
412,TSLA  ,2023-02-16,2023-03-03,360.0,2102,0,2102
413,TSLA  ,2023-02-16,2023-03-10,15.0,3,100,103
414,TSLA  ,2023-02-16,2023-03-10,20.0,3,0,3
415,TSLA  ,2023-02-16,2023-03-10,25.0,0,0,0
416,TSLA  ,2023-02-16,2023-03-10,30.0,3,2,5
417,TSLA  ,2023-02-16,2023-03-10,35.0,0,0,0
418,TSLA  ,2023-02-16,2023-03-10,40.0,0,10,10
419,TSLA  ,2023-02-16,2023-03-10,45.0,0,0,0
420,TSLA  ,2023-02-16,2023-03-10,50.0,5,638,643
421,TSLA  ,2023-02-16,2023-03-10,55.0,0,1209,1209
422,TSLA  ,2023-02-16,2023-03-10,60.0,0,23,23
423,TSLA  ,2023-02-16,2023-03-10,65.0,50,14,64
424,TSLA  ,2023-02-16,2023-03-10,70.0,0,114,114
425,TSLA  ,2023-02-16,2023-03-10,75.0,0,454,454
426,TSLA  ,2023-02-16,2023-03-10,80.0,0,86,86
427,TSLA  ,2023-02-16,2023-03-10,85.0,0,69,69
428,TSLA  ,2023-02-16,2023-03-10,90.0,0,96,96
429,TSLA  ,2023-02-16,2023-03-10,95.0,11,335,346
430,TSLA  ,2023-02-16,2023-03-10,100.0,23,810,833
431,TSLA  ,2023-02-16,2023-03-10,105.0,5,377,382
432,TSLA  ,2023-02-16,2023-03-10,110.0,14,868,882
433,TSLA  ,2023-02-16,2023-03-10,115.0,23,643,666
434,TSLA  ,2023-02-16,2023-03-10,120.0,29,1334,1363
435,TSLA  ,2023-02-16,2023-03-10,125.0,18,681,699
436,TSLA  ,2023-02-16,2023-03-10,130.0,82,380,462
437,TSLA  ,2023-02-16,2023-03-10,134.0,5,164,169
438,TSLA  ,2023-02-16,2023-03-10,135.0,33,603,636
439,TSLA  ,2023-02-16,2023-03-10,136.0,55,166,221
440,TSLA  ,2023-02-16,2023-03-10,137.0,8,81,89
441,TSLA  ,2023-02-16,2023-03-10,138.0,14,104,118
442,TSLA  ,2023-02-16,2023-03-10,139.0,4,112,116
443,TSLA  ,2023-02-16,2023-03-10,140.0,53,1101,1154
444,TSLA  ,2023-02-16,2023-03-10,141.0,143,456,599
445,TSLA  ,2023-02-16,2023-03-10,142.0,23,240,263
446,TSLA  ,2023-02-16,2023-03-10,143.0,11,501,512
447,TSLA  ,2023-02-16,2023-03-10,144.0,12,48,60
448,TSLA  ,2023-02-16,2023-03-10,145.0,99,374,473
449,TSLA  ,2023-02-16,2023-03-10,146.0,38,75,113
450,TSLA  ,2023-02-16,2023-03-10,147.0,84,145,229
451,TSLA  ,2023-02-16,2023-03-10,148.0,98,823,921
452,TSLA  ,2023-02-16,2023-03-10,149.0,3,197,200
453,TSLA  ,2023-02-16,2023-03-10,150.0,249,1323,1572
454,TSLA  ,2023-02-16,2023-03-10,152.5,116,267,383
455,TSLA  ,2023-02-16,2023-03-10,155.0,289,762,1051
456,TSLA  ,2023-02-16,2023-03-10,157.5,93,365,458
457,TSLA  ,2023-02-16,2023-03-10,160.0,240,859,1099
458,TSLA  ,2023-02-16,2023-03-10,162.5,111,502,613
459,TSLA  ,2023-02-16,2023-03-10,165.0,266,1112,1378
460,TSLA  ,2023-02-16,2023-03-10,167.5,261,534,795
461,TSLA  ,2023-02-16,2023-03-10,170.0,403,1590,1993
462,TSLA  ,2023-02-16,2023-03-10,172.5,256,373,629
463,TSLA  ,2023-02-16,2023-03-10,175.0,430,1301,1731
464,TSLA  ,2023-02-16,2023-03-10,177.5,1889,608,2497
465,TSLA  ,2023-02-16,2023-03-10,180.0,638,2587,3225
466,TSLA  ,2023-02-16,2023-03-10,182.5,167,448,615
467,TSLA  ,2023-02-16,2023-03-10,185.0,354,952,1306
468,TSLA  ,2023-02-16,2023-03-10,187.5,1207,293,1500
469,TSLA  ,2023-02-16,2023-03-10,190.0,1450,1531,2981
470,TSLA  ,2023-02-16,2023-03-10,192.5,615,551,1166
471,TSLA  ,2023-02-16,2023-03-10,195.0,724,3784,4508
472,TSLA  ,2023-02-16,2023-03-10,197.5,466,1052,1518
473,TSLA  ,2023-02-16,2023-03-10,200.0,2013,1526,3539
474,TSLA  ,2023-02-16,2023-03-10,202.5,1382,1056,2438
475,TSLA  ,2023-02-16,2023-03-10,205.0,1085,1228,2313
476,TSLA  ,2023-02-16,2023-03-10,207.5,581,469,1050
477,TSLA  ,2023-02-16,2023-03-10,210.0,1901,706,2607
478,TSLA  ,2023-02-16,2023-03-10,212.5,599,600,1199
479,TSLA  ,2023-02-16,2023-03-10,215.0,1280,223,1503
480,TSLA  ,2023-02-16,2023-03-10,217.5,302,148,450
481,TSLA  ,2023-02-16,2023-03-10,220.0,1918,82,2000
482,TSLA  ,2023-02-16,2023-03-10,222.5,371,84,455
483,TSLA  ,2023-02-16,2023-03-10,225.0,982,132,1114
484,TSLA  ,2023-02-16,2023-03-10,230.0,1235,92,1327
485,TSLA  ,2023-02-16,2023-03-10,235.0,823,24,847
486,TSLA  ,2023-02-16,2023-03-10,240.0,1239,15,1254
487,TSLA  ,2023-02-16,2023-03-10,245.0,631,53,684
488,TSLA  ,2023-02-16,2023-03-10,250.0,2621,161,2782
489,TSLA  ,2023-02-16,2023-03-10,255.0,424,2,426
490,TSLA  ,2023-02-16,2023-03-10,260.0,1294,64,1358
491,TSLA  ,2023-02-16,2023-03-10,265.0,3408,2,3410
492,TSLA  ,2023-02-16,2023-03-10,270.0,542,4,546
493,TSLA  ,2023-02-16,2023-03-10,275.0,510,5,515
494,TSLA  ,2023-02-16,2023-03-10,280.0,1707,6,1713
495,TSLA  ,2023-02-16,2023-03-10,285.0,671,0,671
496,TSLA  ,2023-02-16,2023-03-10,290.0,389,3,392
497,TSLA  ,2023-02-16,2023-03-10,295.0,450,0,450
498,TSLA  ,2023-02-16,2023-03-10,300.0,2174,0,2174
499,TSLA  ,2023-02-16,2023-03-10,310.0,2783,11,2794
500,TSLA  ,2023-02-16,2023-03-10,320.0,482,1,483
501,TSLA  ,2023-02-16,2023-03-10,330.0,341,0,341
502,TSLA  ,2023-02-16,2023-03-10,340.0,528,0,528
503,TSLA  ,2023-02-16,2023-03-10,350.0,715,0,715
504,TSLA  ,2023-02-16,2023-03-10,360.0,858,0,858
505,TSLA  ,2023-02-16,2023-03-17,1.67,50,24711,24761
506,TSLA  ,2023-02-16,2023-03-17,3.33,29,6941,6970
507,TSLA  ,2023-02-16,2023-03-17,5.0,2,8008,8010
508,TSLA  ,2023-02-16,2023-03-17,6.67,52,4669,4721
509,TSLA  ,2023-02-16,2023-03-17,8.33,15,1379,1394
510,TSLA  ,2023-02-16,2023-03-17,10.0,842,4105,4947
511,TSLA  ,2023-02-16,2023-03-17,11.67,1711,5414,7125
512,TSLA  ,2023-02-16,2023-03-17,13.33,1657,2125,3782
513,TSLA  ,2023-02-16,2023-03-17,15.0,987,5169,6156
514,TSLA  ,2023-02-16,2023-03-17,16.67,863,15329,16192
515,TSLA  ,2023-02-16,2023-03-17,18.33,466,12018,12484
516,TSLA  ,2023-02-16,2023-03-17,33.33,406,33639,34045
517,TSLA  ,2023-02-16,2023-03-17,50.0,503,21502,22005
518,TSLA  ,2023-02-16,2023-03-17,55.0,34,4706,4740
519,TSLA  ,2023-02-16,2023-03-17,60.0,182,6715,6897
520,TSLA  ,2023-02-16,2023-03-17,65.0,25,2865,2890
521,TSLA  ,2023-02-16,2023-03-17,66.67,888,17833,18721
522,TSLA  ,2023-02-16,2023-03-17,70.0,49,8117,8166
523,TSLA  ,2023-02-16,2023-03-17,75.0,54,5327,5381
524,TSLA  ,2023-02-16,2023-03-17,80.0,219,11977,12196
525,TSLA  ,2023-02-16,2023-03-17,83.33,886,5152,6038
526,TSLA  ,2023-02-16,2023-03-17,85.0,87,3630,3717
527,TSLA  ,2023-02-16,2023-03-17,90.0,664,16105,16769
528,TSLA  ,2023-02-16,2023-03-17,95.0,337,3393,3730
529,TSLA  ,2023-02-16,2023-03-17,100.0,1752,39039,40791
530,TSLA  ,2023-02-16,2023-03-17,105.0,1414,4445,5859
531,TSLA  ,2023-02-16,2023-03-17,110.0,2851,13895,16746
532,TSLA  ,2023-02-16,2023-03-17,115.0,3397,9274,12671
533,TSLA  ,2023-02-16,2023-03-17,116.67,1372,10922,12294
534,TSLA  ,2023-02-16,2023-03-17,120.0,12412,26506,38918
535,TSLA  ,2023-02-16,2023-03-17,123.33,2744,6329,9073
536,TSLA  ,2023-02-16,2023-03-17,125.0,3580,10896,14476
537,TSLA  ,2023-02-16,2023-03-17,126.67,1683,4786,6469
538,TSLA  ,2023-02-16,2023-03-17,130.0,7391,11684,19075
539,TSLA  ,2023-02-16,2023-03-17,133.33,3431,9676,13107
540,TSLA  ,2023-02-16,2023-03-17,135.0,27640,33858,61498
541,TSLA  ,2023-02-16,2023-03-17,136.67,2870,3624,6494
542,TSLA  ,2023-02-16,2023-03-17,140.0,6975,29832,36807
543,TSLA  ,2023-02-16,2023-03-17,143.33,2436,4847,7283
544,TSLA  ,2023-02-16,2023-03-17,145.0,2834,8326,11160
545,TSLA  ,2023-02-16,2023-03-17,146.67,1863,4339,6202
546,TSLA  ,2023-02-16,2023-03-17,150.0,13475,25532,39007
547,TSLA  ,2023-02-16,2023-03-17,153.33,1662,2954,4616
548,TSLA  ,2023-02-16,2023-03-17,155.0,3632,6440,10072
549,TSLA  ,2023-02-16,2023-03-17,156.67,2240,3433,5673
550,TSLA  ,2023-02-16,2023-03-17,160.0,8026,24511,32537
551,TSLA  ,2023-02-16,2023-03-17,163.33,3018,5806,8824
552,TSLA  ,2023-02-16,2023-03-17,165.0,7068,6497,13565
553,TSLA  ,2023-02-16,2023-03-17,166.67,6331,11895,18226
554,TSLA  ,2023-02-16,2023-03-17,170.0,10745,22431,33176
555,TSLA  ,2023-02-16,2023-03-17,173.33,3135,12369,15504
556,TSLA  ,2023-02-16,2023-03-17,175.0,4951,9244,14195
557,TSLA  ,2023-02-16,2023-03-17,176.67,5208,3587,8795
558,TSLA  ,2023-02-16,2023-03-17,180.0,20264,24102,44366
559,TSLA  ,2023-02-16,2023-03-17,183.33,3370,8161,11531
560,TSLA  ,2023-02-16,2023-03-17,185.0,3450,4643,8093
561,TSLA  ,2023-02-16,2023-03-17,186.67,2662,4566,7228
562,TSLA  ,2023-02-16,2023-03-17,190.0,16870,19867,36737
563,TSLA  ,2023-02-16,2023-03-17,193.33,2177,2531,4708
564,TSLA  ,2023-02-16,2023-03-17,195.0,11375,10434,21809
565,TSLA  ,2023-02-16,2023-03-17,196.67,2715,1938,4653
566,TSLA  ,2023-02-16,2023-03-17,198.33,3829,2576,6405
567,TSLA  ,2023-02-16,2023-03-17,200.0,39751,36704,76455
568,TSLA  ,2023-02-16,2023-03-17,201.67,2112,1683,3795
569,TSLA  ,2023-02-16,2023-03-17,203.33,3163,2437,5600
570,TSLA  ,2023-02-16,2023-03-17,205.0,4297,3438,7735
571,TSLA  ,2023-02-16,2023-03-17,206.67,2668,2393,5061
572,TSLA  ,2023-02-16,2023-03-17,208.33,2483,1143,3626
573,TSLA  ,2023-02-16,2023-03-17,210.0,11153,6382,17535
574,TSLA  ,2023-02-16,2023-03-17,211.67,2405,952,3357
575,TSLA  ,2023-02-16,2023-03-17,213.33,1931,681,2612
576,TSLA  ,2023-02-16,2023-03-17,215.0,9417,880,10297
577,TSLA  ,2023-02-16,2023-03-17,216.67,4780,2919,7699
578,TSLA  ,2023-02-16,2023-03-17,218.33,1624,213,1837
579,TSLA  ,2023-02-16,2023-03-17,220.0,13866,1472,15338
580,TSLA  ,2023-02-16,2023-03-17,221.67,1405,306,1711
581,TSLA  ,2023-02-16,2023-03-17,223.33,1199,330,1529
582,TSLA  ,2023-02-16,2023-03-17,225.0,5722,1632,7354
583,TSLA  ,2023-02-16,2023-03-17,226.67,2154,215,2369
584,TSLA  ,2023-02-16,2023-03-17,228.33,4940,68,5008
585,TSLA  ,2023-02-16,2023-03-17,230.0,9167,1822,10989
586,TSLA  ,2023-02-16,2023-03-17,231.67,1493,71,1564
587,TSLA  ,2023-02-16,2023-03-17,233.33,6834,426,7260
588,TSLA  ,2023-02-16,2023-03-17,235.0,9096,105,9201
589,TSLA  ,2023-02-16,2023-03-17,236.67,1237,85,1322
590,TSLA  ,2023-02-16,2023-03-17,238.33,1058,100,1158
591,TSLA  ,2023-02-16,2023-03-17,240.0,8075,356,8431
592,TSLA  ,2023-02-16,2023-03-17,241.67,1175,70,1245
593,TSLA  ,2023-02-16,2023-03-17,243.33,1322,404,1726
594,TSLA  ,2023-02-16,2023-03-17,245.0,2416,40,2456
595,TSLA  ,2023-02-16,2023-03-17,246.67,1093,33,1126
596,TSLA  ,2023-02-16,2023-03-17,248.33,1170,32,1202
597,TSLA  ,2023-02-16,2023-03-17,250.0,24707,897,25604
598,TSLA  ,2023-02-16,2023-03-17,251.67,1691,67,1758
599,TSLA  ,2023-02-16,2023-03-17,253.33,670,26,696
600,TSLA  ,2023-02-16,2023-03-17,255.0,4461,69,4530
601,TSLA  ,2023-02-16,2023-03-17,256.67,682,17,699
602,TSLA  ,2023-02-16,2023-03-17,258.33,974,28,1002
603,TSLA  ,2023-02-16,2023-03-17,260.0,7013,50,7063
604,TSLA  ,2023-02-16,2023-03-17,261.67,1581,12,1593
605,TSLA  ,2023-02-16,2023-03-17,263.33,1057,72,1129
606,TSLA  ,2023-02-16,2023-03-17,265.0,2764,16,2780
607,TSLA  ,2023-02-16,2023-03-17,266.67,10945,379,11324
608,TSLA  ,2023-02-16,2023-03-17,270.0,5170,36,5206
609,TSLA  ,2023-02-16,2023-03-17,273.33,3801,80,3881
610,TSLA  ,2023-02-16,2023-03-17,275.0,746,14,760
611,TSLA  ,2023-02-16,2023-03-17,276.67,1463,41,1504
612,TSLA  ,2023-02-16,2023-03-17,280.0,3879,140,4019
613,TSLA  ,2023-02-16,2023-03-17,283.33,6950,54,7004
614,TSLA  ,2023-02-16,2023-03-17,285.0,321,1,322
615,TSLA  ,2023-02-16,2023-03-17,286.67,2011,27,2038
616,TSLA  ,2023-02-16,2023-03-17,290.0,3692,65,3757
617,TSLA  ,2023-02-16,2023-03-17,293.33,7306,343,7649
618,TSLA  ,2023-02-16,2023-03-17,295.0,2953,10,2963
619,TSLA  ,2023-02-16,2023-03-17,296.67,937,16,953
620,TSLA  ,2023-02-16,2023-03-17,298.33,1099,3,1102
621,TSLA  ,2023-02-16,2023-03-17,300.0,72748,459,73207
622,TSLA  ,2023-02-16,2023-03-17,301.67,1481,17,1498
623,TSLA  ,2023-02-16,2023-03-17,303.33,1472,3,1475
624,TSLA  ,2023-02-16,2023-03-17,305.0,2649,26,2675
625,TSLA  ,2023-02-16,2023-03-17,306.67,2016,3,2019
626,TSLA  ,2023-02-16,2023-03-17,308.33,3556,2,3558
627,TSLA  ,2023-02-16,2023-03-17,310.0,4370,37,4407
628,TSLA  ,2023-02-16,2023-03-17,311.67,2044,5,2049
629,TSLA  ,2023-02-16,2023-03-17,313.33,2571,1,2572
630,TSLA  ,2023-02-16,2023-03-17,316.67,29631,11,29642
631,TSLA  ,2023-02-16,2023-03-17,320.0,15615,205,15820
632,TSLA  ,2023-02-16,2023-03-17,323.33,471,2,473
633,TSLA  ,2023-02-16,2023-03-17,326.67,678,1,679
634,TSLA  ,2023-02-16,2023-03-17,330.0,3189,8,3197
635,TSLA  ,2023-02-16,2023-03-17,333.33,20572,29,20601
636,TSLA  ,2023-02-16,2023-03-17,336.67,833,0,833
637,TSLA  ,2023-02-16,2023-03-17,340.0,5266,4,5270
638,TSLA  ,2023-02-16,2023-03-17,343.33,1875,0,1875
639,TSLA  ,2023-02-16,2023-03-17,346.67,624,0,624
640,TSLA  ,2023-02-16,2023-03-17,350.0,11211,6,11217
641,TSLA  ,2023-02-16,2023-03-17,353.33,1315,0,1315
642,TSLA  ,2023-02-16,2023-03-17,356.67,509,0,509
643,TSLA  ,2023-02-16,2023-03-17,360.0,2177,0,2177
644,TSLA  ,2023-02-16,2023-03-17,363.33,572,0,572
645,TSLA  ,2023-02-16,2023-03-17,366.67,7763,0,7763
646,TSLA  ,2023-02-16,2023-03-17,370.0,1378,0,1378
647,TSLA  ,2023-02-16,2023-03-17,373.33,677,0,677
648,TSLA  ,2023-02-16,2023-03-17,383.33,12756,0,12756
649,TSLA  ,2023-02-16,2023-03-17,400.0,25396,0,25396
650,TSLA  ,2023-02-16,2023-03-17,416.67,13219,0,13219
651,TSLA  ,2023-02-16,2023-03-17,433.33,19415,0,19415
652,TSLA  ,2023-02-16,2023-03-17,441.67,2014,0,2014
653,TSLA  ,2023-02-16,2023-03-17,450.0,5515,0,5515
654,TSLA  ,2023-02-16,2023-03-17,458.33,2460,0,2460
655,TSLA  ,2023-02-16,2023-03-17,466.67,2885,10,2895
656,TSLA  ,2023-02-16,2023-03-17,475.0,3754,0,3754
657,TSLA  ,2023-02-16,2023-03-17,483.33,1989,0,1989
658,TSLA  ,2023-02-16,2023-03-17,491.67,2482,0,2482
659,TSLA  ,2023-02-16,2023-03-17,500.0,13815,26,13841
660,TSLA  ,2023-02-16,2023-03-17,508.33,3616,0,3616
661,TSLA  ,2023-02-16,2023-03-17,516.67,1122,0,1122
662,TSLA  ,2023-02-16,2023-03-17,525.0,4879,0,4879
663,TSLA  ,2023-02-16,2023-03-17,533.33,4709,0,4709
664,TSLA  ,2023-02-16,2023-03-17,541.67,1032,0,1032
665,TSLA  ,2023-02-16,2023-03-17,550.0,5036,0,5036
666,TSLA  ,2023-02-16,2023-03-17,558.33,3779,0,3779
667,TSLA  ,2023-02-16,2023-03-17,566.67,7710,0,7710
668,TSLA  ,2023-02-16,2023-03-17,575.0,11904,0,11904
669,TSLA  ,2023-02-16,2023-03-17,583.33,2653,0,2653
670,TSLA  ,2023-02-16,2023-03-17,591.67,1098,0,1098
671,TSLA  ,2023-02-16,2023-03-17,600.0,5588,0,5588
672,TSLA  ,2023-02-16,2023-03-17,608.33,540,0,540
673,TSLA  ,2023-02-16,2023-03-17,616.67,3997,0,3997
674,TSLA  ,2023-02-16,2023-03-17,625.0,1021,0,1021
675,TSLA  ,2023-02-16,2023-03-17,633.33,2365,0,2365
676,TSLA  ,2023-02-16,2023-03-17,641.67,1513,0,1513
677,TSLA  ,2023-02-16,2023-03-17,650.0,8462,0,8462
678,TSLA  ,2023-02-16,2023-03-17,666.67,70245,0,70245
679,TSLA  ,2023-02-16,2023-03-17,675.0,21633,0,21633
680,TSLA  ,2023-02-16,2023-03-17,683.33,3830,0,3830
681,TSLA  ,2023-02-16,2023-03-17,691.67,1388,0,1388
682,TSLA  ,2023-02-16,2023-03-17,700.0,4710,0,4710
683,TSLA  ,2023-02-16,2023-03-17,708.33,587,0,587
684,TSLA  ,2023-02-16,2023-03-17,716.67,783,0,783
685,TSLA  ,2023-02-16,2023-03-17,725.0,1042,0,1042
686,TSLA  ,2023-02-16,2023-03-17,733.33,1614,0,1614
687,TSLA  ,2023-02-16,2023-03-17,741.67,755,0,755
688,TSLA  ,2023-02-16,2023-03-17,750.0,754,0,754
689,TSLA  ,2023-02-16,2023-03-17,758.33,1235,0,1235
690,TSLA  ,2023-02-16,2023-03-17,766.67,1260,0,1260
691,TSLA  ,2023-02-16,2023-03-17,775.0,849,0,849
692,TSLA  ,2023-02-16,2023-03-17,783.33,1306,0,1306
693,TSLA  ,2023-02-16,2023-03-17,791.67,1447,0,1447
694,TSLA  ,2023-02-16,2023-03-17,800.0,5379,0,5379
695,TSLA  ,2023-02-16,2023-03-17,808.33,1842,0,1842
696,TSLA  ,2023-02-16,2023-03-17,816.67,2608,0,2608
697,TSLA  ,2023-02-16,2023-03-17,825.0,60223,0,60223
698,TSLA  ,2023-02-16,2023-03-24,20.0,6,122,128
699,TSLA  ,2023-02-16,2023-03-24,25.0,0,0,0
700,TSLA  ,2023-02-16,2023-03-24,30.0,0,0,0
701,TSLA  ,2023-02-16,2023-03-24,35.0,0,0,0
702,TSLA  ,2023-02-16,2023-03-24,40.0,0,0,0
703,TSLA  ,2023-02-16,2023-03-24,45.0,0,1,1
704,TSLA  ,2023-02-16,2023-03-24,50.0,21,1543,1564
705,TSLA  ,2023-02-16,2023-03-24,55.0,3,0,3
706,TSLA  ,2023-02-16,2023-03-24,60.0,0,13,13
707,TSLA  ,2023-02-16,2023-03-24,65.0,0,1,1
708,TSLA  ,2023-02-16,2023-03-24,70.0,0,20,20
709,TSLA  ,2023-02-16,2023-03-24,75.0,0,45,45
710,TSLA  ,2023-02-16,2023-03-24,80.0,0,62,62
711,TSLA  ,2023-02-16,2023-03-24,85.0,1,26,27
712,TSLA  ,2023-02-16,2023-03-24,90.0,0,34,34
713,TSLA  ,2023-02-16,2023-03-24,95.0,0,71,71
714,TSLA  ,2023-02-16,2023-03-24,100.0,12,313,325
715,TSLA  ,2023-02-16,2023-03-24,105.0,10,94,104
716,TSLA  ,2023-02-16,2023-03-24,110.0,6,93,99
717,TSLA  ,2023-02-16,2023-03-24,115.0,2,57,59
718,TSLA  ,2023-02-16,2023-03-24,120.0,2,206,208
719,TSLA  ,2023-02-16,2023-03-24,125.0,5,264,269
720,TSLA  ,2023-02-16,2023-03-24,130.0,145,341,486
721,TSLA  ,2023-02-16,2023-03-24,135.0,16,430,446
722,TSLA  ,2023-02-16,2023-03-24,140.0,26,474,500
723,TSLA  ,2023-02-16,2023-03-24,145.0,57,262,319
724,TSLA  ,2023-02-16,2023-03-24,146.0,7,58,65
725,TSLA  ,2023-02-16,2023-03-24,147.0,87,29,116
726,TSLA  ,2023-02-16,2023-03-24,148.0,76,92,168
727,TSLA  ,2023-02-16,2023-03-24,149.0,59,84,143
728,TSLA  ,2023-02-16,2023-03-24,150.0,73,763,836
729,TSLA  ,2023-02-16,2023-03-24,152.5,16,139,155
730,TSLA  ,2023-02-16,2023-03-24,155.0,473,646,1119
731,TSLA  ,2023-02-16,2023-03-24,157.5,51,436,487
732,TSLA  ,2023-02-16,2023-03-24,160.0,88,504,592
733,TSLA  ,2023-02-16,2023-03-24,162.5,43,118,161
734,TSLA  ,2023-02-16,2023-03-24,165.0,64,572,636
735,TSLA  ,2023-02-16,2023-03-24,167.5,16,542,558
736,TSLA  ,2023-02-16,2023-03-24,170.0,175,892,1067
737,TSLA  ,2023-02-16,2023-03-24,172.5,39,256,295
738,TSLA  ,2023-02-16,2023-03-24,175.0,144,513,657
739,TSLA  ,2023-02-16,2023-03-24,177.5,34,460,494
740,TSLA  ,2023-02-16,2023-03-24,180.0,192,1140,1332
741,TSLA  ,2023-02-16,2023-03-24,182.5,8,144,152
742,TSLA  ,2023-02-16,2023-03-24,185.0,101,315,416
743,TSLA  ,2023-02-16,2023-03-24,187.5,129,71,200
744,TSLA  ,2023-02-16,2023-03-24,190.0,417,715,1132
745,TSLA  ,2023-02-16,2023-03-24,192.5,94,192,286
746,TSLA  ,2023-02-16,2023-03-24,195.0,513,260,773
747,TSLA  ,2023-02-16,2023-03-24,197.5,1139,124,1263
748,TSLA  ,2023-02-16,2023-03-24,200.0,2520,1691,4211
749,TSLA  ,2023-02-16,2023-03-24,202.5,651,107,758
750,TSLA  ,2023-02-16,2023-03-24,205.0,1311,141,1452
751,TSLA  ,2023-02-16,2023-03-24,207.5,231,109,340
752,TSLA  ,2023-02-16,2023-03-24,210.0,2418,253,2671
753,TSLA  ,2023-02-16,2023-03-24,212.5,268,96,364
754,TSLA  ,2023-02-16,2023-03-24,215.0,973,459,1432
755,TSLA  ,2023-02-16,2023-03-24,217.5,210,68,278
756,TSLA  ,2023-02-16,2023-03-24,220.0,2733,588,3321
757,TSLA  ,2023-02-16,2023-03-24,222.5,272,31,303
758,TSLA  ,2023-02-16,2023-03-24,225.0,424,111,535
759,TSLA  ,2023-02-16,2023-03-24,230.0,708,197,905
760,TSLA  ,2023-02-16,2023-03-24,235.0,568,64,632
761,TSLA  ,2023-02-16,2023-03-24,240.0,197,136,333
762,TSLA  ,2023-02-16,2023-03-24,245.0,574,21,595
763,TSLA  ,2023-02-16,2023-03-24,250.0,1210,38,1248
764,TSLA  ,2023-02-16,2023-03-24,255.0,292,21,313
765,TSLA  ,2023-02-16,2023-03-24,260.0,751,5,756
766,TSLA  ,2023-02-16,2023-03-24,265.0,275,1,276
767,TSLA  ,2023-02-16,2023-03-24,270.0,1593,2,1595
768,TSLA  ,2023-02-16,2023-03-24,275.0,229,3,232
769,TSLA  ,2023-02-16,2023-03-24,280.0,326,0,326
770,TSLA  ,2023-02-16,2023-03-24,285.0,303,0,303
771,TSLA  ,2023-02-16,2023-03-24,290.0,236,0,236
772,TSLA  ,2023-02-16,2023-03-24,295.0,90,0,90
773,TSLA  ,2023-02-16,2023-03-24,300.0,719,1,720
774,TSLA  ,2023-02-16,2023-03-24,310.0,238,0,238
775,TSLA  ,2023-02-16,2023-03-24,320.0,318,1,319
776,TSLA  ,2023-02-16,2023-03-24,330.0,130,0,130
777,TSLA  ,2023-02-16,2023-03-24,340.0,347,0,347
778,TSLA  ,2023-02-16,2023-03-24,350.0,170,0,170
779,TSLA  ,2023-02-16,2023-03-24,360.0,622,0,622
780,TSLA  ,2023-02-16,2023-03-31,25.0,0,0,0
781,TSLA  ,2023-02-16,2023-03-31,30.0,0,0,0
782,TSLA  ,2023-02-16,2023-03-31,35.0,0,0,0
783,TSLA  ,2023-02-16,2023-03-31,40.0,0,0,0
784,TSLA  ,2023-02-16,2023-03-31,45.0,0,2,2
785,TSLA  ,2023-02-16,2023-03-31,50.0,0,2,2
786,TSLA  ,2023-02-16,2023-03-31,55.0,0,0,0
787,TSLA  ,2023-02-16,2023-03-31,60.0,0,12,12
788,TSLA  ,2023-02-16,2023-03-31,65.0,0,1,1
789,TSLA  ,2023-02-16,2023-03-31,70.0,0,12,12
790,TSLA  ,2023-02-16,2023-03-31,75.0,0,58,58
791,TSLA  ,2023-02-16,2023-03-31,80.0,4,15,19
792,TSLA  ,2023-02-16,2023-03-31,85.0,0,2,2
793,TSLA  ,2023-02-16,2023-03-31,90.0,0,23,23
794,TSLA  ,2023-02-16,2023-03-31,95.0,0,124,124
795,TSLA  ,2023-02-16,2023-03-31,100.0,3,69,72
796,TSLA  ,2023-02-16,2023-03-31,105.0,0,162,162
797,TSLA  ,2023-02-16,2023-03-31,110.0,0,62,62
798,TSLA  ,2023-02-16,2023-03-31,115.0,11,123,134
799,TSLA  ,2023-02-16,2023-03-31,120.0,2,157,159
800,TSLA  ,2023-02-16,2023-03-31,125.0,41,38,79
801,TSLA  ,2023-02-16,2023-03-31,130.0,11,127,138
802,TSLA  ,2023-02-16,2023-03-31,135.0,6,218,224
803,TSLA  ,2023-02-16,2023-03-31,140.0,13,183,196
804,TSLA  ,2023-02-16,2023-03-31,145.0,17,267,284
805,TSLA  ,2023-02-16,2023-03-31,150.0,116,510,626
806,TSLA  ,2023-02-16,2023-03-31,155.0,306,114,420
807,TSLA  ,2023-02-16,2023-03-31,160.0,33,180,213
808,TSLA  ,2023-02-16,2023-03-31,165.0,42,266,308
809,TSLA  ,2023-02-16,2023-03-31,170.0,10,706,716
810,TSLA  ,2023-02-16,2023-03-31,172.5,6,133,139
811,TSLA  ,2023-02-16,2023-03-31,175.0,36,399,435
812,TSLA  ,2023-02-16,2023-03-31,177.5,3,62,65
813,TSLA  ,2023-02-16,2023-03-31,180.0,247,510,757
814,TSLA  ,2023-02-16,2023-03-31,182.5,10,54,64
815,TSLA  ,2023-02-16,2023-03-31,185.0,34,111,145
816,TSLA  ,2023-02-16,2023-03-31,187.5,28,48,76
817,TSLA  ,2023-02-16,2023-03-31,190.0,55,166,221
818,TSLA  ,2023-02-16,2023-03-31,192.5,27,55,82
819,TSLA  ,2023-02-16,2023-03-31,195.0,80,124,204
820,TSLA  ,2023-02-16,2023-03-31,197.5,118,64,182
821,TSLA  ,2023-02-16,2023-03-31,200.0,254,292,546
822,TSLA  ,2023-02-16,2023-03-31,202.5,71,79,150
823,TSLA  ,2023-02-16,2023-03-31,205.0,296,285,581
824,TSLA  ,2023-02-16,2023-03-31,207.5,158,114,272
825,TSLA  ,2023-02-16,2023-03-31,210.0,715,131,846
826,TSLA  ,2023-02-16,2023-03-31,212.5,257,69,326
827,TSLA  ,2023-02-16,2023-03-31,215.0,321,64,385
828,TSLA  ,2023-02-16,2023-03-31,217.5,103,2,105
829,TSLA  ,2023-02-16,2023-03-31,220.0,607,16,623
830,TSLA  ,2023-02-16,2023-03-31,222.5,71,6,77
831,TSLA  ,2023-02-16,2023-03-31,225.0,176,2,178
832,TSLA  ,2023-02-16,2023-03-31,230.0,458,22,480
833,TSLA  ,2023-02-16,2023-03-31,235.0,292,22,314
834,TSLA  ,2023-02-16,2023-03-31,240.0,391,6,397
835,TSLA  ,2023-02-16,2023-03-31,245.0,298,2,300
836,TSLA  ,2023-02-16,2023-03-31,250.0,622,2,624
837,TSLA  ,2023-02-16,2023-03-31,255.0,293,2,295
838,TSLA  ,2023-02-16,2023-03-31,260.0,333,22,355
839,TSLA  ,2023-02-16,2023-03-31,265.0,138,0,138
840,TSLA  ,2023-02-16,2023-03-31,270.0,267,11,278
841,TSLA  ,2023-02-16,2023-03-31,275.0,308,1,309
842,TSLA  ,2023-02-16,2023-03-31,280.0,495,2,497
843,TSLA  ,2023-02-16,2023-03-31,285.0,177,0,177
844,TSLA  ,2023-02-16,2023-03-31,290.0,99,28,127
845,TSLA  ,2023-02-16,2023-03-31,295.0,99,28,127
846,TSLA  ,2023-02-16,2023-03-31,300.0,370,0,370
847,TSLA  ,2023-02-16,2023-03-31,310.0,187,1,188
848,TSLA  ,2023-02-16,2023-03-31,320.0,23,3,26
849,TSLA  ,2023-02-16,2023-03-31,330.0,108,0,108
850,TSLA  ,2023-02-16,2023-03-31,340.0,46,0,46
851,TSLA  ,2023-02-16,2023-03-31,350.0,44,1,45
852,TSLA  ,2023-02-16,2023-03-31,360.0,127,3,130
853,TSLA  ,2023-02-16,2023-04-21,5.0,14,101,115
854,TSLA  ,2023-02-16,2023-04-21,10.0,0,8,8
855,TSLA  ,2023-02-16,2023-04-21,15.0,0,41,41
856,TSLA  ,2023-02-16,2023-04-21,20.0,4,320,324
857,TSLA  ,2023-02-16,2023-04-21,25.0,8,2491,2499
858,TSLA  ,2023-02-16,2023-04-21,30.0,0,3037,3037
859,TSLA  ,2023-02-16,2023-04-21,35.0,5,445,450
860,TSLA  ,2023-02-16,2023-04-21,40.0,6,526,532
861,TSLA  ,2023-02-16,2023-04-21,45.0,2,796,798
862,TSLA  ,2023-02-16,2023-04-21,50.0,127,5100,5227
863,TSLA  ,2023-02-16,2023-04-21,55.0,15,2770,2785
864,TSLA  ,2023-02-16,2023-04-21,60.0,18,1973,1991
865,TSLA  ,2023-02-16,2023-04-21,65.0,65,5217,5282
866,TSLA  ,2023-02-16,2023-04-21,70.0,65,4460,4525
867,TSLA  ,2023-02-16,2023-04-21,75.0,123,13208,13331
868,TSLA  ,2023-02-16,2023-04-21,80.0,25226,4552,29778
869,TSLA  ,2023-02-16,2023-04-21,85.0,89,3305,3394
870,TSLA  ,2023-02-16,2023-04-21,90.0,271,2199,2470
871,TSLA  ,2023-02-16,2023-04-21,95.0,152,6122,6274
872,TSLA  ,2023-02-16,2023-04-21,100.0,1560,25447,27007
873,TSLA  ,2023-02-16,2023-04-21,105.0,358,2773,3131
874,TSLA  ,2023-02-16,2023-04-21,108.33,899,4782,5681
875,TSLA  ,2023-02-16,2023-04-21,110.0,1079,7416,8495
876,TSLA  ,2023-02-16,2023-04-21,115.0,1424,3295,4719
877,TSLA  ,2023-02-16,2023-04-21,116.67,2539,9381,11920
878,TSLA  ,2023-02-16,2023-04-21,120.0,7420,10411,17831
879,TSLA  ,2023-02-16,2023-04-21,125.0,11080,12268,23348
880,TSLA  ,2023-02-16,2023-04-21,130.0,1816,7476,9292
881,TSLA  ,2023-02-16,2023-04-21,133.33,4581,3695,8276
882,TSLA  ,2023-02-16,2023-04-21,135.0,1853,2381,4234
883,TSLA  ,2023-02-16,2023-04-21,140.0,2970,7220,10190
884,TSLA  ,2023-02-16,2023-04-21,141.67,6311,3535,9846
885,TSLA  ,2023-02-16,2023-04-21,145.0,1930,2523,4453
886,TSLA  ,2023-02-16,2023-04-21,150.0,7658,17614,25272
887,TSLA  ,2023-02-16,2023-04-21,155.0,1403,1819,3222
888,TSLA  ,2023-02-16,2023-04-21,158.33,2999,4085,7084
889,TSLA  ,2023-02-16,2023-04-21,160.0,2723,4817,7540
890,TSLA  ,2023-02-16,2023-04-21,165.0,1556,1562,3118
891,TSLA  ,2023-02-16,2023-04-21,166.67,2668,5400,8068
892,TSLA  ,2023-02-16,2023-04-21,170.0,1891,3259,5150
893,TSLA  ,2023-02-16,2023-04-21,175.0,10738,7995,18733
894,TSLA  ,2023-02-16,2023-04-21,180.0,2930,5143,8073
895,TSLA  ,2023-02-16,2023-04-21,183.33,2706,3984,6690
896,TSLA  ,2023-02-16,2023-04-21,185.0,2147,3723,5870
897,TSLA  ,2023-02-16,2023-04-21,190.0,2389,7511,9900
898,TSLA  ,2023-02-16,2023-04-21,191.67,3132,13902,17034
899,TSLA  ,2023-02-16,2023-04-21,195.0,3161,2592,5753
900,TSLA  ,2023-02-16,2023-04-21,200.0,13241,9373,22614
901,TSLA  ,2023-02-16,2023-04-21,205.0,3790,2482,6272
902,TSLA  ,2023-02-16,2023-04-21,208.33,6009,2874,8883
903,TSLA  ,2023-02-16,2023-04-21,210.0,5492,2770,8262
904,TSLA  ,2023-02-16,2023-04-21,215.0,2713,1360,4073
905,TSLA  ,2023-02-16,2023-04-21,216.67,1764,2776,4540
906,TSLA  ,2023-02-16,2023-04-21,220.0,7084,964,8048
907,TSLA  ,2023-02-16,2023-04-21,225.0,8747,2109,10856
908,TSLA  ,2023-02-16,2023-04-21,230.0,1968,572,2540
909,TSLA  ,2023-02-16,2023-04-21,233.33,1759,769,2528
910,TSLA  ,2023-02-16,2023-04-21,235.0,1170,287,1457
911,TSLA  ,2023-02-16,2023-04-21,240.0,13610,549,14159
912,TSLA  ,2023-02-16,2023-04-21,241.67,1145,86,1231
913,TSLA  ,2023-02-16,2023-04-21,243.33,1280,49,1329
914,TSLA  ,2023-02-16,2023-04-21,245.0,1395,176,1571
915,TSLA  ,2023-02-16,2023-04-21,246.67,1372,77,1449
916,TSLA  ,2023-02-16,2023-04-21,248.33,950,330,1280
917,TSLA  ,2023-02-16,2023-04-21,250.0,9242,811,10053
918,TSLA  ,2023-02-16,2023-04-21,251.67,1655,82,1737
919,TSLA  ,2023-02-16,2023-04-21,253.33,426,39,465
920,TSLA  ,2023-02-16,2023-04-21,255.0,1471,36,1507
921,TSLA  ,2023-02-16,2023-04-21,258.33,1144,894,2038
922,TSLA  ,2023-02-16,2023-04-21,260.0,2167,6,2173
923,TSLA  ,2023-02-16,2023-04-21,265.0,518,1,519
924,TSLA  ,2023-02-16,2023-04-21,266.67,1561,197,1758
925,TSLA  ,2023-02-16,2023-04-21,270.0,946,2,948
926,TSLA  ,2023-02-16,2023-04-21,275.0,2176,91,2267
927,TSLA  ,2023-02-16,2023-04-21,280.0,2162,206,2368
928,TSLA  ,2023-02-16,2023-04-21,283.33,1302,214,1516
929,TSLA  ,2023-02-16,2023-04-21,285.0,256,15,271
930,TSLA  ,2023-02-16,2023-04-21,290.0,384,0,384
931,TSLA  ,2023-02-16,2023-04-21,291.67,3070,30,3100
932,TSLA  ,2023-02-16,2023-04-21,295.0,93,0,93
933,TSLA  ,2023-02-16,2023-04-21,300.0,9435,37,9472
934,TSLA  ,2023-02-16,2023-04-21,305.0,162,0,162
935,TSLA  ,2023-02-16,2023-04-21,308.33,4160,26,4186
936,TSLA  ,2023-02-16,2023-04-21,310.0,788,0,788
937,TSLA  ,2023-02-16,2023-04-21,316.67,22098,2,22100
938,TSLA  ,2023-02-16,2023-04-21,325.0,2682,11,2693
939,TSLA  ,2023-02-16,2023-04-21,333.33,4511,0,4511
940,TSLA  ,2023-02-16,2023-04-21,341.67,802,8,810
941,TSLA  ,2023-02-16,2023-04-21,350.0,3341,0,3341
942,TSLA  ,2023-02-16,2023-04-21,358.33,952,0,952
943,TSLA  ,2023-02-16,2023-04-21,366.67,1185,4,1189
944,TSLA  ,2023-02-16,2023-04-21,375.0,1534,16,1550
945,TSLA  ,2023-02-16,2023-04-21,383.33,673,0,673
946,TSLA  ,2023-02-16,2023-04-21,391.67,404,0,404
947,TSLA  ,2023-02-16,2023-04-21,400.0,3013,0,3013
948,TSLA  ,2023-02-16,2023-04-21,408.33,416,0,416
949,TSLA  ,2023-02-16,2023-04-21,416.67,1124,0,1124
950,TSLA  ,2023-02-16,2023-04-21,425.0,4928,0,4928
951,TSLA  ,2023-02-16,2023-04-21,433.33,12433,0,12433
952,TSLA  ,2023-02-16,2023-04-21,441.67,788,0,788
953,TSLA  ,2023-02-16,2023-04-21,450.0,1326,1,1327
954,TSLA  ,2023-02-16,2023-04-21,458.33,3217,0,3217
955,TSLA  ,2023-02-16,2023-04-21,466.67,433,0,433
956,TSLA  ,2023-02-16,2023-04-21,475.0,932,0,932
957,TSLA  ,2023-02-16,2023-04-21,483.33,822,0,822
958,TSLA  ,2023-02-16,2023-04-21,491.67,186,0,186
959,TSLA  ,2023-02-16,2023-04-21,500.0,3517,0,3517
960,TSLA  ,2023-02-16,2023-04-21,508.33,902,0,902
961,TSLA  ,2023-02-16,2023-04-21,516.67,503,0,503
962,TSLA  ,2023-02-16,2023-04-21,525.0,486,0,486
963,TSLA  ,2023-02-16,2023-04-21,533.33,495,0,495
964,TSLA  ,2023-02-16,2023-04-21,541.67,554,0,554
965,TSLA  ,2023-02-16,2023-04-21,550.0,11217,0,11217
966,TSLA  ,2023-02-16,2023-04-21,558.33,345,0,345
967,TSLA  ,2023-02-16,2023-04-21,566.67,611,0,611
968,TSLA  ,2023-02-16,2023-04-21,575.0,1596,0,1596
969,TSLA  ,2023-02-16,2023-04-21,583.33,1024,0,1024
970,TSLA  ,2023-02-16,2023-04-21,600.0,20965,0,20965
971,TSLA  ,2023-02-16,2023-05-19,50.0,62,2812,2874
972,TSLA  ,2023-02-16,2023-05-19,55.0,51,601,652
973,TSLA  ,2023-02-16,2023-05-19,60.0,159,944,1103
974,TSLA  ,2023-02-16,2023-05-19,65.0,64,462,526
975,TSLA  ,2023-02-16,2023-05-19,70.0,178,1450,1628
976,TSLA  ,2023-02-16,2023-05-19,75.0,135,1650,1785
977,TSLA  ,2023-02-16,2023-05-19,80.0,85,1574,1659
978,TSLA  ,2023-02-16,2023-05-19,85.0,63,1774,1837
979,TSLA  ,2023-02-16,2023-05-19,90.0,243,2770,3013
980,TSLA  ,2023-02-16,2023-05-19,95.0,134,1725,1859
981,TSLA  ,2023-02-16,2023-05-19,100.0,1085,19550,20635
982,TSLA  ,2023-02-16,2023-05-19,105.0,285,6126,6411
983,TSLA  ,2023-02-16,2023-05-19,110.0,1017,7217,8234
984,TSLA  ,2023-02-16,2023-05-19,115.0,1365,1943,3308
985,TSLA  ,2023-02-16,2023-05-19,120.0,2140,7947,10087
986,TSLA  ,2023-02-16,2023-05-19,125.0,3719,2624,6343
987,TSLA  ,2023-02-16,2023-05-19,130.0,2685,5013,7698
988,TSLA  ,2023-02-16,2023-05-19,135.0,2007,2122,4129
989,TSLA  ,2023-02-16,2023-05-19,140.0,1885,11562,13447
990,TSLA  ,2023-02-16,2023-05-19,145.0,2366,2033,4399
991,TSLA  ,2023-02-16,2023-05-19,150.0,3916,4865,8781
992,TSLA  ,2023-02-16,2023-05-19,155.0,1384,1589,2973
993,TSLA  ,2023-02-16,2023-05-19,160.0,3134,4745,7879
994,TSLA  ,2023-02-16,2023-05-19,165.0,1395,1523,2918
995,TSLA  ,2023-02-16,2023-05-19,170.0,2776,4855,7631
996,TSLA  ,2023-02-16,2023-05-19,175.0,2048,1874,3922
997,TSLA  ,2023-02-16,2023-05-19,180.0,7978,4039,12017
998,TSLA  ,2023-02-16,2023-05-19,185.0,1783,1507,3290
999,TSLA  ,2023-02-16,2023-05-19,190.0,2836,3320,6156
1000,TSLA  ,2023-02-16,2023-05-19,195.0,2908,2079,4987
1001,TSLA  ,2023-02-16,2023-05-19,200.0,7993,2537,10530
1002,TSLA  ,2023-02-16,2023-05-19,205.0,3578,3797,7375
1003,TSLA  ,2023-02-16,2023-05-19,210.0,10221,1809,12030
1004,TSLA  ,2023-02-16,2023-05-19,215.0,25923,1392,27315
1005,TSLA  ,2023-02-16,2023-05-19,220.0,7427,1269,8696
1006,TSLA  ,2023-02-16,2023-05-19,225.0,1557,843,2400
1007,TSLA  ,2023-02-16,2023-05-19,230.0,2474,427,2901
1008,TSLA  ,2023-02-16,2023-05-19,235.0,1175,160,1335
1009,TSLA  ,2023-02-16,2023-05-19,240.0,2451,102,2553
1010,TSLA  ,2023-02-16,2023-05-19,245.0,701,145,846
1011,TSLA  ,2023-02-16,2023-05-19,250.0,2966,54,3020
1012,TSLA  ,2023-02-16,2023-05-19,260.0,767,117,884
1013,TSLA  ,2023-02-16,2023-05-19,270.0,3242,130,3372
1014,TSLA  ,2023-02-16,2023-05-19,280.0,632,32,664
1015,TSLA  ,2023-02-16,2023-05-19,290.0,418,367,785
1016,TSLA  ,2023-02-16,2023-05-19,300.0,1447,543,1990
1017,TSLA  ,2023-02-16,2023-05-19,310.0,556,5252,5808
1018,TSLA  ,2023-02-16,2023-05-19,320.0,856,1169,2025
1019,TSLA  ,2023-02-16,2023-05-19,330.0,524,26,550
1020,TSLA  ,2023-02-16,2023-05-19,340.0,433,3,436
1021,TSLA  ,2023-02-16,2023-05-19,350.0,307,5,312
1022,TSLA  ,2023-02-16,2023-05-19,360.0,778,1,779
1023,TSLA  ,2023-02-16,2023-05-19,370.0,108,0,108
1024,TSLA  ,2023-02-16,2023-05-19,380.0,125,0,125
1025,TSLA  ,2023-02-16,2023-05-19,390.0,851,0,851
1026,TSLA  ,2023-02-16,2023-06-16,1.67,107,41937,42044
1027,TSLA  ,2023-02-16,2023-06-16,3.33,399,5010,5409
1028,TSLA  ,2023-02-16,2023-06-16,5.0,108,1684,1792
1029,TSLA  ,2023-02-16,2023-06-16,6.67,75,1309,1384
1030,TSLA  ,2023-02-16,2023-06-16,8.33,425,2371,2796
1031,TSLA  ,2023-02-16,2023-06-16,10.0,3233,3746,6979
1032,TSLA  ,2023-02-16,2023-06-16,11.67,155,8573,8728
1033,TSLA  ,2023-02-16,2023-06-16,13.33,1234,5645,6879
1034,TSLA  ,2023-02-16,2023-06-16,15.0,168,4103,4271
1035,TSLA  ,2023-02-16,2023-06-16,16.67,489,9827,10316
1036,TSLA  ,2023-02-16,2023-06-16,18.33,93,4965,5058
1037,TSLA  ,2023-02-16,2023-06-16,33.33,862,16785,17647
1038,TSLA  ,2023-02-16,2023-06-16,50.0,1110,17415,18525
1039,TSLA  ,2023-02-16,2023-06-16,55.0,31,7345,7376
1040,TSLA  ,2023-02-16,2023-06-16,60.0,15,2294,2309
1041,TSLA  ,2023-02-16,2023-06-16,65.0,4,625,629
1042,TSLA  ,2023-02-16,2023-06-16,66.67,1012,14262,15274
1043,TSLA  ,2023-02-16,2023-06-16,70.0,51,4059,4110
1044,TSLA  ,2023-02-16,2023-06-16,75.0,84,6629,6713
1045,TSLA  ,2023-02-16,2023-06-16,80.0,184,3827,4011
1046,TSLA  ,2023-02-16,2023-06-16,83.33,712,5050,5762
1047,TSLA  ,2023-02-16,2023-06-16,85.0,86,4264,4350
1048,TSLA  ,2023-02-16,2023-06-16,90.0,202,3745,3947
1049,TSLA  ,2023-02-16,2023-06-16,95.0,123,1585,1708
1050,TSLA  ,2023-02-16,2023-06-16,100.0,3481,28610,32091
1051,TSLA  ,2023-02-16,2023-06-16,105.0,362,5348,5710
1052,TSLA  ,2023-02-16,2023-06-16,110.0,1181,5641,6822
1053,TSLA  ,2023-02-16,2023-06-16,115.0,595,2739,3334
1054,TSLA  ,2023-02-16,2023-06-16,116.67,1786,5310,7096
1055,TSLA  ,2023-02-16,2023-06-16,120.0,3432,9871,13303
1056,TSLA  ,2023-02-16,2023-06-16,123.33,456,1141,1597
1057,TSLA  ,2023-02-16,2023-06-16,125.0,4155,7003,11158
1058,TSLA  ,2023-02-16,2023-06-16,126.67,916,1314,2230
1059,TSLA  ,2023-02-16,2023-06-16,130.0,3683,9409,13092
1060,TSLA  ,2023-02-16,2023-06-16,133.33,2531,8759,11290
1061,TSLA  ,2023-02-16,2023-06-16,135.0,2735,2697,5432
1062,TSLA  ,2023-02-16,2023-06-16,136.67,1081,2573,3654
1063,TSLA  ,2023-02-16,2023-06-16,140.0,7785,6555,14340
1064,TSLA  ,2023-02-16,2023-06-16,143.33,1231,3300,4531
1065,TSLA  ,2023-02-16,2023-06-16,145.0,2152,3558,5710
1066,TSLA  ,2023-02-16,2023-06-16,146.67,1585,1941,3526
1067,TSLA  ,2023-02-16,2023-06-16,150.0,12697,13584,26281
1068,TSLA  ,2023-02-16,2023-06-16,153.33,2433,3215,5648
1069,TSLA  ,2023-02-16,2023-06-16,155.0,1223,3079,4302
1070,TSLA  ,2023-02-16,2023-06-16,156.67,1639,745,2384
1071,TSLA  ,2023-02-16,2023-06-16,160.0,6562,7092,13654
1072,TSLA  ,2023-02-16,2023-06-16,163.33,972,1213,2185
1073,TSLA  ,2023-02-16,2023-06-16,165.0,1810,2930,4740
1074,TSLA  ,2023-02-16,2023-06-16,166.67,3640,12975,16615
1075,TSLA  ,2023-02-16,2023-06-16,170.0,2700,4329,7029
1076,TSLA  ,2023-02-16,2023-06-16,173.33,1453,6323,7776
1077,TSLA  ,2023-02-16,2023-06-16,175.0,2644,5556,8200
1078,TSLA  ,2023-02-16,2023-06-16,180.0,8317,8815,17132
1079,TSLA  ,2023-02-16,2023-06-16,183.33,9935,10318,20253
1080,TSLA  ,2023-02-16,2023-06-16,185.0,7969,7040,15009
1081,TSLA  ,2023-02-16,2023-06-16,186.67,962,1980,2942
1082,TSLA  ,2023-02-16,2023-06-16,190.0,5840,4761,10601
1083,TSLA  ,2023-02-16,2023-06-16,193.33,1863,7780,9643
1084,TSLA  ,2023-02-16,2023-06-16,195.0,2708,2736,5444
1085,TSLA  ,2023-02-16,2023-06-16,200.0,25881,24521,50402
1086,TSLA  ,2023-02-16,2023-06-16,205.0,2635,1172,3807
1087,TSLA  ,2023-02-16,2023-06-16,206.67,2414,3080,5494
1088,TSLA  ,2023-02-16,2023-06-16,210.0,4906,3410,8316
1089,TSLA  ,2023-02-16,2023-06-16,213.33,2098,2578,4676
1090,TSLA  ,2023-02-16,2023-06-16,215.0,3583,1267,4850
1091,TSLA  ,2023-02-16,2023-06-16,216.67,6570,6168,12738
1092,TSLA  ,2023-02-16,2023-06-16,220.0,8042,6979,15021
1093,TSLA  ,2023-02-16,2023-06-16,225.0,2443,1268,3711
1094,TSLA  ,2023-02-16,2023-06-16,226.67,2725,2105,4830
1095,TSLA  ,2023-02-16,2023-06-16,230.0,7139,3039,10178
1096,TSLA  ,2023-02-16,2023-06-16,233.33,11396,7632,19028
1097,TSLA  ,2023-02-16,2023-06-16,235.0,3617,775,4392
1098,TSLA  ,2023-02-16,2023-06-16,240.0,7856,2928,10784
1099,TSLA  ,2023-02-16,2023-06-16,243.33,1308,1697,3005
1100,TSLA  ,2023-02-16,2023-06-16,245.0,1848,75,1923
1101,TSLA  ,2023-02-16,2023-06-16,246.67,3048,94,3142
1102,TSLA  ,2023-02-16,2023-06-16,250.0,15621,3441,19062
1103,TSLA  ,2023-02-16,2023-06-16,253.33,1388,195,1583
1104,TSLA  ,2023-02-16,2023-06-16,255.0,1212,73,1285
1105,TSLA  ,2023-02-16,2023-06-16,260.0,5131,81,5212
1106,TSLA  ,2023-02-16,2023-06-16,265.0,2411,79,2490
1107,TSLA  ,2023-02-16,2023-06-16,266.67,7289,408,7697
1108,TSLA  ,2023-02-16,2023-06-16,270.0,1386,6,1392
1109,TSLA  ,2023-02-16,2023-06-16,273.33,1332,1051,2383
1110,TSLA  ,2023-02-16,2023-06-16,275.0,1840,6,1846
1111,TSLA  ,2023-02-16,2023-06-16,280.0,3751,66,3817
1112,TSLA  ,2023-02-16,2023-06-16,283.33,4641,51,4692
1113,TSLA  ,2023-02-16,2023-06-16,285.0,1020,2,1022
1114,TSLA  ,2023-02-16,2023-06-16,286.67,751,30,781
1115,TSLA  ,2023-02-16,2023-06-16,290.0,744,828,1572
1116,TSLA  ,2023-02-16,2023-06-16,293.33,1634,62,1696
1117,TSLA  ,2023-02-16,2023-06-16,295.0,292,258,550
1118,TSLA  ,2023-02-16,2023-06-16,300.0,19225,185,19410
1119,TSLA  ,2023-02-16,2023-06-16,305.0,929,5,934
1120,TSLA  ,2023-02-16,2023-06-16,306.67,1439,30,1469
1121,TSLA  ,2023-02-16,2023-06-16,310.0,1705,45,1750
1122,TSLA  ,2023-02-16,2023-06-16,313.33,537,33,570
1123,TSLA  ,2023-02-16,2023-06-16,315.0,342,82,424
1124,TSLA  ,2023-02-16,2023-06-16,316.67,7178,241,7419
1125,TSLA  ,2023-02-16,2023-06-16,320.0,2463,3,2466
1126,TSLA  ,2023-02-16,2023-06-16,326.67,9728,6,9734
1127,TSLA  ,2023-02-16,2023-06-16,330.0,1646,51,1697
1128,TSLA  ,2023-02-16,2023-06-16,333.33,33813,231,34044
1129,TSLA  ,2023-02-16,2023-06-16,340.0,1643,3,1646
1130,TSLA  ,2023-02-16,2023-06-16,346.67,1323,0,1323
1131,TSLA  ,2023-02-16,2023-06-16,350.0,8507,334,8841
1132,TSLA  ,2023-02-16,2023-06-16,353.33,999,0,999
1133,TSLA  ,2023-02-16,2023-06-16,360.0,1844,1,1845
1134,TSLA  ,2023-02-16,2023-06-16,366.67,10938,450,11388
1135,TSLA  ,2023-02-16,2023-06-16,370.0,947,0,947
1136,TSLA  ,2023-02-16,2023-06-16,383.33,10911,0,10911
1137,TSLA  ,2023-02-16,2023-06-16,400.0,18415,919,19334
1138,TSLA  ,2023-02-16,2023-06-16,416.67,3626,20,3646
1139,TSLA  ,2023-02-16,2023-06-16,433.33,9681,0,9681
1140,TSLA  ,2023-02-16,2023-06-16,450.0,8222,0,8222
1141,TSLA  ,2023-02-16,2023-06-16,466.67,20903,0,20903
1142,TSLA  ,2023-02-16,2023-06-16,483.33,8320,0,8320
1143,TSLA  ,2023-02-16,2023-06-16,500.0,21570,0,21570
1144,TSLA  ,2023-02-16,2023-06-16,516.67,2695,0,2695
1145,TSLA  ,2023-02-16,2023-06-16,533.33,4869,0,4869
1146,TSLA  ,2023-02-16,2023-06-16,550.0,6105,0,6105
1147,TSLA  ,2023-02-16,2023-06-16,558.33,1699,0,1699
1148,TSLA  ,2023-02-16,2023-06-16,566.67,1266,0,1266
1149,TSLA  ,2023-02-16,2023-06-16,575.0,691,0,691
1150,TSLA  ,2023-02-16,2023-06-16,583.33,1200,0,1200
1151,TSLA  ,2023-02-16,2023-06-16,591.67,391,0,391
1152,TSLA  ,2023-02-16,2023-06-16,600.0,6511,0,6511
1153,TSLA  ,2023-02-16,2023-06-16,608.33,1158,0,1158
1154,TSLA  ,2023-02-16,2023-06-16,616.67,603,0,603
1155,TSLA  ,2023-02-16,2023-06-16,625.0,2167,0,2167
1156,TSLA  ,2023-02-16,2023-06-16,633.33,5396,0,5396
1157,TSLA  ,2023-02-16,2023-06-16,641.67,446,0,446
1158,TSLA  ,2023-02-16,2023-06-16,650.0,591,0,591
1159,TSLA  ,2023-02-16,2023-06-16,666.67,18093,0,18093
1160,TSLA  ,2023-02-16,2023-06-16,675.0,921,0,921
1161,TSLA  ,2023-02-16,2023-06-16,683.33,605,0,605
1162,TSLA  ,2023-02-16,2023-06-16,691.67,897,0,897
1163,TSLA  ,2023-02-16,2023-06-16,700.0,2726,0,2726
1164,TSLA  ,2023-02-16,2023-06-16,708.33,547,0,547
1165,TSLA  ,2023-02-16,2023-06-16,716.67,696,0,696
1166,TSLA  ,2023-02-16,2023-06-16,725.0,1170,0,1170
1167,TSLA  ,2023-02-16,2023-06-16,733.33,2256,0,2256
1168,TSLA  ,2023-02-16,2023-06-16,741.67,767,0,767
1169,TSLA  ,2023-02-16,2023-06-16,750.0,11747,0,11747
1170,TSLA  ,2023-02-16,2023-06-16,758.33,1298,0,1298
1171,TSLA  ,2023-02-16,2023-06-16,766.67,1263,0,1263
1172,TSLA  ,2023-02-16,2023-06-16,775.0,1129,0,1129
1173,TSLA  ,2023-02-16,2023-06-16,783.33,2218,0,2218
1174,TSLA  ,2023-02-16,2023-06-16,791.67,1866,0,1866
1175,TSLA  ,2023-02-16,2023-06-16,800.0,10043,0,10043
1176,TSLA  ,2023-02-16,2023-06-16,808.33,1233,0,1233
1177,TSLA  ,2023-02-16,2023-06-16,816.67,1801,0,1801
1178,TSLA  ,2023-02-16,2023-06-16,825.0,43189,0,43189
1179,TSLA  ,2023-02-16,2023-07-21,5.0,32,721,753
1180,TSLA  ,2023-02-16,2023-07-21,10.0,5,906,911
1181,TSLA  ,2023-02-16,2023-07-21,15.0,4,383,387
1182,TSLA  ,2023-02-16,2023-07-21,20.0,12,1205,1217
1183,TSLA  ,2023-02-16,2023-07-21,25.0,25,1090,1115
1184,TSLA  ,2023-02-16,2023-07-21,30.0,111,1421,1532
1185,TSLA  ,2023-02-16,2023-07-21,35.0,42,839,881
1186,TSLA  ,2023-02-16,2023-07-21,40.0,21,1183,1204
1187,TSLA  ,2023-02-16,2023-07-21,45.0,38,630,668
1188,TSLA  ,2023-02-16,2023-07-21,50.0,70,5074,5144
1189,TSLA  ,2023-02-16,2023-07-21,55.0,86,1857,1943
1190,TSLA  ,2023-02-16,2023-07-21,60.0,94,3621,3715
1191,TSLA  ,2023-02-16,2023-07-21,65.0,89,400,489
1192,TSLA  ,2023-02-16,2023-07-21,70.0,25,2406,2431
1193,TSLA  ,2023-02-16,2023-07-21,75.0,63,4217,4280
1194,TSLA  ,2023-02-16,2023-07-21,80.0,79,3656,3735
1195,TSLA  ,2023-02-16,2023-07-21,85.0,54,1387,1441
1196,TSLA  ,2023-02-16,2023-07-21,90.0,121,3408,3529
1197,TSLA  ,2023-02-16,2023-07-21,95.0,68,1615,1683
1198,TSLA  ,2023-02-16,2023-07-21,100.0,325,5811,6136
1199,TSLA  ,2023-02-16,2023-07-21,105.0,374,2493,2867
1200,TSLA  ,2023-02-16,2023-07-21,110.0,1126,3038,4164
1201,TSLA  ,2023-02-16,2023-07-21,115.0,465,1019,1484
1202,TSLA  ,2023-02-16,2023-07-21,120.0,1250,4571,5821
1203,TSLA  ,2023-02-16,2023-07-21,125.0,1417,2196,3613
1204,TSLA  ,2023-02-16,2023-07-21,130.0,1499,1780,3279
1205,TSLA  ,2023-02-16,2023-07-21,135.0,1148,2815,3963
1206,TSLA  ,2023-02-16,2023-07-21,140.0,1465,3121,4586
1207,TSLA  ,2023-02-16,2023-07-21,145.0,1058,2365,3423
1208,TSLA  ,2023-02-16,2023-07-21,150.0,3182,3817,6999
1209,TSLA  ,2023-02-16,2023-07-21,155.0,1686,2875,4561
1210,TSLA  ,2023-02-16,2023-07-21,160.0,1773,1536,3309
1211,TSLA  ,2023-02-16,2023-07-21,165.0,668,1438,2106
1212,TSLA  ,2023-02-16,2023-07-21,170.0,1789,2203,3992
1213,TSLA  ,2023-02-16,2023-07-21,175.0,1634,1490,3124
1214,TSLA  ,2023-02-16,2023-07-21,180.0,2123,1929,4052
1215,TSLA  ,2023-02-16,2023-07-21,185.0,3947,13313,17260
1216,TSLA  ,2023-02-16,2023-07-21,190.0,2962,2299,5261
1217,TSLA  ,2023-02-16,2023-07-21,195.0,1965,1928,3893
1218,TSLA  ,2023-02-16,2023-07-21,200.0,8204,3539,11743
1219,TSLA  ,2023-02-16,2023-07-21,205.0,4783,2016,6799
1220,TSLA  ,2023-02-16,2023-07-21,210.0,4582,1710,6292
1221,TSLA  ,2023-02-16,2023-07-21,215.0,3532,1260,4792
1222,TSLA  ,2023-02-16,2023-07-21,220.0,2931,1794,4725
1223,TSLA  ,2023-02-16,2023-07-21,225.0,5139,2143,7282
1224,TSLA  ,2023-02-16,2023-07-21,230.0,2001,1305,3306
1225,TSLA  ,2023-02-16,2023-07-21,235.0,1508,674,2182
1226,TSLA  ,2023-02-16,2023-07-21,240.0,2509,1755,4264
1227,TSLA  ,2023-02-16,2023-07-21,245.0,2451,705,3156
1228,TSLA  ,2023-02-16,2023-07-21,250.0,24372,1574,25946
1229,TSLA  ,2023-02-16,2023-07-21,255.0,919,681,1600
1230,TSLA  ,2023-02-16,2023-07-21,260.0,1464,83,1547
1231,TSLA  ,2023-02-16,2023-07-21,265.0,637,9,646
1232,TSLA  ,2023-02-16,2023-07-21,270.0,762,126,888
1233,TSLA  ,2023-02-16,2023-07-21,275.0,408,82,490
1234,TSLA  ,2023-02-16,2023-07-21,280.0,1177,147,1324
1235,TSLA  ,2023-02-16,2023-07-21,285.0,1044,147,1191
1236,TSLA  ,2023-02-16,2023-07-21,290.0,439,35,474
1237,TSLA  ,2023-02-16,2023-07-21,295.0,340,11,351
1238,TSLA  ,2023-02-16,2023-07-21,300.0,2515,9,2524
1239,TSLA  ,2023-02-16,2023-07-21,305.0,234,6,240
1240,TSLA  ,2023-02-16,2023-07-21,310.0,1378,6,1384
1241,TSLA  ,2023-02-16,2023-07-21,315.0,401,1,402
1242,TSLA  ,2023-02-16,2023-07-21,320.0,581,0,581
1243,TSLA  ,2023-02-16,2023-07-21,325.0,682,2,684
1244,TSLA  ,2023-02-16,2023-07-21,330.0,421,25,446
1245,TSLA  ,2023-02-16,2023-07-21,335.0,170,7,177
1246,TSLA  ,2023-02-16,2023-07-21,340.0,441,16,457
1247,TSLA  ,2023-02-16,2023-07-21,345.0,213,0,213
1248,TSLA  ,2023-02-16,2023-07-21,350.0,781,1,782
1249,TSLA  ,2023-02-16,2023-07-21,355.0,276,1,277
1250,TSLA  ,2023-02-16,2023-07-21,360.0,554,3,557
1251,TSLA  ,2023-02-16,2023-07-21,365.0,876,0,876
1252,TSLA  ,2023-02-16,2023-07-21,370.0,1054,0,1054
1253,TSLA  ,2023-02-16,2023-07-21,375.0,3146,0,3146
1254,TSLA  ,2023-02-16,2023-07-21,380.0,186,0,186
1255,TSLA  ,2023-02-16,2023-07-21,390.0,636,0,636
1256,TSLA  ,2023-02-16,2023-09-15,1.67,861,20023,20884
1257,TSLA  ,2023-02-16,2023-09-15,3.33,1085,2849,3934
1258,TSLA  ,2023-02-16,2023-09-15,5.0,25,942,967
1259,TSLA  ,2023-02-16,2023-09-15,6.67,29,3367,3396
1260,TSLA  ,2023-02-16,2023-09-15,8.33,32,1178,1210
1261,TSLA  ,2023-02-16,2023-09-15,10.0,26,2496,2522
1262,TSLA  ,2023-02-16,2023-09-15,11.67,49,617,666
1263,TSLA  ,2023-02-16,2023-09-15,13.33,83,230,313
1264,TSLA  ,2023-02-16,2023-09-15,15.0,0,116,116
1265,TSLA  ,2023-02-16,2023-09-15,16.67,143,4198,4341
1266,TSLA  ,2023-02-16,2023-09-15,30.0,0,75,75
1267,TSLA  ,2023-02-16,2023-09-15,33.33,3118,11360,14478
1268,TSLA  ,2023-02-16,2023-09-15,35.0,5,35,40
1269,TSLA  ,2023-02-16,2023-09-15,40.0,9,272,281
1270,TSLA  ,2023-02-16,2023-09-15,45.0,9,49,58
1271,TSLA  ,2023-02-16,2023-09-15,50.0,418,7560,7978
1272,TSLA  ,2023-02-16,2023-09-15,55.0,23,2374,2397
1273,TSLA  ,2023-02-16,2023-09-15,60.0,30,4722,4752
1274,TSLA  ,2023-02-16,2023-09-15,65.0,4,2124,2128
1275,TSLA  ,2023-02-16,2023-09-15,66.67,434,5691,6125
1276,TSLA  ,2023-02-16,2023-09-15,70.0,86,613,699
1277,TSLA  ,2023-02-16,2023-09-15,75.0,26,636,662
1278,TSLA  ,2023-02-16,2023-09-15,80.0,260,847,1107
1279,TSLA  ,2023-02-16,2023-09-15,83.33,407,4464,4871
1280,TSLA  ,2023-02-16,2023-09-15,85.0,52,323,375
1281,TSLA  ,2023-02-16,2023-09-15,90.0,485,2678,3163
1282,TSLA  ,2023-02-16,2023-09-15,95.0,70,2427,2497
1283,TSLA  ,2023-02-16,2023-09-15,100.0,2491,11915,14406
1284,TSLA  ,2023-02-16,2023-09-15,105.0,88,2152,2240
1285,TSLA  ,2023-02-16,2023-09-15,108.33,397,2143,2540
1286,TSLA  ,2023-02-16,2023-09-15,110.0,1238,1506,2744
1287,TSLA  ,2023-02-16,2023-09-15,115.0,247,2801,3048
1288,TSLA  ,2023-02-16,2023-09-15,116.67,569,12229,12798
1289,TSLA  ,2023-02-16,2023-09-15,120.0,1166,2023,3189
1290,TSLA  ,2023-02-16,2023-09-15,123.33,543,1353,1896
1291,TSLA  ,2023-02-16,2023-09-15,125.0,1731,7743,9474
1292,TSLA  ,2023-02-16,2023-09-15,126.67,130,1071,1201
1293,TSLA  ,2023-02-16,2023-09-15,130.0,1389,4913,6302
1294,TSLA  ,2023-02-16,2023-09-15,133.33,213,2340,2553
1295,TSLA  ,2023-02-16,2023-09-15,135.0,206,1220,1426
1296,TSLA  ,2023-02-16,2023-09-15,136.67,285,954,1239
1297,TSLA  ,2023-02-16,2023-09-15,140.0,1762,2196,3958
1298,TSLA  ,2023-02-16,2023-09-15,141.67,763,1679,2442
1299,TSLA  ,2023-02-16,2023-09-15,143.33,283,1539,1822
1300,TSLA  ,2023-02-16,2023-09-15,145.0,364,2615,2979
1301,TSLA  ,2023-02-16,2023-09-15,146.67,1372,1084,2456
1302,TSLA  ,2023-02-16,2023-09-15,150.0,33779,8952,42731
1303,TSLA  ,2023-02-16,2023-09-15,153.33,30477,1844,32321
1304,TSLA  ,2023-02-16,2023-09-15,155.0,418,386,804
1305,TSLA  ,2023-02-16,2023-09-15,156.67,394,729,1123
1306,TSLA  ,2023-02-16,2023-09-15,158.33,314,556,870
1307,TSLA  ,2023-02-16,2023-09-15,160.0,3717,7111,10828
1308,TSLA  ,2023-02-16,2023-09-15,163.33,413,1505,1918
1309,TSLA  ,2023-02-16,2023-09-15,165.0,1248,854,2102
1310,TSLA  ,2023-02-16,2023-09-15,166.67,1395,3079,4474
1311,TSLA  ,2023-02-16,2023-09-15,170.0,656,721,1377
1312,TSLA  ,2023-02-16,2023-09-15,173.33,10314,2962,13276
1313,TSLA  ,2023-02-16,2023-09-15,175.0,10911,7844,18755
1314,TSLA  ,2023-02-16,2023-09-15,180.0,33697,6965,40662
1315,TSLA  ,2023-02-16,2023-09-15,183.33,32294,5244,37538
1316,TSLA  ,2023-02-16,2023-09-15,185.0,332,807,1139
1317,TSLA  ,2023-02-16,2023-09-15,186.67,515,3461,3976
1318,TSLA  ,2023-02-16,2023-09-15,190.0,705,3091,3796
1319,TSLA  ,2023-02-16,2023-09-15,191.67,489,1152,1641
1320,TSLA  ,2023-02-16,2023-09-15,193.33,876,2931,3807
1321,TSLA  ,2023-02-16,2023-09-15,195.0,430,784,1214
1322,TSLA  ,2023-02-16,2023-09-15,200.0,11753,17080,28833
1323,TSLA  ,2023-02-16,2023-09-15,205.0,454,399,853
1324,TSLA  ,2023-02-16,2023-09-15,206.67,1065,655,1720
1325,TSLA  ,2023-02-16,2023-09-15,208.33,538,1989,2527
1326,TSLA  ,2023-02-16,2023-09-15,210.0,2474,468,2942
1327,TSLA  ,2023-02-16,2023-09-15,213.33,855,1289,2144
1328,TSLA  ,2023-02-16,2023-09-15,215.0,899,221,1120
1329,TSLA  ,2023-02-16,2023-09-15,216.67,1915,4089,6004
1330,TSLA  ,2023-02-16,2023-09-15,220.0,8791,4169,12960
1331,TSLA  ,2023-02-16,2023-09-15,225.0,2747,3306,6053
1332,TSLA  ,2023-02-16,2023-09-15,226.67,2245,1500,3745
1333,TSLA  ,2023-02-16,2023-09-15,230.0,3471,887,4358
1334,TSLA  ,2023-02-16,2023-09-15,233.33,2791,3439,6230
1335,TSLA  ,2023-02-16,2023-09-15,235.0,776,753,1529
1336,TSLA  ,2023-02-16,2023-09-15,240.0,1390,2531,3921
1337,TSLA  ,2023-02-16,2023-09-15,241.67,1373,838,2211
1338,TSLA  ,2023-02-16,2023-09-15,245.0,171,270,441
1339,TSLA  ,2023-02-16,2023-09-15,246.67,505,760,1265
1340,TSLA  ,2023-02-16,2023-09-15,250.0,10754,5532,16286
1341,TSLA  ,2023-02-16,2023-09-15,253.33,793,587,1380
1342,TSLA  ,2023-02-16,2023-09-15,255.0,309,39,348
1343,TSLA  ,2023-02-16,2023-09-15,258.33,946,2408,3354
1344,TSLA  ,2023-02-16,2023-09-15,260.0,11890,1419,13309
1345,TSLA  ,2023-02-16,2023-09-15,265.0,301,150,451
1346,TSLA  ,2023-02-16,2023-09-15,266.67,2373,319,2692
1347,TSLA  ,2023-02-16,2023-09-15,270.0,402,162,564
1348,TSLA  ,2023-02-16,2023-09-15,273.33,684,354,1038
1349,TSLA  ,2023-02-16,2023-09-15,275.0,2833,3223,6056
1350,TSLA  ,2023-02-16,2023-09-15,280.0,2153,576,2729
1351,TSLA  ,2023-02-16,2023-09-15,283.33,1276,315,1591
1352,TSLA  ,2023-02-16,2023-09-15,286.67,605,97,702
1353,TSLA  ,2023-02-16,2023-09-15,290.0,1346,65,1411
1354,TSLA  ,2023-02-16,2023-09-15,291.67,988,376,1364
1355,TSLA  ,2023-02-16,2023-09-15,293.33,1350,402,1752
1356,TSLA  ,2023-02-16,2023-09-15,300.0,7687,967,8654
1357,TSLA  ,2023-02-16,2023-09-15,306.67,2721,327,3048
1358,TSLA  ,2023-02-16,2023-09-15,308.33,872,335,1207
1359,TSLA  ,2023-02-16,2023-09-15,310.0,108,0,108
1360,TSLA  ,2023-02-16,2023-09-15,313.33,798,287,1085
1361,TSLA  ,2023-02-16,2023-09-15,316.67,1603,162,1765
1362,TSLA  ,2023-02-16,2023-09-15,320.0,1793,169,1962
1363,TSLA  ,2023-02-16,2023-09-15,325.0,2774,75,2849
1364,TSLA  ,2023-02-16,2023-09-15,326.67,1076,5,1081
1365,TSLA  ,2023-02-16,2023-09-15,333.33,6443,83,6526
1366,TSLA  ,2023-02-16,2023-09-15,340.0,23327,147,23474
1367,TSLA  ,2023-02-16,2023-09-15,341.67,179,187,366
1368,TSLA  ,2023-02-16,2023-09-15,346.67,549,135,684
1369,TSLA  ,2023-02-16,2023-09-15,350.0,20580,328,20908
1370,TSLA  ,2023-02-16,2023-09-15,353.33,22648,149,22797
1371,TSLA  ,2023-02-16,2023-09-15,358.33,470,287,757
1372,TSLA  ,2023-02-16,2023-09-15,360.0,3237,305,3542
1373,TSLA  ,2023-02-16,2023-09-15,366.67,2818,561,3379
1374,TSLA  ,2023-02-16,2023-09-15,375.0,3274,160,3434
1375,TSLA  ,2023-02-16,2023-09-15,383.33,4643,17,4660
1376,TSLA  ,2023-02-16,2023-09-15,391.67,839,14,853
1377,TSLA  ,2023-02-16,2023-09-15,400.0,5711,69,5780
1378,TSLA  ,2023-02-16,2023-09-15,408.33,1575,1,1576
1379,TSLA  ,2023-02-16,2023-09-15,416.67,963,0,963
1380,TSLA  ,2023-02-16,2023-09-15,425.0,3228,0,3228
1381,TSLA  ,2023-02-16,2023-09-15,433.33,4937,8,4945
1382,TSLA  ,2023-02-16,2023-09-15,441.67,1036,0,1036
1383,TSLA  ,2023-02-16,2023-09-15,450.0,2457,0,2457
1384,TSLA  ,2023-02-16,2023-09-15,458.33,402,0,402
1385,TSLA  ,2023-02-16,2023-09-15,466.67,2697,0,2697
1386,TSLA  ,2023-02-16,2023-09-15,475.0,338,0,338
1387,TSLA  ,2023-02-16,2023-09-15,483.33,670,0,670
1388,TSLA  ,2023-02-16,2023-09-15,491.67,1097,0,1097
1389,TSLA  ,2023-02-16,2023-09-15,500.0,5636,0,5636
1390,TSLA  ,2023-02-16,2023-09-15,508.33,811,0,811
1391,TSLA  ,2023-02-16,2023-09-15,516.67,1277,0,1277
1392,TSLA  ,2023-02-16,2023-09-15,525.0,1190,0,1190
1393,TSLA  ,2023-02-16,2023-09-15,533.33,1593,0,1593
1394,TSLA  ,2023-02-16,2023-09-15,541.67,1161,0,1161
1395,TSLA  ,2023-02-16,2023-09-15,550.0,11720,0,11720
1396,TSLA  ,2023-02-16,2023-09-15,558.33,188,0,188
1397,TSLA  ,2023-02-16,2023-09-15,566.67,4041,0,4041
1398,TSLA  ,2023-02-16,2023-09-15,575.0,378,0,378
1399,TSLA  ,2023-02-16,2023-09-15,583.33,512,0,512
1400,TSLA  ,2023-02-16,2023-09-15,591.67,2112,0,2112
1401,TSLA  ,2023-02-16,2023-09-15,600.0,8628,0,8628
1402,TSLA  ,2023-02-16,2023-09-15,608.33,672,0,672
1403,TSLA  ,2023-02-16,2023-09-15,616.67,1021,0,1021
1404,TSLA  ,2023-02-16,2023-09-15,625.0,1067,0,1067
1405,TSLA  ,2023-02-16,2023-09-15,633.33,694,0,694
1406,TSLA  ,2023-02-16,2023-09-15,641.67,415,0,415
1407,TSLA  ,2023-02-16,2023-09-15,650.0,27469,0,27469
1408,TSLA  ,2023-02-16,2023-09-15,658.33,1207,0,1207
1409,TSLA  ,2023-02-16,2023-09-15,666.67,1353,0,1353
1410,TSLA  ,2023-02-16,2023-09-15,675.0,493,0,493
1411,TSLA  ,2023-02-16,2023-09-15,683.33,458,0,458
1412,TSLA  ,2023-02-16,2023-09-15,700.0,1517,0,1517
1413,TSLA  ,2023-02-16,2023-09-15,716.67,1062,0,1062
1414,TSLA  ,2023-02-16,2023-09-15,733.33,2322,0,2322
1415,TSLA  ,2023-02-16,2023-09-15,750.0,8187,0,8187
1416,TSLA  ,2023-02-16,2023-09-15,758.33,71859,0,71859
1417,TSLA  ,2023-02-16,2023-12-15,50.0,1372,13893,15265
1418,TSLA  ,2023-02-16,2023-12-15,55.0,63,1179,1242
1419,TSLA  ,2023-02-16,2023-12-15,60.0,40,1322,1362
1420,TSLA  ,2023-02-16,2023-12-15,65.0,4,380,384
1421,TSLA  ,2023-02-16,2023-12-15,70.0,27,3859,3886
1422,TSLA  ,2023-02-16,2023-12-15,75.0,19,4136,4155
1423,TSLA  ,2023-02-16,2023-12-15,80.0,156,817,973
1424,TSLA  ,2023-02-16,2023-12-15,85.0,2574,2379,4953
1425,TSLA  ,2023-02-16,2023-12-15,90.0,1648,6034,7682
1426,TSLA  ,2023-02-16,2023-12-15,95.0,831,498,1329
1427,TSLA  ,2023-02-16,2023-12-15,100.0,2326,6398,8724
1428,TSLA  ,2023-02-16,2023-12-15,105.0,321,2270,2591
1429,TSLA  ,2023-02-16,2023-12-15,110.0,680,2170,2850
1430,TSLA  ,2023-02-16,2023-12-15,115.0,1716,964,2680
1431,TSLA  ,2023-02-16,2023-12-15,120.0,1023,1331,2354
1432,TSLA  ,2023-02-16,2023-12-15,125.0,522,1471,1993
1433,TSLA  ,2023-02-16,2023-12-15,130.0,769,11061,11830
1434,TSLA  ,2023-02-16,2023-12-15,135.0,790,6064,6854
1435,TSLA  ,2023-02-16,2023-12-15,140.0,935,1832,2767
1436,TSLA  ,2023-02-16,2023-12-15,145.0,629,947,1576
1437,TSLA  ,2023-02-16,2023-12-15,150.0,1483,12386,13869
1438,TSLA  ,2023-02-16,2023-12-15,155.0,394,1031,1425
1439,TSLA  ,2023-02-16,2023-12-15,160.0,2832,10980,13812
1440,TSLA  ,2023-02-16,2023-12-15,165.0,1452,507,1959
1441,TSLA  ,2023-02-16,2023-12-15,170.0,746,4285,5031
1442,TSLA  ,2023-02-16,2023-12-15,175.0,2093,432,2525
1443,TSLA  ,2023-02-16,2023-12-15,180.0,1609,1208,2817
1444,TSLA  ,2023-02-16,2023-12-15,185.0,563,658,1221
1445,TSLA  ,2023-02-16,2023-12-15,190.0,1118,571,1689
1446,TSLA  ,2023-02-16,2023-12-15,195.0,761,970,1731
1447,TSLA  ,2023-02-16,2023-12-15,200.0,8381,1576,9957
1448,TSLA  ,2023-02-16,2023-12-15,205.0,6461,761,7222
1449,TSLA  ,2023-02-16,2023-12-15,210.0,2713,743,3456
1450,TSLA  ,2023-02-16,2023-12-15,215.0,1281,661,1942
1451,TSLA  ,2023-02-16,2023-12-15,220.0,1606,1169,2775
1452,TSLA  ,2023-02-16,2023-12-15,225.0,1895,297,2192
1453,TSLA  ,2023-02-16,2023-12-15,230.0,1726,717,2443
1454,TSLA  ,2023-02-16,2023-12-15,235.0,515,444,959
1455,TSLA  ,2023-02-16,2023-12-15,240.0,5773,713,6486
1456,TSLA  ,2023-02-16,2023-12-15,245.0,2362,513,2875
1457,TSLA  ,2023-02-16,2023-12-15,250.0,16329,3656,19985
1458,TSLA  ,2023-02-16,2023-12-15,260.0,10176,753,10929
1459,TSLA  ,2023-02-16,2023-12-15,270.0,3999,520,4519
1460,TSLA  ,2023-02-16,2023-12-15,280.0,1476,676,2152
1461,TSLA  ,2023-02-16,2023-12-15,290.0,578,492,1070
1462,TSLA  ,2023-02-16,2023-12-15,300.0,1717,1028,2745
1463,TSLA  ,2023-02-16,2023-12-15,310.0,774,621,1395
1464,TSLA  ,2023-02-16,2023-12-15,320.0,1178,537,1715
1465,TSLA  ,2023-02-16,2023-12-15,330.0,409,232,641
1466,TSLA  ,2023-02-16,2023-12-15,340.0,336,120,456
1467,TSLA  ,2023-02-16,2023-12-15,350.0,1120,183,1303
1468,TSLA  ,2023-02-16,2023-12-15,360.0,619,117,736
1469,TSLA  ,2023-02-16,2023-12-15,370.0,52,243,295
1470,TSLA  ,2023-02-16,2023-12-15,380.0,468,321,789
1471,TSLA  ,2023-02-16,2023-12-15,390.0,1492,146,1638
1472,TSLA  ,2023-02-16,2024-01-19,1.67,2498,29715,32213
1473,TSLA  ,2023-02-16,2024-01-19,3.33,967,6090,7057
1474,TSLA  ,2023-02-16,2024-01-19,5.0,256,10581,10837
1475,TSLA  ,2023-02-16,2024-01-19,6.67,76,3334,3410
1476,TSLA  ,2023-02-16,2024-01-19,8.33,3902,2860,6762
1477,TSLA  ,2023-02-16,2024-01-19,10.0,294,4655,4949
1478,TSLA  ,2023-02-16,2024-01-19,11.67,253,3225,3478
1479,TSLA  ,2023-02-16,2024-01-19,13.33,819,507,1326
1480,TSLA  ,2023-02-16,2024-01-19,15.0,279,2064,2343
1481,TSLA  ,2023-02-16,2024-01-19,16.67,486,4672,5158
1482,TSLA  ,2023-02-16,2024-01-19,18.33,393,6124,6517
1483,TSLA  ,2023-02-16,2024-01-19,20.0,258,7609,7867
1484,TSLA  ,2023-02-16,2024-01-19,21.67,118,805,923
1485,TSLA  ,2023-02-16,2024-01-19,23.33,382,3837,4219
1486,TSLA  ,2023-02-16,2024-01-19,25.0,369,3029,3398
1487,TSLA  ,2023-02-16,2024-01-19,26.67,833,1135,1968
1488,TSLA  ,2023-02-16,2024-01-19,28.33,341,747,1088
1489,TSLA  ,2023-02-16,2024-01-19,30.0,228,8875,9103
1490,TSLA  ,2023-02-16,2024-01-19,31.67,1326,1353,2679
1491,TSLA  ,2023-02-16,2024-01-19,33.33,4315,32824,37139
1492,TSLA  ,2023-02-16,2024-01-19,50.0,2165,30836,33001
1493,TSLA  ,2023-02-16,2024-01-19,55.0,80,1490,1570
1494,TSLA  ,2023-02-16,2024-01-19,60.0,249,2617,2866
1495,TSLA  ,2023-02-16,2024-01-19,65.0,266,766,1032
1496,TSLA  ,2023-02-16,2024-01-19,66.67,4703,14826,19529
1497,TSLA  ,2023-02-16,2024-01-19,70.0,143,800,943
1498,TSLA  ,2023-02-16,2024-01-19,75.0,92,1161,1253
1499,TSLA  ,2023-02-16,2024-01-19,80.0,405,1929,2334
1500,TSLA  ,2023-02-16,2024-01-19,83.33,1064,8092,9156
1501,TSLA  ,2023-02-16,2024-01-19,85.0,511,427,938
1502,TSLA  ,2023-02-16,2024-01-19,90.0,3548,1323,4871
1503,TSLA  ,2023-02-16,2024-01-19,95.0,2979,1493,4472
1504,TSLA  ,2023-02-16,2024-01-19,100.0,13968,40375,54343
1505,TSLA  ,2023-02-16,2024-01-19,105.0,1289,2094,3383
1506,TSLA  ,2023-02-16,2024-01-19,110.0,4802,7068,11870
1507,TSLA  ,2023-02-16,2024-01-19,115.0,4698,5563,10261
1508,TSLA  ,2023-02-16,2024-01-19,116.67,1930,8360,10290
1509,TSLA  ,2023-02-16,2024-01-19,120.0,3444,6170,9614
1510,TSLA  ,2023-02-16,2024-01-19,123.33,1962,2315,4277
1511,TSLA  ,2023-02-16,2024-01-19,125.0,2394,13256,15650
1512,TSLA  ,2023-02-16,2024-01-19,126.67,1744,6598,8342
1513,TSLA  ,2023-02-16,2024-01-19,130.0,5088,11766,16854
1514,TSLA  ,2023-02-16,2024-01-19,133.33,2431,11047,13478
1515,TSLA  ,2023-02-16,2024-01-19,135.0,1326,1292,2618
1516,TSLA  ,2023-02-16,2024-01-19,136.67,2432,2314,4746
1517,TSLA  ,2023-02-16,2024-01-19,140.0,5113,4313,9426
1518,TSLA  ,2023-02-16,2024-01-19,143.33,1673,2303,3976
1519,TSLA  ,2023-02-16,2024-01-19,145.0,782,848,1630
1520,TSLA  ,2023-02-16,2024-01-19,146.67,1043,978,2021
1521,TSLA  ,2023-02-16,2024-01-19,150.0,17787,22295,40082
1522,TSLA  ,2023-02-16,2024-01-19,153.33,10511,1067,11578
1523,TSLA  ,2023-02-16,2024-01-19,155.0,549,1428,1977
1524,TSLA  ,2023-02-16,2024-01-19,156.67,1726,844,2570
1525,TSLA  ,2023-02-16,2024-01-19,160.0,3309,12299,15608
1526,TSLA  ,2023-02-16,2024-01-19,163.33,476,7425,7901
1527,TSLA  ,2023-02-16,2024-01-19,165.0,694,555,1249
1528,TSLA  ,2023-02-16,2024-01-19,166.67,6757,6865,13622
1529,TSLA  ,2023-02-16,2024-01-19,170.0,2796,6303,9099
1530,TSLA  ,2023-02-16,2024-01-19,173.33,855,2569,3424
1531,TSLA  ,2023-02-16,2024-01-19,175.0,1729,3227,4956
1532,TSLA  ,2023-02-16,2024-01-19,176.67,1021,1275,2296
1533,TSLA  ,2023-02-16,2024-01-19,180.0,39023,11109,50132
1534,TSLA  ,2023-02-16,2024-01-19,183.33,34442,7429,41871
1535,TSLA  ,2023-02-16,2024-01-19,185.0,1344,756,2100
1536,TSLA  ,2023-02-16,2024-01-19,186.67,1266,2281,3547
1537,TSLA  ,2023-02-16,2024-01-19,190.0,1673,714,2387
1538,TSLA  ,2023-02-16,2024-01-19,193.33,2288,9828,12116
1539,TSLA  ,2023-02-16,2024-01-19,195.0,714,1737,2451
1540,TSLA  ,2023-02-16,2024-01-19,200.0,33704,23983,57687
1541,TSLA  ,2023-02-16,2024-01-19,203.33,6303,2369,8672
1542,TSLA  ,2023-02-16,2024-01-19,206.67,1661,1229,2890
1543,TSLA  ,2023-02-16,2024-01-19,210.0,11085,6661,17746
1544,TSLA  ,2023-02-16,2024-01-19,213.33,1591,2689,4280
1545,TSLA  ,2023-02-16,2024-01-19,216.67,8917,6722,15639
1546,TSLA  ,2023-02-16,2024-01-19,220.0,6852,7102,13954
1547,TSLA  ,2023-02-16,2024-01-19,223.33,6073,1629,7702
1548,TSLA  ,2023-02-16,2024-01-19,226.67,20004,3145,23149
1549,TSLA  ,2023-02-16,2024-01-19,230.0,15391,18673,34064
1550,TSLA  ,2023-02-16,2024-01-19,233.33,36959,13472,50431
1551,TSLA  ,2023-02-16,2024-01-19,236.67,2005,1690,3695
1552,TSLA  ,2023-02-16,2024-01-19,240.0,4502,3876,8378
1553,TSLA  ,2023-02-16,2024-01-19,243.33,1267,2021,3288
1554,TSLA  ,2023-02-16,2024-01-19,246.67,1178,2109,3287
1555,TSLA  ,2023-02-16,2024-01-19,250.0,22006,5327,27333
1556,TSLA  ,2023-02-16,2024-01-19,253.33,2852,2095,4947
1557,TSLA  ,2023-02-16,2024-01-19,256.67,2826,1640,4466
1558,TSLA  ,2023-02-16,2024-01-19,260.0,7514,3181,10695
1559,TSLA  ,2023-02-16,2024-01-19,263.33,7757,2146,9903
1560,TSLA  ,2023-02-16,2024-01-19,266.67,10257,8798,19055
1561,TSLA  ,2023-02-16,2024-01-19,270.0,4582,5253,9835
1562,TSLA  ,2023-02-16,2024-01-19,273.33,3391,3092,6483
1563,TSLA  ,2023-02-16,2024-01-19,276.67,1956,1763,3719
1564,TSLA  ,2023-02-16,2024-01-19,280.0,9250,6503,15753
1565,TSLA  ,2023-02-16,2024-01-19,283.33,3145,3089,6234
1566,TSLA  ,2023-02-16,2024-01-19,286.67,2474,1509,3983
1567,TSLA  ,2023-02-16,2024-01-19,290.0,9112,576,9688
1568,TSLA  ,2023-02-16,2024-01-19,293.33,2903,1990,4893
1569,TSLA  ,2023-02-16,2024-01-19,296.67,2176,1688,3864
1570,TSLA  ,2023-02-16,2024-01-19,300.0,26433,6123,32556
1571,TSLA  ,2023-02-16,2024-01-19,303.33,3444,290,3734
1572,TSLA  ,2023-02-16,2024-01-19,306.67,6579,133,6712
1573,TSLA  ,2023-02-16,2024-01-19,310.0,3709,1021,4730
1574,TSLA  ,2023-02-16,2024-01-19,313.33,1201,27,1228
1575,TSLA  ,2023-02-16,2024-01-19,316.67,4148,306,4454
1576,TSLA  ,2023-02-16,2024-01-19,320.0,6204,321,6525
1577,TSLA  ,2023-02-16,2024-01-19,323.33,454,268,722
1578,TSLA  ,2023-02-16,2024-01-19,325.0,10243,134,10377
1579,TSLA  ,2023-02-16,2024-01-19,326.67,1370,630,2000
1580,TSLA  ,2023-02-16,2024-01-19,330.0,7453,11,7464
1581,TSLA  ,2023-02-16,2024-01-19,333.33,30410,1952,32362
1582,TSLA  ,2023-02-16,2024-01-19,336.67,1469,7,1476
1583,TSLA  ,2023-02-16,2024-01-19,340.0,3793,5,3798
1584,TSLA  ,2023-02-16,2024-01-19,341.67,905,10,915
1585,TSLA  ,2023-02-16,2024-01-19,343.33,552,0,552
1586,TSLA  ,2023-02-16,2024-01-19,346.67,2398,3,2401
1587,TSLA  ,2023-02-16,2024-01-19,350.0,15635,758,16393
1588,TSLA  ,2023-02-16,2024-01-19,353.33,1162,0,1162
1589,TSLA  ,2023-02-16,2024-01-19,356.67,900,0,900
1590,TSLA  ,2023-02-16,2024-01-19,358.33,1241,3,1244
1591,TSLA  ,2023-02-16,2024-01-19,360.0,9201,600,9801
1592,TSLA  ,2023-02-16,2024-01-19,363.33,516,7,523
1593,TSLA  ,2023-02-16,2024-01-19,366.67,38791,2807,41598
1594,TSLA  ,2023-02-16,2024-01-19,370.0,5998,4,6002
1595,TSLA  ,2023-02-16,2024-01-19,373.33,1058,12,1070
1596,TSLA  ,2023-02-16,2024-01-19,375.0,11419,8,11427
1597,TSLA  ,2023-02-16,2024-01-19,376.67,573,106,679
1598,TSLA  ,2023-02-16,2024-01-19,380.0,1094,2,1096
1599,TSLA  ,2023-02-16,2024-01-19,383.33,3082,2,3084
1600,TSLA  ,2023-02-16,2024-01-19,386.67,409,203,612
1601,TSLA  ,2023-02-16,2024-01-19,390.0,920,1,921
1602,TSLA  ,2023-02-16,2024-01-19,391.67,2333,1,2334
1603,TSLA  ,2023-02-16,2024-01-19,393.33,519,4,523
1604,TSLA  ,2023-02-16,2024-01-19,396.67,2713,0,2713
1605,TSLA  ,2023-02-16,2024-01-19,400.0,40666,1002,41668
1606,TSLA  ,2023-02-16,2024-01-19,408.33,5170,21,5191
1607,TSLA  ,2023-02-16,2024-01-19,416.67,4033,2142,6175
1608,TSLA  ,2023-02-16,2024-01-19,425.0,4505,18,4523
1609,TSLA  ,2023-02-16,2024-01-19,433.33,5780,3,5783
1610,TSLA  ,2023-02-16,2024-01-19,441.67,1252,0,1252
1611,TSLA  ,2023-02-16,2024-01-19,450.0,8029,2427,10456
1612,TSLA  ,2023-02-16,2024-01-19,458.33,2003,0,2003
1613,TSLA  ,2023-02-16,2024-01-19,466.67,27786,0,27786
1614,TSLA  ,2023-02-16,2024-01-19,475.0,5172,195,5367
1615,TSLA  ,2023-02-16,2024-01-19,483.33,1583,20,1603
1616,TSLA  ,2023-02-16,2024-01-19,491.67,2142,0,2142
1617,TSLA  ,2023-02-16,2024-01-19,500.0,36292,170,36462
1618,TSLA  ,2023-02-16,2024-01-19,516.67,4805,215,5020
1619,TSLA  ,2023-02-16,2024-01-19,533.33,22307,0,22307
1620,TSLA  ,2023-02-16,2024-01-19,550.0,16432,0,16432
1621,TSLA  ,2023-02-16,2024-01-19,558.33,1183,0,1183
1622,TSLA  ,2023-02-16,2024-01-19,566.67,12905,0,12905
1623,TSLA  ,2023-02-16,2024-01-19,575.0,13857,0,13857
1624,TSLA  ,2023-02-16,2024-01-19,583.33,13821,0,13821
1625,TSLA  ,2023-02-16,2024-01-19,591.67,2277,0,2277
1626,TSLA  ,2023-02-16,2024-01-19,600.0,18568,0,18568
1627,TSLA  ,2023-02-16,2024-01-19,608.33,2279,0,2279
1628,TSLA  ,2023-02-16,2024-01-19,616.67,11852,0,11852
1629,TSLA  ,2023-02-16,2024-01-19,625.0,2414,0,2414
1630,TSLA  ,2023-02-16,2024-01-19,633.33,5738,0,5738
1631,TSLA  ,2023-02-16,2024-01-19,641.67,929,0,929
1632,TSLA  ,2023-02-16,2024-01-19,650.0,3197,0,3197
1633,TSLA  ,2023-02-16,2024-01-19,666.67,40723,0,40723
1634,TSLA  ,2023-02-16,2024-01-19,675.0,4357,0,4357
1635,TSLA  ,2023-02-16,2024-01-19,683.33,7133,0,7133
1636,TSLA  ,2023-02-16,2024-01-19,691.67,1564,0,1564
1637,TSLA  ,2023-02-16,2024-01-19,700.0,5376,0,5376
1638,TSLA  ,2023-02-16,2024-01-19,708.33,761,0,761
1639,TSLA  ,2023-02-16,2024-01-19,716.67,6074,0,6074
1640,TSLA  ,2023-02-16,2024-01-19,725.0,2693,3,2696
1641,TSLA  ,2023-02-16,2024-01-19,733.33,3399,0,3399
1642,TSLA  ,2023-02-16,2024-01-19,741.67,805,0,805
1643,TSLA  ,2023-02-16,2024-01-19,750.0,2375,0,2375
1644,TSLA  ,2023-02-16,2024-01-19,758.33,932,0,932
1645,TSLA  ,2023-02-16,2024-01-19,766.67,2114,0,2114
1646,TSLA  ,2023-02-16,2024-01-19,775.0,2798,0,2798
1647,TSLA  ,2023-02-16,2024-01-19,783.33,692,0,692
1648,TSLA  ,2023-02-16,2024-01-19,791.67,3182,0,3182
1649,TSLA  ,2023-02-16,2024-01-19,800.0,13842,0,13842
1650,TSLA  ,2023-02-16,2024-01-19,808.33,3927,0,3927
1651,TSLA  ,2023-02-16,2024-01-19,816.67,5805,0,5805
1652,TSLA  ,2023-02-16,2024-01-19,825.0,75809,0,75809
1653,TSLA  ,2023-02-16,2024-03-15,1.67,108,1894,2002
1654,TSLA  ,2023-02-16,2024-03-15,3.33,22,769,791
1655,TSLA  ,2023-02-16,2024-03-15,5.0,64,895,959
1656,TSLA  ,2023-02-16,2024-03-15,6.67,6,93,99
1657,TSLA  ,2023-02-16,2024-03-15,8.33,16,42,58
1658,TSLA  ,2023-02-16,2024-03-15,10.0,6,313,319
1659,TSLA  ,2023-02-16,2024-03-15,11.67,11,409,420
1660,TSLA  ,2023-02-16,2024-03-15,13.33,18,55,73
1661,TSLA  ,2023-02-16,2024-03-15,15.0,24,380,404
1662,TSLA  ,2023-02-16,2024-03-15,16.67,124,230,354
1663,TSLA  ,2023-02-16,2024-03-15,33.33,809,2000,2809
1664,TSLA  ,2023-02-16,2024-03-15,50.0,449,5654,6103
1665,TSLA  ,2023-02-16,2024-03-15,55.0,30,300,330
1666,TSLA  ,2023-02-16,2024-03-15,60.0,45,856,901
1667,TSLA  ,2023-02-16,2024-03-15,65.0,31,828,859
1668,TSLA  ,2023-02-16,2024-03-15,66.67,2035,1012,3047
1669,TSLA  ,2023-02-16,2024-03-15,70.0,50,238,288
1670,TSLA  ,2023-02-16,2024-03-15,75.0,20,399,419
1671,TSLA  ,2023-02-16,2024-03-15,80.0,191,553,744
1672,TSLA  ,2023-02-16,2024-03-15,83.33,999,4511,5510
1673,TSLA  ,2023-02-16,2024-03-15,85.0,291,214,505
1674,TSLA  ,2023-02-16,2024-03-15,90.0,744,766,1510
1675,TSLA  ,2023-02-16,2024-03-15,95.0,1559,401,1960
1676,TSLA  ,2023-02-16,2024-03-15,100.0,3355,3190,6545
1677,TSLA  ,2023-02-16,2024-03-15,105.0,819,722,1541
1678,TSLA  ,2023-02-16,2024-03-15,110.0,912,2520,3432
1679,TSLA  ,2023-02-16,2024-03-15,115.0,2046,197,2243
1680,TSLA  ,2023-02-16,2024-03-15,116.67,609,1030,1639
1681,TSLA  ,2023-02-16,2024-03-15,120.0,327,616,943
1682,TSLA  ,2023-02-16,2024-03-15,125.0,793,741,1534
1683,TSLA  ,2023-02-16,2024-03-15,130.0,1555,529,2084
1684,TSLA  ,2023-02-16,2024-03-15,133.33,590,5693,6283
1685,TSLA  ,2023-02-16,2024-03-15,135.0,206,231,437
1686,TSLA  ,2023-02-16,2024-03-15,140.0,222,270,492
1687,TSLA  ,2023-02-16,2024-03-15,141.67,562,325,887
1688,TSLA  ,2023-02-16,2024-03-15,145.0,304,382,686
1689,TSLA  ,2023-02-16,2024-03-15,150.0,1307,4449,5756
1690,TSLA  ,2023-02-16,2024-03-15,155.0,88,206,294
1691,TSLA  ,2023-02-16,2024-03-15,158.33,172,583,755
1692,TSLA  ,2023-02-16,2024-03-15,160.0,237,4380,4617
1693,TSLA  ,2023-02-16,2024-03-15,165.0,151,3903,4054
1694,TSLA  ,2023-02-16,2024-03-15,166.67,587,1181,1768
1695,TSLA  ,2023-02-16,2024-03-15,170.0,285,8894,9179
1696,TSLA  ,2023-02-16,2024-03-15,175.0,726,1943,2669
1697,TSLA  ,2023-02-16,2024-03-15,180.0,286,642,928
1698,TSLA  ,2023-02-16,2024-03-15,183.33,514,1146,1660
1699,TSLA  ,2023-02-16,2024-03-15,185.0,251,149,400
1700,TSLA  ,2023-02-16,2024-03-15,190.0,217,272,489
1701,TSLA  ,2023-02-16,2024-03-15,191.67,678,1383,2061
1702,TSLA  ,2023-02-16,2024-03-15,195.0,554,131,685
1703,TSLA  ,2023-02-16,2024-03-15,200.0,5231,4713,9944
1704,TSLA  ,2023-02-16,2024-03-15,208.33,1197,731,1928
1705,TSLA  ,2023-02-16,2024-03-15,210.0,472,193,665
1706,TSLA  ,2023-02-16,2024-03-15,216.67,1483,838,2321
1707,TSLA  ,2023-02-16,2024-03-15,220.0,562,62,624
1708,TSLA  ,2023-02-16,2024-03-15,225.0,2203,2419,4622
1709,TSLA  ,2023-02-16,2024-03-15,230.0,245,84,329
1710,TSLA  ,2023-02-16,2024-03-15,233.33,1623,996,2619
1711,TSLA  ,2023-02-16,2024-03-15,240.0,181,50,231
1712,TSLA  ,2023-02-16,2024-03-15,241.67,1107,955,2062
1713,TSLA  ,2023-02-16,2024-03-15,250.0,2168,1417,3585
1714,TSLA  ,2023-02-16,2024-03-15,258.33,4133,1036,5169
1715,TSLA  ,2023-02-16,2024-03-15,260.0,576,97,673
1716,TSLA  ,2023-02-16,2024-03-15,266.67,4460,810,5270
1717,TSLA  ,2023-02-16,2024-03-15,270.0,309,3,312
1718,TSLA  ,2023-02-16,2024-03-15,275.0,8958,1011,9969
1719,TSLA  ,2023-02-16,2024-03-15,280.0,116,71,187
1720,TSLA  ,2023-02-16,2024-03-15,283.33,1144,709,1853
1721,TSLA  ,2023-02-16,2024-03-15,290.0,13,4,17
1722,TSLA  ,2023-02-16,2024-03-15,291.67,1289,129,1418
1723,TSLA  ,2023-02-16,2024-03-15,300.0,4846,695,5541
1724,TSLA  ,2023-02-16,2024-03-15,308.33,406,40,446
1725,TSLA  ,2023-02-16,2024-03-15,310.0,13,0,13
1726,TSLA  ,2023-02-16,2024-03-15,316.67,936,390,1326
1727,TSLA  ,2023-02-16,2024-03-15,325.0,1559,16,1575
1728,TSLA  ,2023-02-16,2024-03-15,333.33,1043,24,1067
1729,TSLA  ,2023-02-16,2024-03-15,341.67,299,24,323
1730,TSLA  ,2023-02-16,2024-03-15,350.0,898,82,980
1731,TSLA  ,2023-02-16,2024-03-15,358.33,456,68,524
1732,TSLA  ,2023-02-16,2024-03-15,366.67,535,250,785
1733,TSLA  ,2023-02-16,2024-03-15,375.0,770,2,772
1734,TSLA  ,2023-02-16,2024-03-15,383.33,194,1337,1531
1735,TSLA  ,2023-02-16,2024-03-15,391.67,319,8,327
1736,TSLA  ,2023-02-16,2024-03-15,400.0,1230,221,1451
1737,TSLA  ,2023-02-16,2024-03-15,408.33,612,53,665
1738,TSLA  ,2023-02-16,2024-03-15,416.67,368,366,734
1739,TSLA  ,2023-02-16,2024-03-15,425.0,890,8,898
1740,TSLA  ,2023-02-16,2024-03-15,433.33,573,0,573
1741,TSLA  ,2023-02-16,2024-03-15,441.67,170,0,170
1742,TSLA  ,2023-02-16,2024-03-15,450.0,1467,0,1467
1743,TSLA  ,2023-02-16,2024-03-15,458.33,243,2,245
1744,TSLA  ,2023-02-16,2024-03-15,466.67,822,0,822
1745,TSLA  ,2023-02-16,2024-03-15,475.0,423,0,423
1746,TSLA  ,2023-02-16,2024-03-15,483.33,487,0,487
1747,TSLA  ,2023-02-16,2024-03-15,491.67,319,0,319
1748,TSLA  ,2023-02-16,2024-03-15,500.0,2949,0,2949
1749,TSLA  ,2023-02-16,2024-03-15,508.33,227,0,227
1750,TSLA  ,2023-02-16,2024-03-15,516.67,691,0,691
1751,TSLA  ,2023-02-16,2024-03-15,525.0,117,0,117
1752,TSLA  ,2023-02-16,2024-03-15,533.33,221,0,221
1753,TSLA  ,2023-02-16,2024-03-15,541.67,165,0,165
1754,TSLA  ,2023-02-16,2024-03-15,550.0,520,0,520
1755,TSLA  ,2023-02-16,2024-03-15,558.33,264,0,264
1756,TSLA  ,2023-02-16,2024-03-15,566.67,385,0,385
1757,TSLA  ,2023-02-16,2024-03-15,575.0,668,0,668
1758,TSLA  ,2023-02-16,2024-03-15,583.33,487,0,487
1759,TSLA  ,2023-02-16,2024-03-15,600.0,3876,1,3877
1760,TSLA  ,2023-02-16,2024-06-21,1.67,629,16450,17079
1761,TSLA  ,2023-02-16,2024-06-21,3.33,149,3279,3428
1762,TSLA  ,2023-02-16,2024-06-21,5.0,20,1518,1538
1763,TSLA  ,2023-02-16,2024-06-21,6.67,219,1218,1437
1764,TSLA  ,2023-02-16,2024-06-21,8.33,121,368,489
1765,TSLA  ,2023-02-16,2024-06-21,10.0,275,1827,2102
1766,TSLA  ,2023-02-16,2024-06-21,11.67,540,336,876
1767,TSLA  ,2023-02-16,2024-06-21,13.33,39,217,256
1768,TSLA  ,2023-02-16,2024-06-21,16.67,1407,3533,4940
1769,TSLA  ,2023-02-16,2024-06-21,33.33,7802,5364,13166
1770,TSLA  ,2023-02-16,2024-06-21,50.0,1916,3795,5711
1771,TSLA  ,2023-02-16,2024-06-21,55.0,6,383,389
1772,TSLA  ,2023-02-16,2024-06-21,60.0,57,491,548
1773,TSLA  ,2023-02-16,2024-06-21,65.0,111,2103,2214
1774,TSLA  ,2023-02-16,2024-06-21,66.67,1877,4359,6236
1775,TSLA  ,2023-02-16,2024-06-21,70.0,49,250,299
1776,TSLA  ,2023-02-16,2024-06-21,75.0,74,195,269
1777,TSLA  ,2023-02-16,2024-06-21,80.0,111,1455,1566
1778,TSLA  ,2023-02-16,2024-06-21,83.33,30601,4178,34779
1779,TSLA  ,2023-02-16,2024-06-21,85.0,60,862,922
1780,TSLA  ,2023-02-16,2024-06-21,90.0,532,1172,1704
1781,TSLA  ,2023-02-16,2024-06-21,95.0,363,428,791
1782,TSLA  ,2023-02-16,2024-06-21,100.0,5360,9733,15093
1783,TSLA  ,2023-02-16,2024-06-21,105.0,798,925,1723
1784,TSLA  ,2023-02-16,2024-06-21,110.0,495,2221,2716
1785,TSLA  ,2023-02-16,2024-06-21,115.0,414,252,666
1786,TSLA  ,2023-02-16,2024-06-21,116.67,2482,1020,3502
1787,TSLA  ,2023-02-16,2024-06-21,120.0,559,1194,1753
1788,TSLA  ,2023-02-16,2024-06-21,123.33,643,3524,4167
1789,TSLA  ,2023-02-16,2024-06-21,125.0,162,2240,2402
1790,TSLA  ,2023-02-16,2024-06-21,126.67,668,1272,1940
1791,TSLA  ,2023-02-16,2024-06-21,130.0,839,1780,2619
1792,TSLA  ,2023-02-16,2024-06-21,133.33,1922,2859,4781
1793,TSLA  ,2023-02-16,2024-06-21,135.0,63,363,426
1794,TSLA  ,2023-02-16,2024-06-21,136.67,426,1838,2264
1795,TSLA  ,2023-02-16,2024-06-21,140.0,1491,2590,4081
1796,TSLA  ,2023-02-16,2024-06-21,143.33,1404,1686,3090
1797,TSLA  ,2023-02-16,2024-06-21,145.0,600,217,817
1798,TSLA  ,2023-02-16,2024-06-21,146.67,1642,564,2206
1799,TSLA  ,2023-02-16,2024-06-21,150.0,4376,9839,14215
1800,TSLA  ,2023-02-16,2024-06-21,153.33,289,802,1091
1801,TSLA  ,2023-02-16,2024-06-21,155.0,84,438,522
1802,TSLA  ,2023-02-16,2024-06-21,156.67,383,223,606
1803,TSLA  ,2023-02-16,2024-06-21,160.0,879,2716,3595
1804,TSLA  ,2023-02-16,2024-06-21,163.33,186,1412,1598
1805,TSLA  ,2023-02-16,2024-06-21,165.0,347,897,1244
1806,TSLA  ,2023-02-16,2024-06-21,166.67,1733,5515,7248
1807,TSLA  ,2023-02-16,2024-06-21,170.0,301,839,1140
1808,TSLA  ,2023-02-16,2024-06-21,173.33,595,5868,6463
1809,TSLA  ,2023-02-16,2024-06-21,175.0,938,393,1331
1810,TSLA  ,2023-02-16,2024-06-21,180.0,1368,6673,8041
1811,TSLA  ,2023-02-16,2024-06-21,183.33,931,3703,4634
1812,TSLA  ,2023-02-16,2024-06-21,185.0,285,238,523
1813,TSLA  ,2023-02-16,2024-06-21,186.67,1322,1656,2978
1814,TSLA  ,2023-02-16,2024-06-21,190.0,342,114,456
1815,TSLA  ,2023-02-16,2024-06-21,193.33,1022,4297,5319
1816,TSLA  ,2023-02-16,2024-06-21,195.0,273,913,1186
1817,TSLA  ,2023-02-16,2024-06-21,200.0,4739,9875,14614
1818,TSLA  ,2023-02-16,2024-06-21,206.67,1173,2901,4074
1819,TSLA  ,2023-02-16,2024-06-21,210.0,423,132,555
1820,TSLA  ,2023-02-16,2024-06-21,213.33,826,1202,2028
1821,TSLA  ,2023-02-16,2024-06-21,216.67,1641,5370,7011
1822,TSLA  ,2023-02-16,2024-06-21,220.0,2479,2408,4887
1823,TSLA  ,2023-02-16,2024-06-21,226.67,2598,3506,6104
1824,TSLA  ,2023-02-16,2024-06-21,230.0,508,134,642
1825,TSLA  ,2023-02-16,2024-06-21,233.33,6662,7246,13908
1826,TSLA  ,2023-02-16,2024-06-21,240.0,2124,4866,6990
1827,TSLA  ,2023-02-16,2024-06-21,246.67,2257,1235,3492
1828,TSLA  ,2023-02-16,2024-06-21,250.0,5452,3586,9038
1829,TSLA  ,2023-02-16,2024-06-21,253.33,1310,851,2161
1830,TSLA  ,2023-02-16,2024-06-21,260.0,2077,953,3030
1831,TSLA  ,2023-02-16,2024-06-21,266.67,10105,3339,13444
1832,TSLA  ,2023-02-16,2024-06-21,270.0,1449,1816,3265
1833,TSLA  ,2023-02-16,2024-06-21,273.33,1253,793,2046
1834,TSLA  ,2023-02-16,2024-06-21,276.67,1021,809,1830
1835,TSLA  ,2023-02-16,2024-06-21,280.0,1241,1601,2842
1836,TSLA  ,2023-02-16,2024-06-21,283.33,3609,1362,4971
1837,TSLA  ,2023-02-16,2024-06-21,286.67,991,768,1759
1838,TSLA  ,2023-02-16,2024-06-21,290.0,2317,1161,3478
1839,TSLA  ,2023-02-16,2024-06-21,293.33,1112,966,2078
1840,TSLA  ,2023-02-16,2024-06-21,296.67,1019,360,1379
1841,TSLA  ,2023-02-16,2024-06-21,300.0,9326,839,10165
1842,TSLA  ,2023-02-16,2024-06-21,303.33,1417,646,2063
1843,TSLA  ,2023-02-16,2024-06-21,306.67,1489,247,1736
1844,TSLA  ,2023-02-16,2024-06-21,310.0,1822,518,2340
1845,TSLA  ,2023-02-16,2024-06-21,313.33,1194,720,1914
1846,TSLA  ,2023-02-16,2024-06-21,316.67,2365,28,2393
1847,TSLA  ,2023-02-16,2024-06-21,320.0,690,691,1381
1848,TSLA  ,2023-02-16,2024-06-21,323.33,449,309,758
1849,TSLA  ,2023-02-16,2024-06-21,326.67,573,274,847
1850,TSLA  ,2023-02-16,2024-06-21,330.0,2725,123,2848
1851,TSLA  ,2023-02-16,2024-06-21,333.33,7554,1092,8646
1852,TSLA  ,2023-02-16,2024-06-21,336.67,2308,238,2546
1853,TSLA  ,2023-02-16,2024-06-21,340.0,783,30,813
1854,TSLA  ,2023-02-16,2024-06-21,343.33,1220,89,1309
1855,TSLA  ,2023-02-16,2024-06-21,346.67,399,45,444
1856,TSLA  ,2023-02-16,2024-06-21,350.0,3389,6,3395
1857,TSLA  ,2023-02-16,2024-06-21,353.33,199,70,269
1858,TSLA  ,2023-02-16,2024-06-21,356.67,468,0,468
1859,TSLA  ,2023-02-16,2024-06-21,360.0,2621,12,2633
1860,TSLA  ,2023-02-16,2024-06-21,363.33,356,0,356
1861,TSLA  ,2023-02-16,2024-06-21,366.67,4708,0,4708
1862,TSLA  ,2023-02-16,2024-06-21,370.0,3054,9,3063
1863,TSLA  ,2023-02-16,2024-06-21,373.33,556,1,557
1864,TSLA  ,2023-02-16,2024-06-21,376.67,804,0,804
1865,TSLA  ,2023-02-16,2024-06-21,380.0,1052,1,1053
1866,TSLA  ,2023-02-16,2024-06-21,383.33,1019,11,1030
1867,TSLA  ,2023-02-16,2024-06-21,386.67,299,5,304
1868,TSLA  ,2023-02-16,2024-06-21,390.0,436,3,439
1869,TSLA  ,2023-02-16,2024-06-21,393.33,889,2,891
1870,TSLA  ,2023-02-16,2024-06-21,396.67,735,2,737
1871,TSLA  ,2023-02-16,2024-06-21,400.0,38725,35,38760
1872,TSLA  ,2023-02-16,2024-06-21,416.67,3179,1,3180
1873,TSLA  ,2023-02-16,2024-06-21,433.33,3271,0,3271
1874,TSLA  ,2023-02-16,2024-06-21,450.0,3043,0,3043
1875,TSLA  ,2023-02-16,2024-06-21,466.67,5395,0,5395
1876,TSLA  ,2023-02-16,2024-06-21,483.33,1114,0,1114
1877,TSLA  ,2023-02-16,2024-06-21,500.0,10998,0,10998
1878,TSLA  ,2023-02-16,2024-06-21,516.67,2090,0,2090
1879,TSLA  ,2023-02-16,2024-06-21,533.33,3104,0,3104
1880,TSLA  ,2023-02-16,2024-06-21,550.0,2605,0,2605
1881,TSLA  ,2023-02-16,2024-06-21,566.67,1007,0,1007
1882,TSLA  ,2023-02-16,2024-06-21,583.33,1039,0,1039
1883,TSLA  ,2023-02-16,2024-06-21,600.0,17163,0,17163
1884,TSLA  ,2023-02-16,2024-06-21,616.67,14010,0,14010
1885,TSLA  ,2023-02-16,2024-06-21,633.33,4540,0,4540
1886,TSLA  ,2023-02-16,2024-06-21,650.0,622,0,622
1887,TSLA  ,2023-02-16,2024-06-21,666.67,6553,0,6553
1888,TSLA  ,2023-02-16,2024-06-21,683.33,1687,0,1687
1889,TSLA  ,2023-02-16,2024-06-21,700.0,3967,0,3967
1890,TSLA  ,2023-02-16,2024-06-21,716.67,899,0,899
1891,TSLA  ,2023-02-16,2024-06-21,733.33,2082,0,2082
1892,TSLA  ,2023-02-16,2024-06-21,750.0,5828,1,5829
1893,TSLA  ,2023-02-16,2024-06-21,758.33,14450,0,14450
1894,TSLA  ,2023-02-16,2024-09-20,50.0,44,925,969
1895,TSLA  ,2023-02-16,2024-09-20,55.0,29,176,205
1896,TSLA  ,2023-02-16,2024-09-20,60.0,10,146,156
1897,TSLA  ,2023-02-16,2024-09-20,65.0,39,80,119
1898,TSLA  ,2023-02-16,2024-09-20,70.0,11,136,147
1899,TSLA  ,2023-02-16,2024-09-20,75.0,10,2323,2333
1900,TSLA  ,2023-02-16,2024-09-20,80.0,66,139,205
1901,TSLA  ,2023-02-16,2024-09-20,85.0,987,454,1441
1902,TSLA  ,2023-02-16,2024-09-20,90.0,47,185,232
1903,TSLA  ,2023-02-16,2024-09-20,95.0,22,441,463
1904,TSLA  ,2023-02-16,2024-09-20,100.0,384,2214,2598
1905,TSLA  ,2023-02-16,2024-09-20,105.0,188,719,907
1906,TSLA  ,2023-02-16,2024-09-20,110.0,163,1095,1258
1907,TSLA  ,2023-02-16,2024-09-20,115.0,563,603,1166
1908,TSLA  ,2023-02-16,2024-09-20,120.0,718,547,1265
1909,TSLA  ,2023-02-16,2024-09-20,125.0,321,1201,1522
1910,TSLA  ,2023-02-16,2024-09-20,130.0,636,840,1476
1911,TSLA  ,2023-02-16,2024-09-20,135.0,580,271,851
1912,TSLA  ,2023-02-16,2024-09-20,140.0,1094,343,1437
1913,TSLA  ,2023-02-16,2024-09-20,145.0,1292,353,1645
1914,TSLA  ,2023-02-16,2024-09-20,150.0,1437,2726,4163
1915,TSLA  ,2023-02-16,2024-09-20,155.0,529,296,825
1916,TSLA  ,2023-02-16,2024-09-20,160.0,429,822,1251
1917,TSLA  ,2023-02-16,2024-09-20,165.0,280,109,389
1918,TSLA  ,2023-02-16,2024-09-20,170.0,205,277,482
1919,TSLA  ,2023-02-16,2024-09-20,175.0,235,126,361
1920,TSLA  ,2023-02-16,2024-09-20,180.0,730,85,815
1921,TSLA  ,2023-02-16,2024-09-20,185.0,830,916,1746
1922,TSLA  ,2023-02-16,2024-09-20,190.0,1492,126,1618
1923,TSLA  ,2023-02-16,2024-09-20,195.0,1416,118,1534
1924,TSLA  ,2023-02-16,2024-09-20,200.0,1764,1478,3242
1925,TSLA  ,2023-02-16,2024-09-20,210.0,775,268,1043
1926,TSLA  ,2023-02-16,2024-09-20,220.0,1381,422,1803
1927,TSLA  ,2023-02-16,2024-09-20,230.0,695,119,814
1928,TSLA  ,2023-02-16,2024-09-20,240.0,452,305,757
1929,TSLA  ,2023-02-16,2024-09-20,250.0,859,366,1225
1930,TSLA  ,2023-02-16,2024-09-20,260.0,901,70,971
1931,TSLA  ,2023-02-16,2024-09-20,270.0,601,534,1135
1932,TSLA  ,2023-02-16,2024-09-20,280.0,327,577,904
1933,TSLA  ,2023-02-16,2024-09-20,290.0,466,2810,3276
1934,TSLA  ,2023-02-16,2024-09-20,300.0,1042,1165,2207
1935,TSLA  ,2023-02-16,2024-09-20,310.0,182,786,968
1936,TSLA  ,2023-02-16,2024-09-20,320.0,112,258,370
1937,TSLA  ,2023-02-16,2024-09-20,330.0,106,117,223
1938,TSLA  ,2023-02-16,2024-09-20,340.0,702,110,812
1939,TSLA  ,2023-02-16,2024-09-20,350.0,1442,109,1551
1940,TSLA  ,2023-02-16,2024-09-20,360.0,53,63,116
1941,TSLA  ,2023-02-16,2024-09-20,370.0,78,3,81
1942,TSLA  ,2023-02-16,2024-09-20,380.0,76,2,78
1943,TSLA  ,2023-02-16,2024-09-20,390.0,213,17,230
1944,TSLA  ,2023-02-16,2025-01-17,5.0,660,11505,12165
1945,TSLA  ,2023-02-16,2025-01-17,10.0,139,854,993
1946,TSLA  ,2023-02-16,2025-01-17,15.0,29,862,891
1947,TSLA  ,2023-02-16,2025-01-17,20.0,385,5799,6184
1948,TSLA  ,2023-02-16,2025-01-17,25.0,103,2510,2613
1949,TSLA  ,2023-02-16,2025-01-17,30.0,13823,16560,30383
1950,TSLA  ,2023-02-16,2025-01-17,35.0,265,1140,1405
1951,TSLA  ,2023-02-16,2025-01-17,40.0,14708,15783,30491
1952,TSLA  ,2023-02-16,2025-01-17,45.0,2979,3196,6175
1953,TSLA  ,2023-02-16,2025-01-17,50.0,2725,8552,11277
1954,TSLA  ,2023-02-16,2025-01-17,55.0,2004,4257,6261
1955,TSLA  ,2023-02-16,2025-01-17,60.0,592,1961,2553
1956,TSLA  ,2023-02-16,2025-01-17,65.0,1640,1572,3212
1957,TSLA  ,2023-02-16,2025-01-17,70.0,2492,2201,4693
1958,TSLA  ,2023-02-16,2025-01-17,75.0,177,4311,4488
1959,TSLA  ,2023-02-16,2025-01-17,80.0,1308,1859,3167
1960,TSLA  ,2023-02-16,2025-01-17,85.0,1827,1608,3435
1961,TSLA  ,2023-02-16,2025-01-17,90.0,1123,5529,6652
1962,TSLA  ,2023-02-16,2025-01-17,95.0,139,503,642
1963,TSLA  ,2023-02-16,2025-01-17,100.0,5431,17633,23064
1964,TSLA  ,2023-02-16,2025-01-17,105.0,320,1673,1993
1965,TSLA  ,2023-02-16,2025-01-17,110.0,5443,7138,12581
1966,TSLA  ,2023-02-16,2025-01-17,115.0,3632,3632,7264
1967,TSLA  ,2023-02-16,2025-01-17,120.0,8376,6128,14504
1968,TSLA  ,2023-02-16,2025-01-17,125.0,2156,1171,3327
1969,TSLA  ,2023-02-16,2025-01-17,130.0,5635,7182,12817
1970,TSLA  ,2023-02-16,2025-01-17,135.0,5700,694,6394
1971,TSLA  ,2023-02-16,2025-01-17,140.0,8569,4666,13235
1972,TSLA  ,2023-02-16,2025-01-17,145.0,767,694,1461
1973,TSLA  ,2023-02-16,2025-01-17,150.0,11927,12104,24031
1974,TSLA  ,2023-02-16,2025-01-17,155.0,427,499,926
1975,TSLA  ,2023-02-16,2025-01-17,160.0,4607,5542,10149
1976,TSLA  ,2023-02-16,2025-01-17,165.0,250,949,1199
1977,TSLA  ,2023-02-16,2025-01-17,170.0,35398,10282,45680
1978,TSLA  ,2023-02-16,2025-01-17,175.0,33475,4514,37989
1979,TSLA  ,2023-02-16,2025-01-17,180.0,4010,8205,12215
1980,TSLA  ,2023-02-16,2025-01-17,185.0,7116,4530,11646
1981,TSLA  ,2023-02-16,2025-01-17,190.0,5683,4781,10464
1982,TSLA  ,2023-02-16,2025-01-17,195.0,3232,1729,4961
1983,TSLA  ,2023-02-16,2025-01-17,200.0,28970,12442,41412
1984,TSLA  ,2023-02-16,2025-01-17,210.0,5324,2619,7943
1985,TSLA  ,2023-02-16,2025-01-17,220.0,3089,4081,7170
1986,TSLA  ,2023-02-16,2025-01-17,230.0,4234,3299,7533
1987,TSLA  ,2023-02-16,2025-01-17,240.0,4701,4587,9288
1988,TSLA  ,2023-02-16,2025-01-17,250.0,11663,5156,16819
1989,TSLA  ,2023-02-16,2025-01-17,260.0,5624,1805,7429
1990,TSLA  ,2023-02-16,2025-01-17,270.0,3103,1319,4422
1991,TSLA  ,2023-02-16,2025-01-17,280.0,2247,3339,5586
1992,TSLA  ,2023-02-16,2025-01-17,290.0,3436,2807,6243
1993,TSLA  ,2023-02-16,2025-01-17,300.0,30561,3072,33633
1994,TSLA  ,2023-02-16,2025-01-17,310.0,4387,701,5088
1995,TSLA  ,2023-02-16,2025-01-17,320.0,2112,850,2962
1996,TSLA  ,2023-02-16,2025-01-17,330.0,2346,1021,3367
1997,TSLA  ,2023-02-16,2025-01-17,340.0,1399,462,1861
1998,TSLA  ,2023-02-16,2025-01-17,350.0,7122,867,7989
1999,TSLA  ,2023-02-16,2025-01-17,360.0,1944,241,2185
2000,TSLA  ,2023-02-16,2025-01-17,370.0,1894,297,2191
2001,TSLA  ,2023-02-16,2025-01-17,380.0,1375,212,1587
2002,TSLA  ,2023-02-16,2025-01-17,390.0,1722,71,1793
2003,TSLA  ,2023-02-16,2025-01-17,400.0,19343,108,19451
2004,TSLA  ,2023-02-16,2025-01-17,410.0,4373,70,4443
2005,TSLA  ,2023-02-16,2025-01-17,420.0,4120,11,4131
2006,TSLA  ,2023-02-16,2025-01-17,430.0,591,2,593
2007,TSLA  ,2023-02-16,2025-01-17,440.0,1585,9,1594
2008,TSLA  ,2023-02-16,2025-01-17,450.0,5132,4,5136
2009,TSLA  ,2023-02-16,2025-01-17,460.0,1008,14,1022
2010,TSLA  ,2023-02-16,2025-01-17,470.0,1552,67,1619
2011,TSLA  ,2023-02-16,2025-01-17,480.0,1246,1,1247
2012,TSLA  ,2023-02-16,2025-01-17,490.0,803,0,803
2013,TSLA  ,2023-02-16,2025-01-17,500.0,10769,19,10788
2014,TSLA  ,2023-02-16,2025-01-17,510.0,1422,274,1696
2015,TSLA  ,2023-02-16,2025-01-17,520.0,8349,1,8350
2016,TSLA  ,2023-02-16,2025-01-17,530.0,652,0,652
2017,TSLA  ,2023-02-16,2025-01-17,540.0,603,0,603
2018,TSLA  ,2023-02-16,2025-01-17,550.0,3089,0,3089
2019,TSLA  ,2023-02-16,2025-01-17,560.0,631,0,631
2020,TSLA  ,2023-02-16,2025-01-17,570.0,669,0,669
2021,TSLA  ,2023-02-16,2025-01-17,580.0,879,0,879
2022,TSLA  ,2023-02-16,2025-01-17,590.0,756,1,757
2023,TSLA  ,2023-02-16,2025-01-17,600.0,15255,4,15259
2024,TSLA  ,2023-02-16,2025-01-17,610.0,17862,110,17972
2025,TSLA  ,2023-02-16,2025-06-20,5.0,231,976,1207
2026,TSLA  ,2023-02-16,2025-06-20,10.0,4,66,70
2027,TSLA  ,2023-02-16,2025-06-20,15.0,8,5847,5855
2028,TSLA  ,2023-02-16,2025-06-20,20.0,53,423,476
2029,TSLA  ,2023-02-16,2025-06-20,25.0,9,134,143
2030,TSLA  ,2023-02-16,2025-06-20,30.0,83,249,332
2031,TSLA  ,2023-02-16,2025-06-20,35.0,11,184,195
2032,TSLA  ,2023-02-16,2025-06-20,40.0,10,281,291
2033,TSLA  ,2023-02-16,2025-06-20,45.0,17,53,70
2034,TSLA  ,2023-02-16,2025-06-20,50.0,158,747,905
2035,TSLA  ,2023-02-16,2025-06-20,55.0,13,54,67
2036,TSLA  ,2023-02-16,2025-06-20,60.0,15,383,398
2037,TSLA  ,2023-02-16,2025-06-20,65.0,19,575,594
2038,TSLA  ,2023-02-16,2025-06-20,70.0,164,125,289
2039,TSLA  ,2023-02-16,2025-06-20,75.0,131,1297,1428
2040,TSLA  ,2023-02-16,2025-06-20,80.0,803,731,1534
2041,TSLA  ,2023-02-16,2025-06-20,85.0,351,243,594
2042,TSLA  ,2023-02-16,2025-06-20,90.0,10311,440,10751
2043,TSLA  ,2023-02-16,2025-06-20,95.0,46449,545,46994
2044,TSLA  ,2023-02-16,2025-06-20,100.0,984,4842,5826
2045,TSLA  ,2023-02-16,2025-06-20,105.0,159,438,597
2046,TSLA  ,2023-02-16,2025-06-20,110.0,352,1608,1960
2047,TSLA  ,2023-02-16,2025-06-20,115.0,435,257,692
2048,TSLA  ,2023-02-16,2025-06-20,120.0,529,979,1508
2049,TSLA  ,2023-02-16,2025-06-20,125.0,507,369,876
2050,TSLA  ,2023-02-16,2025-06-20,130.0,2601,1556,4157
2051,TSLA  ,2023-02-16,2025-06-20,135.0,4673,272,4945
2052,TSLA  ,2023-02-16,2025-06-20,140.0,986,1866,2852
2053,TSLA  ,2023-02-16,2025-06-20,145.0,407,482,889
2054,TSLA  ,2023-02-16,2025-06-20,150.0,1398,1307,2705
2055,TSLA  ,2023-02-16,2025-06-20,155.0,401,125,526
2056,TSLA  ,2023-02-16,2025-06-20,160.0,2171,842,3013
2057,TSLA  ,2023-02-16,2025-06-20,165.0,937,329,1266
2058,TSLA  ,2023-02-16,2025-06-20,170.0,2822,991,3813
2059,TSLA  ,2023-02-16,2025-06-20,175.0,745,1196,1941
2060,TSLA  ,2023-02-16,2025-06-20,180.0,639,539,1178
2061,TSLA  ,2023-02-16,2025-06-20,185.0,2554,188,2742
2062,TSLA  ,2023-02-16,2025-06-20,190.0,527,349,876
2063,TSLA  ,2023-02-16,2025-06-20,195.0,327,318,645
2064,TSLA  ,2023-02-16,2025-06-20,200.0,4319,3227,7546
2065,TSLA  ,2023-02-16,2025-06-20,205.0,276,230,506
2066,TSLA  ,2023-02-16,2025-06-20,210.0,437,174,611
2067,TSLA  ,2023-02-16,2025-06-20,215.0,175,87,262
2068,TSLA  ,2023-02-16,2025-06-20,220.0,675,116,791
2069,TSLA  ,2023-02-16,2025-06-20,225.0,553,192,745
2070,TSLA  ,2023-02-16,2025-06-20,230.0,497,84,581
2071,TSLA  ,2023-02-16,2025-06-20,235.0,337,263,600
2072,TSLA  ,2023-02-16,2025-06-20,240.0,4213,1405,5618
2073,TSLA  ,2023-02-16,2025-06-20,250.0,2221,541,2762
2074,TSLA  ,2023-02-16,2025-06-20,260.0,495,1337,1832
2075,TSLA  ,2023-02-16,2025-06-20,270.0,545,100,645
2076,TSLA  ,2023-02-16,2025-06-20,280.0,235,234,469
2077,TSLA  ,2023-02-16,2025-06-20,290.0,242,398,640
2078,TSLA  ,2023-02-16,2025-06-20,300.0,2920,651,3571
2079,TSLA  ,2023-02-16,2025-06-20,310.0,266,180,446
2080,TSLA  ,2023-02-16,2025-06-20,320.0,831,194,1025
2081,TSLA  ,2023-02-16,2025-06-20,330.0,208,286,494
2082,TSLA  ,2023-02-16,2025-06-20,340.0,454,399,853
2083,TSLA  ,2023-02-16,2025-06-20,350.0,2683,247,2930
2084,TSLA  ,2023-02-16,2025-06-20,360.0,684,222,906
2085,TSLA  ,2023-02-16,2025-06-20,370.0,170,178,348
2086,TSLA  ,2023-02-16,2025-06-20,380.0,81,54,135
2087,TSLA  ,2023-02-16,2025-06-20,390.0,2314,116,2430
