index,ProductSymbol,DateGen,ExpDate,Strike,Call,Put,TotalOI
0,TSLA  ,2023-02-07,2023-02-10,15.0,16,163,179
1,TSLA  ,2023-02-07,2023-02-10,20.0,4,1,5
2,TSLA  ,2023-02-07,2023-02-10,25.0,0,250,250
3,TSLA  ,2023-02-07,2023-02-10,30.0,7,1498,1505
4,TSLA  ,2023-02-07,2023-02-10,35.0,2,1461,1463
5,TSLA  ,2023-02-07,2023-02-10,40.0,2,934,936
6,TSLA  ,2023-02-07,2023-02-10,45.0,1,1869,1870
7,TSLA  ,2023-02-07,2023-02-10,50.0,73,2204,2277
8,TSLA  ,2023-02-07,2023-02-10,55.0,3,1158,1161
9,TSLA  ,2023-02-07,2023-02-10,60.0,4,2416,2420
10,TSLA  ,2023-02-07,2023-02-10,65.0,5,1705,1710
11,TSLA  ,2023-02-07,2023-02-10,70.0,13,1611,1624
12,TSLA  ,2023-02-07,2023-02-10,75.0,5,657,662
13,TSLA  ,2023-02-07,2023-02-10,80.0,69,1922,1991
14,TSLA  ,2023-02-07,2023-02-10,85.0,24,1033,1057
15,TSLA  ,2023-02-07,2023-02-10,90.0,59,1798,1857
16,TSLA  ,2023-02-07,2023-02-10,95.0,41,1391,1432
17,TSLA  ,2023-02-07,2023-02-10,98.0,40,710,750
18,TSLA  ,2023-02-07,2023-02-10,99.0,36,1228,1264
19,TSLA  ,2023-02-07,2023-02-10,100.0,176,3104,3280
20,TSLA  ,2023-02-07,2023-02-10,101.0,106,1910,2016
21,TSLA  ,2023-02-07,2023-02-10,102.0,51,513,564
22,TSLA  ,2023-02-07,2023-02-10,103.0,51,997,1048
23,TSLA  ,2023-02-07,2023-02-10,104.0,61,864,925
24,TSLA  ,2023-02-07,2023-02-10,105.0,157,3328,3485
25,TSLA  ,2023-02-07,2023-02-10,106.0,27,1778,1805
26,TSLA  ,2023-02-07,2023-02-10,107.0,47,1827,1874
27,TSLA  ,2023-02-07,2023-02-10,108.0,71,1531,1602
28,TSLA  ,2023-02-07,2023-02-10,109.0,94,1131,1225
29,TSLA  ,2023-02-07,2023-02-10,110.0,564,2353,2917
30,TSLA  ,2023-02-07,2023-02-10,111.0,103,383,486
31,TSLA  ,2023-02-07,2023-02-10,112.0,42,2475,2517
32,TSLA  ,2023-02-07,2023-02-10,113.0,167,1095,1262
33,TSLA  ,2023-02-07,2023-02-10,114.0,139,6026,6165
34,TSLA  ,2023-02-07,2023-02-10,115.0,287,2692,2979
35,TSLA  ,2023-02-07,2023-02-10,116.0,103,528,631
36,TSLA  ,2023-02-07,2023-02-10,117.0,177,521,698
37,TSLA  ,2023-02-07,2023-02-10,118.0,181,1201,1382
38,TSLA  ,2023-02-07,2023-02-10,119.0,150,815,965
39,TSLA  ,2023-02-07,2023-02-10,120.0,828,5085,5913
40,TSLA  ,2023-02-07,2023-02-10,121.0,245,1757,2002
41,TSLA  ,2023-02-07,2023-02-10,122.0,686,1293,1979
42,TSLA  ,2023-02-07,2023-02-10,123.0,269,1407,1676
43,TSLA  ,2023-02-07,2023-02-10,124.0,332,1800,2132
44,TSLA  ,2023-02-07,2023-02-10,125.0,882,4755,5637
45,TSLA  ,2023-02-07,2023-02-10,126.0,236,1467,1703
46,TSLA  ,2023-02-07,2023-02-10,127.0,382,1942,2324
47,TSLA  ,2023-02-07,2023-02-10,128.0,1146,1146,2292
48,TSLA  ,2023-02-07,2023-02-10,129.0,629,3258,3887
49,TSLA  ,2023-02-07,2023-02-10,130.0,1512,6578,8090
50,TSLA  ,2023-02-07,2023-02-10,131.0,559,2474,3033
51,TSLA  ,2023-02-07,2023-02-10,132.0,668,1944,2612
52,TSLA  ,2023-02-07,2023-02-10,133.0,757,847,1604
53,TSLA  ,2023-02-07,2023-02-10,134.0,334,4015,4349
54,TSLA  ,2023-02-07,2023-02-10,135.0,1580,5416,6996
55,TSLA  ,2023-02-07,2023-02-10,136.0,396,2386,2782
56,TSLA  ,2023-02-07,2023-02-10,137.0,622,2600,3222
57,TSLA  ,2023-02-07,2023-02-10,138.0,802,5293,6095
58,TSLA  ,2023-02-07,2023-02-10,139.0,990,6280,7270
59,TSLA  ,2023-02-07,2023-02-10,140.0,2866,7939,10805
60,TSLA  ,2023-02-07,2023-02-10,141.0,736,1345,2081
61,TSLA  ,2023-02-07,2023-02-10,142.0,1296,3608,4904
62,TSLA  ,2023-02-07,2023-02-10,143.0,587,586,1173
63,TSLA  ,2023-02-07,2023-02-10,144.0,375,1134,1509
64,TSLA  ,2023-02-07,2023-02-10,145.0,3106,12657,15763
65,TSLA  ,2023-02-07,2023-02-10,146.0,904,1166,2070
66,TSLA  ,2023-02-07,2023-02-10,147.0,1013,3139,4152
67,TSLA  ,2023-02-07,2023-02-10,148.0,423,1970,2393
68,TSLA  ,2023-02-07,2023-02-10,149.0,330,2129,2459
69,TSLA  ,2023-02-07,2023-02-10,150.0,4168,12911,17079
70,TSLA  ,2023-02-07,2023-02-10,152.5,687,3959,4646
71,TSLA  ,2023-02-07,2023-02-10,155.0,6426,7501,13927
72,TSLA  ,2023-02-07,2023-02-10,157.5,1200,4437,5637
73,TSLA  ,2023-02-07,2023-02-10,160.0,3997,11469,15466
74,TSLA  ,2023-02-07,2023-02-10,162.5,1182,2569,3751
75,TSLA  ,2023-02-07,2023-02-10,165.0,5004,12661,17665
76,TSLA  ,2023-02-07,2023-02-10,167.5,1453,4482,5935
77,TSLA  ,2023-02-07,2023-02-10,170.0,6388,13662,20050
78,TSLA  ,2023-02-07,2023-02-10,172.5,2589,7541,10130
79,TSLA  ,2023-02-07,2023-02-10,175.0,6291,12905,19196
80,TSLA  ,2023-02-07,2023-02-10,177.5,2513,4412,6925
81,TSLA  ,2023-02-07,2023-02-10,180.0,7921,14682,22603
82,TSLA  ,2023-02-07,2023-02-10,182.5,2408,5226,7634
83,TSLA  ,2023-02-07,2023-02-10,185.0,7760,14378,22138
84,TSLA  ,2023-02-07,2023-02-10,187.5,2675,7144,9819
85,TSLA  ,2023-02-07,2023-02-10,190.0,12909,14129,27038
86,TSLA  ,2023-02-07,2023-02-10,192.5,4988,4675,9663
87,TSLA  ,2023-02-07,2023-02-10,195.0,16646,10500,27146
88,TSLA  ,2023-02-07,2023-02-10,197.5,9840,2653,12493
89,TSLA  ,2023-02-07,2023-02-10,200.0,33424,8978,42402
90,TSLA  ,2023-02-07,2023-02-10,202.5,5339,868,6207
91,TSLA  ,2023-02-07,2023-02-10,205.0,12940,1225,14165
92,TSLA  ,2023-02-07,2023-02-10,207.5,4866,880,5746
93,TSLA  ,2023-02-07,2023-02-10,210.0,20137,2283,22420
94,TSLA  ,2023-02-07,2023-02-10,212.5,2840,706,3546
95,TSLA  ,2023-02-07,2023-02-10,215.0,12430,1428,13858
96,TSLA  ,2023-02-07,2023-02-10,217.5,5529,287,5816
97,TSLA  ,2023-02-07,2023-02-10,220.0,16997,1464,18461
98,TSLA  ,2023-02-07,2023-02-10,222.5,4521,113,4634
99,TSLA  ,2023-02-07,2023-02-10,225.0,8540,208,8748
100,TSLA  ,2023-02-07,2023-02-10,227.5,3365,145,3510
101,TSLA  ,2023-02-07,2023-02-10,230.0,14858,551,15409
102,TSLA  ,2023-02-07,2023-02-10,232.5,2791,87,2878
103,TSLA  ,2023-02-07,2023-02-10,235.0,10856,173,11029
104,TSLA  ,2023-02-07,2023-02-10,237.5,1721,99,1820
105,TSLA  ,2023-02-07,2023-02-10,240.0,8191,193,8384
106,TSLA  ,2023-02-07,2023-02-10,242.5,2718,54,2772
107,TSLA  ,2023-02-07,2023-02-10,245.0,6700,20,6720
108,TSLA  ,2023-02-07,2023-02-10,247.5,3618,6,3624
109,TSLA  ,2023-02-07,2023-02-10,250.0,16071,40,16111
110,TSLA  ,2023-02-07,2023-02-10,252.5,1086,8,1094
111,TSLA  ,2023-02-07,2023-02-10,255.0,6069,11,6080
112,TSLA  ,2023-02-07,2023-02-10,257.5,988,3,991
113,TSLA  ,2023-02-07,2023-02-10,260.0,8551,3,8554
114,TSLA  ,2023-02-07,2023-02-10,265.0,7553,0,7553
115,TSLA  ,2023-02-07,2023-02-10,270.0,9750,0,9750
116,TSLA  ,2023-02-07,2023-02-10,275.0,7995,0,7995
117,TSLA  ,2023-02-07,2023-02-10,280.0,8252,0,8252
118,TSLA  ,2023-02-07,2023-02-10,285.0,12355,0,12355
119,TSLA  ,2023-02-07,2023-02-10,290.0,4709,0,4709
120,TSLA  ,2023-02-07,2023-02-10,295.0,2809,0,2809
121,TSLA  ,2023-02-07,2023-02-10,300.0,3015,0,3015
122,TSLA  ,2023-02-07,2023-02-10,310.0,1709,0,1709
123,TSLA  ,2023-02-07,2023-02-10,320.0,1519,0,1519
124,TSLA  ,2023-02-07,2023-02-10,330.0,1239,0,1239
125,TSLA  ,2023-02-07,2023-02-10,340.0,1341,0,1341
126,TSLA  ,2023-02-07,2023-02-10,350.0,2078,0,2078
127,TSLA  ,2023-02-07,2023-02-10,360.0,3010,0,3010
128,TSLA  ,2023-02-07,2023-02-17,15.0,64,304,368
129,TSLA  ,2023-02-07,2023-02-17,20.0,34,41,75
130,TSLA  ,2023-02-07,2023-02-17,25.0,4,99,103
131,TSLA  ,2023-02-07,2023-02-17,30.0,71,2723,2794
132,TSLA  ,2023-02-07,2023-02-17,35.0,0,5413,5413
133,TSLA  ,2023-02-07,2023-02-17,40.0,160,10375,10535
134,TSLA  ,2023-02-07,2023-02-17,45.0,0,1739,1739
135,TSLA  ,2023-02-07,2023-02-17,50.0,950,17136,18086
136,TSLA  ,2023-02-07,2023-02-17,55.0,41,5311,5352
137,TSLA  ,2023-02-07,2023-02-17,60.0,489,9040,9529
138,TSLA  ,2023-02-07,2023-02-17,65.0,28,6535,6563
139,TSLA  ,2023-02-07,2023-02-17,70.0,74,53619,53693
140,TSLA  ,2023-02-07,2023-02-17,75.0,128,7614,7742
141,TSLA  ,2023-02-07,2023-02-17,80.0,205,22106,22311
142,TSLA  ,2023-02-07,2023-02-17,85.0,261,13189,13450
143,TSLA  ,2023-02-07,2023-02-17,90.0,285,16849,17134
144,TSLA  ,2023-02-07,2023-02-17,95.0,822,17711,18533
145,TSLA  ,2023-02-07,2023-02-17,100.0,3355,36440,39795
146,TSLA  ,2023-02-07,2023-02-17,105.0,20748,29331,50079
147,TSLA  ,2023-02-07,2023-02-17,110.0,3513,25507,29020
148,TSLA  ,2023-02-07,2023-02-17,115.0,15419,24645,40064
149,TSLA  ,2023-02-07,2023-02-17,118.0,262,1201,1463
150,TSLA  ,2023-02-07,2023-02-17,119.0,13,963,976
151,TSLA  ,2023-02-07,2023-02-17,120.0,26443,50420,76863
152,TSLA  ,2023-02-07,2023-02-17,121.0,29,762,791
153,TSLA  ,2023-02-07,2023-02-17,122.0,185,1243,1428
154,TSLA  ,2023-02-07,2023-02-17,123.0,96,1376,1472
155,TSLA  ,2023-02-07,2023-02-17,124.0,31,920,951
156,TSLA  ,2023-02-07,2023-02-17,125.0,12269,17323,29592
157,TSLA  ,2023-02-07,2023-02-17,126.0,44,1061,1105
158,TSLA  ,2023-02-07,2023-02-17,127.0,40,1082,1122
159,TSLA  ,2023-02-07,2023-02-17,128.0,55,2223,2278
160,TSLA  ,2023-02-07,2023-02-17,129.0,84,1565,1649
161,TSLA  ,2023-02-07,2023-02-17,130.0,13535,14900,28435
162,TSLA  ,2023-02-07,2023-02-17,131.0,142,1215,1357
163,TSLA  ,2023-02-07,2023-02-17,132.0,215,1201,1416
164,TSLA  ,2023-02-07,2023-02-17,133.0,67,1238,1305
165,TSLA  ,2023-02-07,2023-02-17,134.0,354,806,1160
166,TSLA  ,2023-02-07,2023-02-17,135.0,7784,10952,18736
167,TSLA  ,2023-02-07,2023-02-17,136.0,1421,1913,3334
168,TSLA  ,2023-02-07,2023-02-17,137.0,869,1535,2404
169,TSLA  ,2023-02-07,2023-02-17,138.0,668,1267,1935
170,TSLA  ,2023-02-07,2023-02-17,139.0,911,1008,1919
171,TSLA  ,2023-02-07,2023-02-17,140.0,8141,16252,24393
172,TSLA  ,2023-02-07,2023-02-17,141.0,321,1756,2077
173,TSLA  ,2023-02-07,2023-02-17,142.0,912,1560,2472
174,TSLA  ,2023-02-07,2023-02-17,143.0,273,1296,1569
175,TSLA  ,2023-02-07,2023-02-17,144.0,294,1053,1347
176,TSLA  ,2023-02-07,2023-02-17,145.0,11854,23731,35585
177,TSLA  ,2023-02-07,2023-02-17,146.0,1749,1416,3165
178,TSLA  ,2023-02-07,2023-02-17,147.0,513,4430,4943
179,TSLA  ,2023-02-07,2023-02-17,148.0,236,2098,2334
180,TSLA  ,2023-02-07,2023-02-17,149.0,459,1418,1877
181,TSLA  ,2023-02-07,2023-02-17,150.0,15762,25079,40841
182,TSLA  ,2023-02-07,2023-02-17,152.5,998,2336,3334
183,TSLA  ,2023-02-07,2023-02-17,155.0,10017,7234,17251
184,TSLA  ,2023-02-07,2023-02-17,157.5,1464,3633,5097
185,TSLA  ,2023-02-07,2023-02-17,160.0,29277,18509,47786
186,TSLA  ,2023-02-07,2023-02-17,162.5,1323,4224,5547
187,TSLA  ,2023-02-07,2023-02-17,165.0,12017,11023,23040
188,TSLA  ,2023-02-07,2023-02-17,167.5,929,3801,4730
189,TSLA  ,2023-02-07,2023-02-17,170.0,19489,15723,35212
190,TSLA  ,2023-02-07,2023-02-17,172.5,2139,5017,7156
191,TSLA  ,2023-02-07,2023-02-17,175.0,10837,9384,20221
192,TSLA  ,2023-02-07,2023-02-17,177.5,2395,2250,4645
193,TSLA  ,2023-02-07,2023-02-17,180.0,13962,15450,29412
194,TSLA  ,2023-02-07,2023-02-17,182.5,4667,2588,7255
195,TSLA  ,2023-02-07,2023-02-17,185.0,13001,6575,19576
196,TSLA  ,2023-02-07,2023-02-17,187.5,2380,2145,4525
197,TSLA  ,2023-02-07,2023-02-17,190.0,12529,11865,24394
198,TSLA  ,2023-02-07,2023-02-17,192.5,2594,2253,4847
199,TSLA  ,2023-02-07,2023-02-17,195.0,8289,5649,13938
200,TSLA  ,2023-02-07,2023-02-17,197.5,5294,1679,6973
201,TSLA  ,2023-02-07,2023-02-17,200.0,30548,5418,35966
202,TSLA  ,2023-02-07,2023-02-17,202.5,4385,737,5122
203,TSLA  ,2023-02-07,2023-02-17,205.0,7537,1646,9183
204,TSLA  ,2023-02-07,2023-02-17,207.5,983,141,1124
205,TSLA  ,2023-02-07,2023-02-17,210.0,13920,1920,15840
206,TSLA  ,2023-02-07,2023-02-17,212.5,844,42,886
207,TSLA  ,2023-02-07,2023-02-17,215.0,13199,1667,14866
208,TSLA  ,2023-02-07,2023-02-17,217.5,649,21,670
209,TSLA  ,2023-02-07,2023-02-17,220.0,30152,1039,31191
210,TSLA  ,2023-02-07,2023-02-17,222.5,313,35,348
211,TSLA  ,2023-02-07,2023-02-17,225.0,8660,418,9078
212,TSLA  ,2023-02-07,2023-02-17,230.0,9010,583,9593
213,TSLA  ,2023-02-07,2023-02-17,235.0,4312,151,4463
214,TSLA  ,2023-02-07,2023-02-17,240.0,6034,60,6094
215,TSLA  ,2023-02-07,2023-02-17,245.0,2040,81,2121
216,TSLA  ,2023-02-07,2023-02-17,250.0,29919,77,29996
217,TSLA  ,2023-02-07,2023-02-17,255.0,9265,22,9287
218,TSLA  ,2023-02-07,2023-02-17,260.0,4842,113,4955
219,TSLA  ,2023-02-07,2023-02-17,265.0,4581,52,4633
220,TSLA  ,2023-02-07,2023-02-17,270.0,6522,47,6569
221,TSLA  ,2023-02-07,2023-02-17,275.0,4975,8,4983
222,TSLA  ,2023-02-07,2023-02-17,280.0,5680,14,5694
223,TSLA  ,2023-02-07,2023-02-17,285.0,3761,0,3761
224,TSLA  ,2023-02-07,2023-02-17,290.0,4945,3,4948
225,TSLA  ,2023-02-07,2023-02-17,295.0,1342,2,1344
226,TSLA  ,2023-02-07,2023-02-17,300.0,6934,12,6946
227,TSLA  ,2023-02-07,2023-02-17,305.0,1492,21,1513
228,TSLA  ,2023-02-07,2023-02-17,310.0,2018,0,2018
229,TSLA  ,2023-02-07,2023-02-17,315.0,1542,0,1542
230,TSLA  ,2023-02-07,2023-02-17,320.0,8465,2,8467
231,TSLA  ,2023-02-07,2023-02-17,325.0,2200,0,2200
232,TSLA  ,2023-02-07,2023-02-17,330.0,1148,0,1148
233,TSLA  ,2023-02-07,2023-02-17,335.0,3629,0,3629
234,TSLA  ,2023-02-07,2023-02-17,340.0,2424,0,2424
235,TSLA  ,2023-02-07,2023-02-17,345.0,2825,0,2825
236,TSLA  ,2023-02-07,2023-02-17,350.0,4016,0,4016
237,TSLA  ,2023-02-07,2023-02-17,355.0,755,0,755
238,TSLA  ,2023-02-07,2023-02-17,360.0,1729,0,1729
239,TSLA  ,2023-02-07,2023-02-17,365.0,1931,0,1931
240,TSLA  ,2023-02-07,2023-02-17,370.0,1356,0,1356
241,TSLA  ,2023-02-07,2023-02-17,375.0,4390,0,4390
242,TSLA  ,2023-02-07,2023-02-17,380.0,1879,0,1879
243,TSLA  ,2023-02-07,2023-02-17,385.0,832,0,832
244,TSLA  ,2023-02-07,2023-02-17,390.0,1205,0,1205
245,TSLA  ,2023-02-07,2023-02-17,395.0,1675,0,1675
246,TSLA  ,2023-02-07,2023-02-17,400.0,4025,0,4025
247,TSLA  ,2023-02-07,2023-02-17,405.0,488,0,488
248,TSLA  ,2023-02-07,2023-02-17,410.0,645,0,645
249,TSLA  ,2023-02-07,2023-02-17,415.0,747,0,747
250,TSLA  ,2023-02-07,2023-02-17,420.0,719,0,719
251,TSLA  ,2023-02-07,2023-02-17,425.0,571,0,571
252,TSLA  ,2023-02-07,2023-02-17,430.0,728,0,728
253,TSLA  ,2023-02-07,2023-02-17,435.0,358,0,358
254,TSLA  ,2023-02-07,2023-02-17,440.0,821,0,821
255,TSLA  ,2023-02-07,2023-02-17,445.0,235,0,235
256,TSLA  ,2023-02-07,2023-02-17,450.0,753,0,753
257,TSLA  ,2023-02-07,2023-02-17,455.0,1725,0,1725
258,TSLA  ,2023-02-07,2023-02-17,460.0,349,0,349
259,TSLA  ,2023-02-07,2023-02-17,465.0,1039,0,1039
260,TSLA  ,2023-02-07,2023-02-17,470.0,1342,0,1342
261,TSLA  ,2023-02-07,2023-02-17,475.0,592,0,592
262,TSLA  ,2023-02-07,2023-02-17,480.0,347,0,347
263,TSLA  ,2023-02-07,2023-02-17,485.0,689,0,689
264,TSLA  ,2023-02-07,2023-02-17,490.0,242,0,242
265,TSLA  ,2023-02-07,2023-02-17,495.0,400,0,400
266,TSLA  ,2023-02-07,2023-02-17,500.0,1970,0,1970
267,TSLA  ,2023-02-07,2023-02-17,505.0,357,0,357
268,TSLA  ,2023-02-07,2023-02-17,510.0,356,0,356
269,TSLA  ,2023-02-07,2023-02-17,515.0,58,0,58
270,TSLA  ,2023-02-07,2023-02-17,520.0,327,0,327
271,TSLA  ,2023-02-07,2023-02-17,525.0,150,0,150
272,TSLA  ,2023-02-07,2023-02-17,530.0,391,0,391
273,TSLA  ,2023-02-07,2023-02-17,535.0,171,0,171
274,TSLA  ,2023-02-07,2023-02-17,540.0,219,0,219
275,TSLA  ,2023-02-07,2023-02-17,545.0,110,0,110
276,TSLA  ,2023-02-07,2023-02-17,550.0,781,0,781
277,TSLA  ,2023-02-07,2023-02-17,555.0,837,0,837
278,TSLA  ,2023-02-07,2023-02-17,560.0,573,0,573
279,TSLA  ,2023-02-07,2023-02-17,565.0,661,0,661
280,TSLA  ,2023-02-07,2023-02-17,570.0,317,0,317
281,TSLA  ,2023-02-07,2023-02-17,575.0,278,0,278
282,TSLA  ,2023-02-07,2023-02-17,580.0,1203,0,1203
283,TSLA  ,2023-02-07,2023-02-17,585.0,955,0,955
284,TSLA  ,2023-02-07,2023-02-17,590.0,297,0,297
285,TSLA  ,2023-02-07,2023-02-17,595.0,2000,0,2000
286,TSLA  ,2023-02-07,2023-02-17,600.0,2670,0,2670
287,TSLA  ,2023-02-07,2023-02-24,15.0,3,8,11
288,TSLA  ,2023-02-07,2023-02-24,20.0,3,1,4
289,TSLA  ,2023-02-07,2023-02-24,25.0,3,3,6
290,TSLA  ,2023-02-07,2023-02-24,30.0,3,748,751
291,TSLA  ,2023-02-07,2023-02-24,35.0,0,20,20
292,TSLA  ,2023-02-07,2023-02-24,40.0,0,439,439
293,TSLA  ,2023-02-07,2023-02-24,45.0,0,2016,2016
294,TSLA  ,2023-02-07,2023-02-24,50.0,0,1898,1898
295,TSLA  ,2023-02-07,2023-02-24,55.0,3,805,808
296,TSLA  ,2023-02-07,2023-02-24,60.0,11,1443,1454
297,TSLA  ,2023-02-07,2023-02-24,65.0,6,654,660
298,TSLA  ,2023-02-07,2023-02-24,70.0,6,520,526
299,TSLA  ,2023-02-07,2023-02-24,75.0,1,823,824
300,TSLA  ,2023-02-07,2023-02-24,80.0,8,922,930
301,TSLA  ,2023-02-07,2023-02-24,85.0,1,636,637
302,TSLA  ,2023-02-07,2023-02-24,90.0,44,1413,1457
303,TSLA  ,2023-02-07,2023-02-24,95.0,19,1811,1830
304,TSLA  ,2023-02-07,2023-02-24,98.0,14,348,362
305,TSLA  ,2023-02-07,2023-02-24,99.0,10,618,628
306,TSLA  ,2023-02-07,2023-02-24,100.0,81,2628,2709
307,TSLA  ,2023-02-07,2023-02-24,101.0,14,336,350
308,TSLA  ,2023-02-07,2023-02-24,102.0,3,243,246
309,TSLA  ,2023-02-07,2023-02-24,103.0,7,125,132
310,TSLA  ,2023-02-07,2023-02-24,104.0,16,326,342
311,TSLA  ,2023-02-07,2023-02-24,105.0,45,1949,1994
312,TSLA  ,2023-02-07,2023-02-24,106.0,17,508,525
313,TSLA  ,2023-02-07,2023-02-24,107.0,8,632,640
314,TSLA  ,2023-02-07,2023-02-24,108.0,9,378,387
315,TSLA  ,2023-02-07,2023-02-24,109.0,9,231,240
316,TSLA  ,2023-02-07,2023-02-24,110.0,317,1411,1728
317,TSLA  ,2023-02-07,2023-02-24,111.0,41,449,490
318,TSLA  ,2023-02-07,2023-02-24,112.0,50,458,508
319,TSLA  ,2023-02-07,2023-02-24,113.0,46,509,555
320,TSLA  ,2023-02-07,2023-02-24,114.0,379,771,1150
321,TSLA  ,2023-02-07,2023-02-24,115.0,381,1115,1496
322,TSLA  ,2023-02-07,2023-02-24,116.0,321,483,804
323,TSLA  ,2023-02-07,2023-02-24,117.0,277,279,556
324,TSLA  ,2023-02-07,2023-02-24,118.0,187,481,668
325,TSLA  ,2023-02-07,2023-02-24,119.0,207,603,810
326,TSLA  ,2023-02-07,2023-02-24,120.0,436,2343,2779
327,TSLA  ,2023-02-07,2023-02-24,121.0,312,835,1147
328,TSLA  ,2023-02-07,2023-02-24,122.0,299,5506,5805
329,TSLA  ,2023-02-07,2023-02-24,123.0,443,541,984
330,TSLA  ,2023-02-07,2023-02-24,124.0,157,256,413
331,TSLA  ,2023-02-07,2023-02-24,125.0,523,2341,2864
332,TSLA  ,2023-02-07,2023-02-24,126.0,169,474,643
333,TSLA  ,2023-02-07,2023-02-24,127.0,83,391,474
334,TSLA  ,2023-02-07,2023-02-24,128.0,215,649,864
335,TSLA  ,2023-02-07,2023-02-24,129.0,237,971,1208
336,TSLA  ,2023-02-07,2023-02-24,130.0,2602,2543,5145
337,TSLA  ,2023-02-07,2023-02-24,131.0,408,141,549
338,TSLA  ,2023-02-07,2023-02-24,132.0,262,769,1031
339,TSLA  ,2023-02-07,2023-02-24,133.0,143,404,547
340,TSLA  ,2023-02-07,2023-02-24,134.0,275,676,951
341,TSLA  ,2023-02-07,2023-02-24,135.0,1926,1497,3423
342,TSLA  ,2023-02-07,2023-02-24,136.0,85,445,530
343,TSLA  ,2023-02-07,2023-02-24,137.0,65,335,400
344,TSLA  ,2023-02-07,2023-02-24,138.0,67,461,528
345,TSLA  ,2023-02-07,2023-02-24,139.0,477,250,727
346,TSLA  ,2023-02-07,2023-02-24,140.0,1715,1943,3658
347,TSLA  ,2023-02-07,2023-02-24,141.0,360,387,747
348,TSLA  ,2023-02-07,2023-02-24,142.0,400,630,1030
349,TSLA  ,2023-02-07,2023-02-24,143.0,79,236,315
350,TSLA  ,2023-02-07,2023-02-24,144.0,49,243,292
351,TSLA  ,2023-02-07,2023-02-24,145.0,1619,4019,5638
352,TSLA  ,2023-02-07,2023-02-24,146.0,26,488,514
353,TSLA  ,2023-02-07,2023-02-24,147.0,38,287,325
354,TSLA  ,2023-02-07,2023-02-24,148.0,133,190,323
355,TSLA  ,2023-02-07,2023-02-24,149.0,96,1043,1139
356,TSLA  ,2023-02-07,2023-02-24,150.0,2548,4024,6572
357,TSLA  ,2023-02-07,2023-02-24,152.5,93,1218,1311
358,TSLA  ,2023-02-07,2023-02-24,155.0,1635,5231,6866
359,TSLA  ,2023-02-07,2023-02-24,157.5,673,497,1170
360,TSLA  ,2023-02-07,2023-02-24,160.0,2933,2514,5447
361,TSLA  ,2023-02-07,2023-02-24,162.5,410,405,815
362,TSLA  ,2023-02-07,2023-02-24,165.0,2464,1242,3706
363,TSLA  ,2023-02-07,2023-02-24,167.5,972,1010,1982
364,TSLA  ,2023-02-07,2023-02-24,170.0,2727,2090,4817
365,TSLA  ,2023-02-07,2023-02-24,172.5,586,340,926
366,TSLA  ,2023-02-07,2023-02-24,175.0,2715,1381,4096
367,TSLA  ,2023-02-07,2023-02-24,177.5,393,2294,2687
368,TSLA  ,2023-02-07,2023-02-24,180.0,2821,1954,4775
369,TSLA  ,2023-02-07,2023-02-24,182.5,467,520,987
370,TSLA  ,2023-02-07,2023-02-24,185.0,1283,1687,2970
371,TSLA  ,2023-02-07,2023-02-24,187.5,734,922,1656
372,TSLA  ,2023-02-07,2023-02-24,190.0,1350,2001,3351
373,TSLA  ,2023-02-07,2023-02-24,192.5,983,963,1946
374,TSLA  ,2023-02-07,2023-02-24,195.0,1835,927,2762
375,TSLA  ,2023-02-07,2023-02-24,197.5,1230,763,1993
376,TSLA  ,2023-02-07,2023-02-24,200.0,6885,842,7727
377,TSLA  ,2023-02-07,2023-02-24,202.5,249,222,471
378,TSLA  ,2023-02-07,2023-02-24,205.0,1976,268,2244
379,TSLA  ,2023-02-07,2023-02-24,207.5,315,169,484
380,TSLA  ,2023-02-07,2023-02-24,210.0,4089,126,4215
381,TSLA  ,2023-02-07,2023-02-24,212.5,260,40,300
382,TSLA  ,2023-02-07,2023-02-24,215.0,1074,44,1118
383,TSLA  ,2023-02-07,2023-02-24,217.5,183,33,216
384,TSLA  ,2023-02-07,2023-02-24,220.0,2207,43,2250
385,TSLA  ,2023-02-07,2023-02-24,222.5,187,5,192
386,TSLA  ,2023-02-07,2023-02-24,225.0,2911,31,2942
387,TSLA  ,2023-02-07,2023-02-24,230.0,2504,34,2538
388,TSLA  ,2023-02-07,2023-02-24,235.0,1282,24,1306
389,TSLA  ,2023-02-07,2023-02-24,240.0,4045,9,4054
390,TSLA  ,2023-02-07,2023-02-24,245.0,1618,6,1624
391,TSLA  ,2023-02-07,2023-02-24,250.0,2255,28,2283
392,TSLA  ,2023-02-07,2023-02-24,255.0,556,0,556
393,TSLA  ,2023-02-07,2023-02-24,260.0,1193,2,1195
394,TSLA  ,2023-02-07,2023-02-24,265.0,386,1,387
395,TSLA  ,2023-02-07,2023-02-24,270.0,510,0,510
396,TSLA  ,2023-02-07,2023-02-24,275.0,1224,3,1227
397,TSLA  ,2023-02-07,2023-02-24,280.0,965,0,965
398,TSLA  ,2023-02-07,2023-02-24,285.0,447,0,447
399,TSLA  ,2023-02-07,2023-02-24,290.0,970,0,970
400,TSLA  ,2023-02-07,2023-02-24,295.0,236,0,236
401,TSLA  ,2023-02-07,2023-02-24,300.0,784,0,784
402,TSLA  ,2023-02-07,2023-02-24,310.0,1950,0,1950
403,TSLA  ,2023-02-07,2023-02-24,320.0,595,0,595
404,TSLA  ,2023-02-07,2023-02-24,330.0,402,0,402
405,TSLA  ,2023-02-07,2023-02-24,340.0,200,0,200
406,TSLA  ,2023-02-07,2023-02-24,350.0,1086,0,1086
407,TSLA  ,2023-02-07,2023-02-24,360.0,1668,0,1668
408,TSLA  ,2023-02-07,2023-03-03,15.0,8,256,264
409,TSLA  ,2023-02-07,2023-03-03,20.0,1,0,1
410,TSLA  ,2023-02-07,2023-03-03,25.0,1,47,48
411,TSLA  ,2023-02-07,2023-03-03,30.0,3,340,343
412,TSLA  ,2023-02-07,2023-03-03,35.0,3,1,4
413,TSLA  ,2023-02-07,2023-03-03,40.0,0,10,10
414,TSLA  ,2023-02-07,2023-03-03,45.0,0,2422,2422
415,TSLA  ,2023-02-07,2023-03-03,50.0,1,886,887
416,TSLA  ,2023-02-07,2023-03-03,55.0,0,154,154
417,TSLA  ,2023-02-07,2023-03-03,60.0,5,1112,1117
418,TSLA  ,2023-02-07,2023-03-03,65.0,1,52,53
419,TSLA  ,2023-02-07,2023-03-03,70.0,2,437,439
420,TSLA  ,2023-02-07,2023-03-03,75.0,0,255,255
421,TSLA  ,2023-02-07,2023-03-03,80.0,112,785,897
422,TSLA  ,2023-02-07,2023-03-03,85.0,4,517,521
423,TSLA  ,2023-02-07,2023-03-03,90.0,7,1008,1015
424,TSLA  ,2023-02-07,2023-03-03,95.0,7,1782,1789
425,TSLA  ,2023-02-07,2023-03-03,100.0,39,1841,1880
426,TSLA  ,2023-02-07,2023-03-03,105.0,16,631,647
427,TSLA  ,2023-02-07,2023-03-03,108.0,59,489,548
428,TSLA  ,2023-02-07,2023-03-03,109.0,34,359,393
429,TSLA  ,2023-02-07,2023-03-03,110.0,96,2935,3031
430,TSLA  ,2023-02-07,2023-03-03,111.0,7,556,563
431,TSLA  ,2023-02-07,2023-03-03,112.0,36,696,732
432,TSLA  ,2023-02-07,2023-03-03,113.0,28,556,584
433,TSLA  ,2023-02-07,2023-03-03,114.0,155,450,605
434,TSLA  ,2023-02-07,2023-03-03,115.0,168,826,994
435,TSLA  ,2023-02-07,2023-03-03,116.0,158,377,535
436,TSLA  ,2023-02-07,2023-03-03,117.0,474,721,1195
437,TSLA  ,2023-02-07,2023-03-03,118.0,302,280,582
438,TSLA  ,2023-02-07,2023-03-03,119.0,309,503,812
439,TSLA  ,2023-02-07,2023-03-03,120.0,816,1587,2403
440,TSLA  ,2023-02-07,2023-03-03,121.0,119,499,618
441,TSLA  ,2023-02-07,2023-03-03,122.0,117,905,1022
442,TSLA  ,2023-02-07,2023-03-03,123.0,263,612,875
443,TSLA  ,2023-02-07,2023-03-03,124.0,451,432,883
444,TSLA  ,2023-02-07,2023-03-03,125.0,284,709,993
445,TSLA  ,2023-02-07,2023-03-03,126.0,670,376,1046
446,TSLA  ,2023-02-07,2023-03-03,127.0,426,247,673
447,TSLA  ,2023-02-07,2023-03-03,128.0,455,912,1367
448,TSLA  ,2023-02-07,2023-03-03,129.0,646,544,1190
449,TSLA  ,2023-02-07,2023-03-03,130.0,682,1479,2161
450,TSLA  ,2023-02-07,2023-03-03,131.0,304,738,1042
451,TSLA  ,2023-02-07,2023-03-03,132.0,818,443,1261
452,TSLA  ,2023-02-07,2023-03-03,133.0,538,109,647
453,TSLA  ,2023-02-07,2023-03-03,134.0,567,1235,1802
454,TSLA  ,2023-02-07,2023-03-03,135.0,883,1067,1950
455,TSLA  ,2023-02-07,2023-03-03,136.0,92,71,163
456,TSLA  ,2023-02-07,2023-03-03,137.0,64,91,155
457,TSLA  ,2023-02-07,2023-03-03,138.0,151,281,432
458,TSLA  ,2023-02-07,2023-03-03,139.0,111,175,286
459,TSLA  ,2023-02-07,2023-03-03,140.0,609,1244,1853
460,TSLA  ,2023-02-07,2023-03-03,141.0,68,100,168
461,TSLA  ,2023-02-07,2023-03-03,142.0,295,157,452
462,TSLA  ,2023-02-07,2023-03-03,143.0,12,23,35
463,TSLA  ,2023-02-07,2023-03-03,144.0,21,67,88
464,TSLA  ,2023-02-07,2023-03-03,145.0,681,3425,4106
465,TSLA  ,2023-02-07,2023-03-03,146.0,26,556,582
466,TSLA  ,2023-02-07,2023-03-03,147.0,39,194,233
467,TSLA  ,2023-02-07,2023-03-03,148.0,16,352,368
468,TSLA  ,2023-02-07,2023-03-03,149.0,255,1660,1915
469,TSLA  ,2023-02-07,2023-03-03,150.0,1012,3859,4871
470,TSLA  ,2023-02-07,2023-03-03,152.5,155,830,985
471,TSLA  ,2023-02-07,2023-03-03,155.0,1218,994,2212
472,TSLA  ,2023-02-07,2023-03-03,157.5,123,298,421
473,TSLA  ,2023-02-07,2023-03-03,160.0,1019,3864,4883
474,TSLA  ,2023-02-07,2023-03-03,162.5,228,4008,4236
475,TSLA  ,2023-02-07,2023-03-03,165.0,1836,906,2742
476,TSLA  ,2023-02-07,2023-03-03,167.5,248,339,587
477,TSLA  ,2023-02-07,2023-03-03,170.0,2422,3219,5641
478,TSLA  ,2023-02-07,2023-03-03,172.5,1197,757,1954
479,TSLA  ,2023-02-07,2023-03-03,175.0,1036,730,1766
480,TSLA  ,2023-02-07,2023-03-03,177.5,421,303,724
481,TSLA  ,2023-02-07,2023-03-03,180.0,1975,1850,3825
482,TSLA  ,2023-02-07,2023-03-03,182.5,312,512,824
483,TSLA  ,2023-02-07,2023-03-03,185.0,1250,761,2011
484,TSLA  ,2023-02-07,2023-03-03,187.5,1274,362,1636
485,TSLA  ,2023-02-07,2023-03-03,190.0,2120,940,3060
486,TSLA  ,2023-02-07,2023-03-03,192.5,600,572,1172
487,TSLA  ,2023-02-07,2023-03-03,195.0,1661,703,2364
488,TSLA  ,2023-02-07,2023-03-03,197.5,1701,318,2019
489,TSLA  ,2023-02-07,2023-03-03,200.0,5438,1084,6522
490,TSLA  ,2023-02-07,2023-03-03,202.5,234,831,1065
491,TSLA  ,2023-02-07,2023-03-03,205.0,2485,104,2589
492,TSLA  ,2023-02-07,2023-03-03,207.5,77,6,83
493,TSLA  ,2023-02-07,2023-03-03,210.0,2062,49,2111
494,TSLA  ,2023-02-07,2023-03-03,212.5,230,3,233
495,TSLA  ,2023-02-07,2023-03-03,215.0,3127,26,3153
496,TSLA  ,2023-02-07,2023-03-03,217.5,371,33,404
497,TSLA  ,2023-02-07,2023-03-03,220.0,2417,94,2511
498,TSLA  ,2023-02-07,2023-03-03,222.5,70,5,75
499,TSLA  ,2023-02-07,2023-03-03,225.0,1283,52,1335
500,TSLA  ,2023-02-07,2023-03-03,230.0,1501,94,1595
501,TSLA  ,2023-02-07,2023-03-03,235.0,1241,1,1242
502,TSLA  ,2023-02-07,2023-03-03,240.0,2642,36,2678
503,TSLA  ,2023-02-07,2023-03-03,245.0,2044,12,2056
504,TSLA  ,2023-02-07,2023-03-03,250.0,2266,6,2272
505,TSLA  ,2023-02-07,2023-03-03,255.0,651,0,651
506,TSLA  ,2023-02-07,2023-03-03,260.0,519,0,519
507,TSLA  ,2023-02-07,2023-03-03,265.0,498,0,498
508,TSLA  ,2023-02-07,2023-03-03,270.0,529,0,529
509,TSLA  ,2023-02-07,2023-03-03,275.0,476,1,477
510,TSLA  ,2023-02-07,2023-03-03,280.0,944,0,944
511,TSLA  ,2023-02-07,2023-03-03,285.0,344,0,344
512,TSLA  ,2023-02-07,2023-03-03,290.0,1055,1,1056
513,TSLA  ,2023-02-07,2023-03-03,295.0,88,0,88
514,TSLA  ,2023-02-07,2023-03-03,300.0,1812,4,1816
515,TSLA  ,2023-02-07,2023-03-03,310.0,286,0,286
516,TSLA  ,2023-02-07,2023-03-03,320.0,282,5,287
517,TSLA  ,2023-02-07,2023-03-03,330.0,114,0,114
518,TSLA  ,2023-02-07,2023-03-03,340.0,347,0,347
519,TSLA  ,2023-02-07,2023-03-03,350.0,423,1,424
520,TSLA  ,2023-02-07,2023-03-03,360.0,835,0,835
521,TSLA  ,2023-02-07,2023-03-10,15.0,3,36,39
522,TSLA  ,2023-02-07,2023-03-10,20.0,0,0,0
523,TSLA  ,2023-02-07,2023-03-10,25.0,0,0,0
524,TSLA  ,2023-02-07,2023-03-10,30.0,0,0,0
525,TSLA  ,2023-02-07,2023-03-10,35.0,0,0,0
526,TSLA  ,2023-02-07,2023-03-10,40.0,0,0,0
527,TSLA  ,2023-02-07,2023-03-10,45.0,0,0,0
528,TSLA  ,2023-02-07,2023-03-10,50.0,5,17,22
529,TSLA  ,2023-02-07,2023-03-10,55.0,0,1200,1200
530,TSLA  ,2023-02-07,2023-03-10,60.0,0,12,12
531,TSLA  ,2023-02-07,2023-03-10,65.0,0,10,10
532,TSLA  ,2023-02-07,2023-03-10,70.0,0,25,25
533,TSLA  ,2023-02-07,2023-03-10,75.0,0,419,419
534,TSLA  ,2023-02-07,2023-03-10,80.0,0,63,63
535,TSLA  ,2023-02-07,2023-03-10,85.0,0,41,41
536,TSLA  ,2023-02-07,2023-03-10,90.0,0,41,41
537,TSLA  ,2023-02-07,2023-03-10,95.0,1,65,66
538,TSLA  ,2023-02-07,2023-03-10,100.0,0,474,474
539,TSLA  ,2023-02-07,2023-03-10,105.0,4,206,210
540,TSLA  ,2023-02-07,2023-03-10,110.0,16,610,626
541,TSLA  ,2023-02-07,2023-03-10,115.0,4,237,241
542,TSLA  ,2023-02-07,2023-03-10,120.0,2,166,168
543,TSLA  ,2023-02-07,2023-03-10,125.0,15,238,253
544,TSLA  ,2023-02-07,2023-03-10,130.0,40,217,257
545,TSLA  ,2023-02-07,2023-03-10,134.0,6,124,130
546,TSLA  ,2023-02-07,2023-03-10,135.0,33,514,547
547,TSLA  ,2023-02-07,2023-03-10,136.0,10,42,52
548,TSLA  ,2023-02-07,2023-03-10,137.0,7,77,84
549,TSLA  ,2023-02-07,2023-03-10,138.0,10,98,108
550,TSLA  ,2023-02-07,2023-03-10,139.0,3,90,93
551,TSLA  ,2023-02-07,2023-03-10,140.0,41,583,624
552,TSLA  ,2023-02-07,2023-03-10,141.0,140,17,157
553,TSLA  ,2023-02-07,2023-03-10,142.0,9,215,224
554,TSLA  ,2023-02-07,2023-03-10,143.0,4,186,190
555,TSLA  ,2023-02-07,2023-03-10,144.0,3,50,53
556,TSLA  ,2023-02-07,2023-03-10,145.0,101,132,233
557,TSLA  ,2023-02-07,2023-03-10,146.0,19,19,38
558,TSLA  ,2023-02-07,2023-03-10,147.0,77,111,188
559,TSLA  ,2023-02-07,2023-03-10,148.0,84,742,826
560,TSLA  ,2023-02-07,2023-03-10,149.0,3,193,196
561,TSLA  ,2023-02-07,2023-03-10,150.0,240,599,839
562,TSLA  ,2023-02-07,2023-03-10,152.5,84,140,224
563,TSLA  ,2023-02-07,2023-03-10,155.0,258,362,620
564,TSLA  ,2023-02-07,2023-03-10,157.5,51,340,391
565,TSLA  ,2023-02-07,2023-03-10,160.0,195,568,763
566,TSLA  ,2023-02-07,2023-03-10,162.5,89,140,229
567,TSLA  ,2023-02-07,2023-03-10,165.0,303,572,875
568,TSLA  ,2023-02-07,2023-03-10,167.5,173,156,329
569,TSLA  ,2023-02-07,2023-03-10,170.0,380,1155,1535
570,TSLA  ,2023-02-07,2023-03-10,172.5,191,140,331
571,TSLA  ,2023-02-07,2023-03-10,175.0,445,694,1139
572,TSLA  ,2023-02-07,2023-03-10,177.5,1793,125,1918
573,TSLA  ,2023-02-07,2023-03-10,180.0,610,871,1481
574,TSLA  ,2023-02-07,2023-03-10,182.5,149,82,231
575,TSLA  ,2023-02-07,2023-03-10,185.0,257,540,797
576,TSLA  ,2023-02-07,2023-03-10,187.5,1029,105,1134
577,TSLA  ,2023-02-07,2023-03-10,190.0,1089,530,1619
578,TSLA  ,2023-02-07,2023-03-10,192.5,279,176,455
579,TSLA  ,2023-02-07,2023-03-10,195.0,692,315,1007
580,TSLA  ,2023-02-07,2023-03-10,197.5,308,435,743
581,TSLA  ,2023-02-07,2023-03-10,200.0,1563,253,1816
582,TSLA  ,2023-02-07,2023-03-10,202.5,77,69,146
583,TSLA  ,2023-02-07,2023-03-10,205.0,655,247,902
584,TSLA  ,2023-02-07,2023-03-10,207.5,26,10,36
585,TSLA  ,2023-02-07,2023-03-10,210.0,893,84,977
586,TSLA  ,2023-02-07,2023-03-10,212.5,40,37,77
587,TSLA  ,2023-02-07,2023-03-10,215.0,193,3,196
588,TSLA  ,2023-02-07,2023-03-10,217.5,67,1,68
589,TSLA  ,2023-02-07,2023-03-10,220.0,475,9,484
590,TSLA  ,2023-02-07,2023-03-10,222.5,141,1,142
591,TSLA  ,2023-02-07,2023-03-10,225.0,490,112,602
592,TSLA  ,2023-02-07,2023-03-10,230.0,197,0,197
593,TSLA  ,2023-02-07,2023-03-10,235.0,323,2,325
594,TSLA  ,2023-02-07,2023-03-10,240.0,692,11,703
595,TSLA  ,2023-02-07,2023-03-10,245.0,261,43,304
596,TSLA  ,2023-02-07,2023-03-10,250.0,1012,0,1012
597,TSLA  ,2023-02-07,2023-03-10,255.0,216,0,216
598,TSLA  ,2023-02-07,2023-03-10,260.0,191,0,191
599,TSLA  ,2023-02-07,2023-03-10,265.0,122,0,122
600,TSLA  ,2023-02-07,2023-03-10,270.0,234,0,234
601,TSLA  ,2023-02-07,2023-03-10,275.0,168,0,168
602,TSLA  ,2023-02-07,2023-03-10,280.0,537,5,542
603,TSLA  ,2023-02-07,2023-03-10,285.0,211,0,211
604,TSLA  ,2023-02-07,2023-03-10,290.0,134,3,137
605,TSLA  ,2023-02-07,2023-03-10,295.0,193,0,193
606,TSLA  ,2023-02-07,2023-03-10,300.0,386,0,386
607,TSLA  ,2023-02-07,2023-03-10,310.0,109,5,114
608,TSLA  ,2023-02-07,2023-03-10,320.0,223,0,223
609,TSLA  ,2023-02-07,2023-03-10,330.0,40,0,40
610,TSLA  ,2023-02-07,2023-03-10,340.0,227,0,227
611,TSLA  ,2023-02-07,2023-03-10,350.0,155,0,155
612,TSLA  ,2023-02-07,2023-03-10,360.0,360,0,360
613,TSLA  ,2023-02-07,2023-03-17,1.67,103,24718,24821
614,TSLA  ,2023-02-07,2023-03-17,3.33,29,6941,6970
615,TSLA  ,2023-02-07,2023-03-17,5.0,2,8008,8010
616,TSLA  ,2023-02-07,2023-03-17,6.67,52,4669,4721
617,TSLA  ,2023-02-07,2023-03-17,8.33,15,1379,1394
618,TSLA  ,2023-02-07,2023-03-17,10.0,842,4105,4947
619,TSLA  ,2023-02-07,2023-03-17,11.67,1711,5414,7125
620,TSLA  ,2023-02-07,2023-03-17,13.33,1657,2125,3782
621,TSLA  ,2023-02-07,2023-03-17,15.0,987,5169,6156
622,TSLA  ,2023-02-07,2023-03-17,16.67,881,15329,16210
623,TSLA  ,2023-02-07,2023-03-17,18.33,467,12018,12485
624,TSLA  ,2023-02-07,2023-03-17,33.33,406,33451,33857
625,TSLA  ,2023-02-07,2023-03-17,50.0,492,21204,21696
626,TSLA  ,2023-02-07,2023-03-17,55.0,33,4650,4683
627,TSLA  ,2023-02-07,2023-03-17,60.0,198,6151,6349
628,TSLA  ,2023-02-07,2023-03-17,65.0,25,2454,2479
629,TSLA  ,2023-02-07,2023-03-17,66.67,903,17863,18766
630,TSLA  ,2023-02-07,2023-03-17,70.0,50,7467,7517
631,TSLA  ,2023-02-07,2023-03-17,75.0,54,5279,5333
632,TSLA  ,2023-02-07,2023-03-17,80.0,212,11989,12201
633,TSLA  ,2023-02-07,2023-03-17,83.33,887,5326,6213
634,TSLA  ,2023-02-07,2023-03-17,85.0,89,3301,3390
635,TSLA  ,2023-02-07,2023-03-17,90.0,665,15923,16588
636,TSLA  ,2023-02-07,2023-03-17,95.0,335,4081,4416
637,TSLA  ,2023-02-07,2023-03-17,100.0,1801,29929,31730
638,TSLA  ,2023-02-07,2023-03-17,105.0,1405,4533,5938
639,TSLA  ,2023-02-07,2023-03-17,110.0,3088,13233,16321
640,TSLA  ,2023-02-07,2023-03-17,115.0,3396,8865,12261
641,TSLA  ,2023-02-07,2023-03-17,116.67,1396,11220,12616
642,TSLA  ,2023-02-07,2023-03-17,120.0,12349,17131,29480
643,TSLA  ,2023-02-07,2023-03-17,123.33,2741,6323,9064
644,TSLA  ,2023-02-07,2023-03-17,125.0,3579,8946,12525
645,TSLA  ,2023-02-07,2023-03-17,126.67,1685,4537,6222
646,TSLA  ,2023-02-07,2023-03-17,130.0,7616,12180,19796
647,TSLA  ,2023-02-07,2023-03-17,133.33,3449,9557,13006
648,TSLA  ,2023-02-07,2023-03-17,135.0,27817,34020,61837
649,TSLA  ,2023-02-07,2023-03-17,136.67,2896,3592,6488
650,TSLA  ,2023-02-07,2023-03-17,140.0,7280,28240,35520
651,TSLA  ,2023-02-07,2023-03-17,143.33,2472,4872,7344
652,TSLA  ,2023-02-07,2023-03-17,145.0,2795,8285,11080
653,TSLA  ,2023-02-07,2023-03-17,146.67,1894,4386,6280
654,TSLA  ,2023-02-07,2023-03-17,150.0,13998,21308,35306
655,TSLA  ,2023-02-07,2023-03-17,153.33,1691,2880,4571
656,TSLA  ,2023-02-07,2023-03-17,155.0,3706,5636,9342
657,TSLA  ,2023-02-07,2023-03-17,156.67,2344,3287,5631
658,TSLA  ,2023-02-07,2023-03-17,160.0,7663,21951,29614
659,TSLA  ,2023-02-07,2023-03-17,163.33,3069,4931,8000
660,TSLA  ,2023-02-07,2023-03-17,165.0,7060,5081,12141
661,TSLA  ,2023-02-07,2023-03-17,166.67,6364,11509,17873
662,TSLA  ,2023-02-07,2023-03-17,170.0,11637,20790,32427
663,TSLA  ,2023-02-07,2023-03-17,173.33,3112,10894,14006
664,TSLA  ,2023-02-07,2023-03-17,175.0,4804,4327,9131
665,TSLA  ,2023-02-07,2023-03-17,176.67,5279,2661,7940
666,TSLA  ,2023-02-07,2023-03-17,180.0,20288,15546,35834
667,TSLA  ,2023-02-07,2023-03-17,183.33,3358,7830,11188
668,TSLA  ,2023-02-07,2023-03-17,185.0,3465,3473,6938
669,TSLA  ,2023-02-07,2023-03-17,186.67,2652,3987,6639
670,TSLA  ,2023-02-07,2023-03-17,190.0,12313,10755,23068
671,TSLA  ,2023-02-07,2023-03-17,193.33,2317,2256,4573
672,TSLA  ,2023-02-07,2023-03-17,195.0,4222,2906,7128
673,TSLA  ,2023-02-07,2023-03-17,196.67,2368,1468,3836
674,TSLA  ,2023-02-07,2023-03-17,198.33,3081,2044,5125
675,TSLA  ,2023-02-07,2023-03-17,200.0,44749,32778,77527
676,TSLA  ,2023-02-07,2023-03-17,201.67,1380,1138,2518
677,TSLA  ,2023-02-07,2023-03-17,203.33,1752,972,2724
678,TSLA  ,2023-02-07,2023-03-17,205.0,4011,463,4474
679,TSLA  ,2023-02-07,2023-03-17,206.67,1107,1848,2955
680,TSLA  ,2023-02-07,2023-03-17,208.33,2140,604,2744
681,TSLA  ,2023-02-07,2023-03-17,210.0,8675,1201,9876
682,TSLA  ,2023-02-07,2023-03-17,211.67,1143,497,1640
683,TSLA  ,2023-02-07,2023-03-17,213.33,944,474,1418
684,TSLA  ,2023-02-07,2023-03-17,215.0,9108,527,9635
685,TSLA  ,2023-02-07,2023-03-17,216.67,4665,2780,7445
686,TSLA  ,2023-02-07,2023-03-17,218.33,821,98,919
687,TSLA  ,2023-02-07,2023-03-17,220.0,10751,755,11506
688,TSLA  ,2023-02-07,2023-03-17,221.67,1346,117,1463
689,TSLA  ,2023-02-07,2023-03-17,223.33,1028,103,1131
690,TSLA  ,2023-02-07,2023-03-17,225.0,4988,679,5667
691,TSLA  ,2023-02-07,2023-03-17,226.67,1789,158,1947
692,TSLA  ,2023-02-07,2023-03-17,228.33,5109,21,5130
693,TSLA  ,2023-02-07,2023-03-17,230.0,5557,629,6186
694,TSLA  ,2023-02-07,2023-03-17,231.67,1374,50,1424
695,TSLA  ,2023-02-07,2023-03-17,233.33,6790,418,7208
696,TSLA  ,2023-02-07,2023-03-17,235.0,6732,97,6829
697,TSLA  ,2023-02-07,2023-03-17,236.67,1010,55,1065
698,TSLA  ,2023-02-07,2023-03-17,238.33,923,61,984
699,TSLA  ,2023-02-07,2023-03-17,240.0,4986,235,5221
700,TSLA  ,2023-02-07,2023-03-17,241.67,892,40,932
701,TSLA  ,2023-02-07,2023-03-17,243.33,1382,85,1467
702,TSLA  ,2023-02-07,2023-03-17,245.0,1808,27,1835
703,TSLA  ,2023-02-07,2023-03-17,246.67,932,36,968
704,TSLA  ,2023-02-07,2023-03-17,248.33,1062,34,1096
705,TSLA  ,2023-02-07,2023-03-17,250.0,16652,580,17232
706,TSLA  ,2023-02-07,2023-03-17,251.67,1228,76,1304
707,TSLA  ,2023-02-07,2023-03-17,253.33,571,34,605
708,TSLA  ,2023-02-07,2023-03-17,255.0,2915,67,2982
709,TSLA  ,2023-02-07,2023-03-17,256.67,667,24,691
710,TSLA  ,2023-02-07,2023-03-17,258.33,794,25,819
711,TSLA  ,2023-02-07,2023-03-17,260.0,5681,50,5731
712,TSLA  ,2023-02-07,2023-03-17,261.67,1268,13,1281
713,TSLA  ,2023-02-07,2023-03-17,263.33,882,57,939
714,TSLA  ,2023-02-07,2023-03-17,265.0,1044,16,1060
715,TSLA  ,2023-02-07,2023-03-17,266.67,9886,374,10260
716,TSLA  ,2023-02-07,2023-03-17,270.0,3893,31,3924
717,TSLA  ,2023-02-07,2023-03-17,273.33,3848,80,3928
718,TSLA  ,2023-02-07,2023-03-17,275.0,235,9,244
719,TSLA  ,2023-02-07,2023-03-17,276.67,1415,39,1454
720,TSLA  ,2023-02-07,2023-03-17,280.0,2564,138,2702
721,TSLA  ,2023-02-07,2023-03-17,283.33,7321,54,7375
722,TSLA  ,2023-02-07,2023-03-17,285.0,109,0,109
723,TSLA  ,2023-02-07,2023-03-17,286.67,1839,17,1856
724,TSLA  ,2023-02-07,2023-03-17,290.0,3113,69,3182
725,TSLA  ,2023-02-07,2023-03-17,293.33,7179,342,7521
726,TSLA  ,2023-02-07,2023-03-17,295.0,2016,11,2027
727,TSLA  ,2023-02-07,2023-03-17,296.67,948,16,964
728,TSLA  ,2023-02-07,2023-03-17,298.33,1123,2,1125
729,TSLA  ,2023-02-07,2023-03-17,300.0,71238,450,71688
730,TSLA  ,2023-02-07,2023-03-17,301.67,1476,17,1493
731,TSLA  ,2023-02-07,2023-03-17,303.33,1307,3,1310
732,TSLA  ,2023-02-07,2023-03-17,305.0,2826,8,2834
733,TSLA  ,2023-02-07,2023-03-17,306.67,1934,3,1937
734,TSLA  ,2023-02-07,2023-03-17,308.33,4183,2,4185
735,TSLA  ,2023-02-07,2023-03-17,310.0,4812,15,4827
736,TSLA  ,2023-02-07,2023-03-17,311.67,2038,5,2043
737,TSLA  ,2023-02-07,2023-03-17,313.33,3775,0,3775
738,TSLA  ,2023-02-07,2023-03-17,316.67,29725,11,29736
739,TSLA  ,2023-02-07,2023-03-17,320.0,14789,202,14991
740,TSLA  ,2023-02-07,2023-03-17,323.33,399,0,399
741,TSLA  ,2023-02-07,2023-03-17,326.67,537,0,537
742,TSLA  ,2023-02-07,2023-03-17,330.0,3314,6,3320
743,TSLA  ,2023-02-07,2023-03-17,333.33,20564,27,20591
744,TSLA  ,2023-02-07,2023-03-17,336.67,824,0,824
745,TSLA  ,2023-02-07,2023-03-17,340.0,5272,0,5272
746,TSLA  ,2023-02-07,2023-03-17,343.33,1905,0,1905
747,TSLA  ,2023-02-07,2023-03-17,346.67,704,0,704
748,TSLA  ,2023-02-07,2023-03-17,350.0,10856,212,11068
749,TSLA  ,2023-02-07,2023-03-17,353.33,614,0,614
750,TSLA  ,2023-02-07,2023-03-17,356.67,573,0,573
751,TSLA  ,2023-02-07,2023-03-17,360.0,2164,0,2164
752,TSLA  ,2023-02-07,2023-03-17,363.33,572,0,572
753,TSLA  ,2023-02-07,2023-03-17,366.67,7822,5,7827
754,TSLA  ,2023-02-07,2023-03-17,370.0,1883,0,1883
755,TSLA  ,2023-02-07,2023-03-17,373.33,687,0,687
756,TSLA  ,2023-02-07,2023-03-17,383.33,12583,0,12583
757,TSLA  ,2023-02-07,2023-03-17,400.0,26668,0,26668
758,TSLA  ,2023-02-07,2023-03-17,416.67,13104,0,13104
759,TSLA  ,2023-02-07,2023-03-17,433.33,19409,0,19409
760,TSLA  ,2023-02-07,2023-03-17,441.67,2055,0,2055
761,TSLA  ,2023-02-07,2023-03-17,450.0,5538,0,5538
762,TSLA  ,2023-02-07,2023-03-17,458.33,2454,0,2454
763,TSLA  ,2023-02-07,2023-03-17,466.67,3806,4,3810
764,TSLA  ,2023-02-07,2023-03-17,475.0,3797,0,3797
765,TSLA  ,2023-02-07,2023-03-17,483.33,1850,0,1850
766,TSLA  ,2023-02-07,2023-03-17,491.67,2607,0,2607
767,TSLA  ,2023-02-07,2023-03-17,500.0,12499,6,12505
768,TSLA  ,2023-02-07,2023-03-17,508.33,1690,0,1690
769,TSLA  ,2023-02-07,2023-03-17,516.67,1054,0,1054
770,TSLA  ,2023-02-07,2023-03-17,525.0,4641,0,4641
771,TSLA  ,2023-02-07,2023-03-17,533.33,4761,0,4761
772,TSLA  ,2023-02-07,2023-03-17,541.67,1032,0,1032
773,TSLA  ,2023-02-07,2023-03-17,550.0,4879,0,4879
774,TSLA  ,2023-02-07,2023-03-17,558.33,3782,0,3782
775,TSLA  ,2023-02-07,2023-03-17,566.67,7761,0,7761
776,TSLA  ,2023-02-07,2023-03-17,575.0,11824,0,11824
777,TSLA  ,2023-02-07,2023-03-17,583.33,2634,0,2634
778,TSLA  ,2023-02-07,2023-03-17,591.67,1270,0,1270
779,TSLA  ,2023-02-07,2023-03-17,600.0,5008,0,5008
780,TSLA  ,2023-02-07,2023-03-17,608.33,530,0,530
781,TSLA  ,2023-02-07,2023-03-17,616.67,3979,0,3979
782,TSLA  ,2023-02-07,2023-03-17,625.0,941,100,1041
783,TSLA  ,2023-02-07,2023-03-17,633.33,2346,0,2346
784,TSLA  ,2023-02-07,2023-03-17,641.67,1446,0,1446
785,TSLA  ,2023-02-07,2023-03-17,650.0,8237,0,8237
786,TSLA  ,2023-02-07,2023-03-17,666.67,70149,0,70149
787,TSLA  ,2023-02-07,2023-03-17,675.0,21510,0,21510
788,TSLA  ,2023-02-07,2023-03-17,683.33,3629,0,3629
789,TSLA  ,2023-02-07,2023-03-17,691.67,1108,0,1108
790,TSLA  ,2023-02-07,2023-03-17,700.0,4503,0,4503
791,TSLA  ,2023-02-07,2023-03-17,708.33,483,0,483
792,TSLA  ,2023-02-07,2023-03-17,716.67,664,0,664
793,TSLA  ,2023-02-07,2023-03-17,725.0,789,0,789
794,TSLA  ,2023-02-07,2023-03-17,733.33,1729,0,1729
795,TSLA  ,2023-02-07,2023-03-17,741.67,753,0,753
796,TSLA  ,2023-02-07,2023-03-17,750.0,703,0,703
797,TSLA  ,2023-02-07,2023-03-17,758.33,1235,0,1235
798,TSLA  ,2023-02-07,2023-03-17,766.67,1260,0,1260
799,TSLA  ,2023-02-07,2023-03-17,775.0,846,0,846
800,TSLA  ,2023-02-07,2023-03-17,783.33,1311,0,1311
801,TSLA  ,2023-02-07,2023-03-17,791.67,1446,0,1446
802,TSLA  ,2023-02-07,2023-03-17,800.0,5214,0,5214
803,TSLA  ,2023-02-07,2023-03-17,808.33,1843,0,1843
804,TSLA  ,2023-02-07,2023-03-17,816.67,2465,0,2465
805,TSLA  ,2023-02-07,2023-03-17,825.0,58280,0,58280
806,TSLA  ,2023-02-07,2023-03-24,20.0,3,11,14
807,TSLA  ,2023-02-07,2023-03-24,30.0,0,0,0
808,TSLA  ,2023-02-07,2023-03-24,40.0,0,0,0
809,TSLA  ,2023-02-07,2023-03-24,50.0,0,1540,1540
810,TSLA  ,2023-02-07,2023-03-24,55.0,1,0,1
811,TSLA  ,2023-02-07,2023-03-24,60.0,0,0,0
812,TSLA  ,2023-02-07,2023-03-24,65.0,0,0,0
813,TSLA  ,2023-02-07,2023-03-24,70.0,0,6,6
814,TSLA  ,2023-02-07,2023-03-24,75.0,0,0,0
815,TSLA  ,2023-02-07,2023-03-24,80.0,0,11,11
816,TSLA  ,2023-02-07,2023-03-24,85.0,0,15,15
817,TSLA  ,2023-02-07,2023-03-24,90.0,0,6,6
818,TSLA  ,2023-02-07,2023-03-24,95.0,0,13,13
819,TSLA  ,2023-02-07,2023-03-24,100.0,10,54,64
820,TSLA  ,2023-02-07,2023-03-24,105.0,10,39,49
821,TSLA  ,2023-02-07,2023-03-24,110.0,4,26,30
822,TSLA  ,2023-02-07,2023-03-24,115.0,1,13,14
823,TSLA  ,2023-02-07,2023-03-24,120.0,0,61,61
824,TSLA  ,2023-02-07,2023-03-24,125.0,2,83,85
825,TSLA  ,2023-02-07,2023-03-24,130.0,128,244,372
826,TSLA  ,2023-02-07,2023-03-24,135.0,5,21,26
827,TSLA  ,2023-02-07,2023-03-24,140.0,19,143,162
828,TSLA  ,2023-02-07,2023-03-24,145.0,57,87,144
829,TSLA  ,2023-02-07,2023-03-24,146.0,6,6,12
830,TSLA  ,2023-02-07,2023-03-24,147.0,64,3,67
831,TSLA  ,2023-02-07,2023-03-24,148.0,57,67,124
832,TSLA  ,2023-02-07,2023-03-24,149.0,58,65,123
833,TSLA  ,2023-02-07,2023-03-24,150.0,19,411,430
834,TSLA  ,2023-02-07,2023-03-24,152.5,1,24,25
835,TSLA  ,2023-02-07,2023-03-24,155.0,15,299,314
836,TSLA  ,2023-02-07,2023-03-24,157.5,2,419,421
837,TSLA  ,2023-02-07,2023-03-24,160.0,100,136,236
838,TSLA  ,2023-02-07,2023-03-24,162.5,17,81,98
839,TSLA  ,2023-02-07,2023-03-24,165.0,19,391,410
840,TSLA  ,2023-02-07,2023-03-24,167.5,14,425,439
841,TSLA  ,2023-02-07,2023-03-24,170.0,18,312,330
842,TSLA  ,2023-02-07,2023-03-24,172.5,16,102,118
843,TSLA  ,2023-02-07,2023-03-24,175.0,88,210,298
844,TSLA  ,2023-02-07,2023-03-24,177.5,8,21,29
845,TSLA  ,2023-02-07,2023-03-24,180.0,68,459,527
846,TSLA  ,2023-02-07,2023-03-24,182.5,0,12,12
847,TSLA  ,2023-02-07,2023-03-24,185.0,66,45,111
848,TSLA  ,2023-02-07,2023-03-24,187.5,104,15,119
849,TSLA  ,2023-02-07,2023-03-24,190.0,285,141,426
850,TSLA  ,2023-02-07,2023-03-24,192.5,45,81,126
851,TSLA  ,2023-02-07,2023-03-24,195.0,258,83,341
852,TSLA  ,2023-02-07,2023-03-24,197.5,79,13,92
853,TSLA  ,2023-02-07,2023-03-24,200.0,880,126,1006
854,TSLA  ,2023-02-07,2023-03-24,202.5,12,55,67
855,TSLA  ,2023-02-07,2023-03-24,205.0,763,20,783
856,TSLA  ,2023-02-07,2023-03-24,207.5,17,0,17
857,TSLA  ,2023-02-07,2023-03-24,210.0,114,16,130
858,TSLA  ,2023-02-07,2023-03-24,212.5,23,0,23
859,TSLA  ,2023-02-07,2023-03-24,215.0,79,1,80
860,TSLA  ,2023-02-07,2023-03-24,217.5,7,37,44
861,TSLA  ,2023-02-07,2023-03-24,220.0,277,299,576
862,TSLA  ,2023-02-07,2023-03-24,222.5,67,5,72
863,TSLA  ,2023-02-07,2023-03-24,225.0,146,77,223
864,TSLA  ,2023-02-07,2023-03-24,230.0,207,100,307
865,TSLA  ,2023-02-07,2023-03-24,235.0,209,59,268
866,TSLA  ,2023-02-07,2023-03-24,240.0,68,123,191
867,TSLA  ,2023-02-07,2023-03-24,245.0,449,13,462
868,TSLA  ,2023-02-07,2023-03-24,250.0,556,12,568
869,TSLA  ,2023-02-07,2023-03-24,255.0,66,13,79
870,TSLA  ,2023-02-07,2023-03-24,260.0,43,0,43
871,TSLA  ,2023-02-07,2023-03-24,265.0,12,1,13
872,TSLA  ,2023-02-07,2023-03-24,270.0,26,0,26
873,TSLA  ,2023-02-07,2023-03-24,275.0,41,0,41
874,TSLA  ,2023-02-07,2023-03-24,280.0,32,0,32
875,TSLA  ,2023-02-07,2023-03-24,285.0,38,0,38
876,TSLA  ,2023-02-07,2023-03-24,290.0,33,0,33
877,TSLA  ,2023-02-07,2023-03-24,300.0,44,0,44
878,TSLA  ,2023-02-07,2023-03-24,310.0,34,0,34
879,TSLA  ,2023-02-07,2023-03-24,320.0,0,0,0
880,TSLA  ,2023-02-07,2023-03-24,330.0,1,0,1
881,TSLA  ,2023-02-07,2023-03-24,340.0,0,0,0
882,TSLA  ,2023-02-07,2023-03-24,350.0,14,0,14
883,TSLA  ,2023-02-07,2023-03-24,360.0,227,0,227
884,TSLA  ,2023-02-07,2023-04-21,5.0,14,1,15
885,TSLA  ,2023-02-07,2023-04-21,10.0,0,8,8
886,TSLA  ,2023-02-07,2023-04-21,15.0,0,41,41
887,TSLA  ,2023-02-07,2023-04-21,20.0,4,320,324
888,TSLA  ,2023-02-07,2023-04-21,25.0,3,2484,2487
889,TSLA  ,2023-02-07,2023-04-21,30.0,0,1680,1680
890,TSLA  ,2023-02-07,2023-04-21,35.0,5,436,441
891,TSLA  ,2023-02-07,2023-04-21,40.0,6,502,508
892,TSLA  ,2023-02-07,2023-04-21,45.0,2,779,781
893,TSLA  ,2023-02-07,2023-04-21,50.0,126,5029,5155
894,TSLA  ,2023-02-07,2023-04-21,55.0,14,2729,2743
895,TSLA  ,2023-02-07,2023-04-21,60.0,20,1896,1916
896,TSLA  ,2023-02-07,2023-04-21,65.0,65,5031,5096
897,TSLA  ,2023-02-07,2023-04-21,70.0,105,4359,4464
898,TSLA  ,2023-02-07,2023-04-21,75.0,124,13186,13310
899,TSLA  ,2023-02-07,2023-04-21,80.0,25226,4529,29755
900,TSLA  ,2023-02-07,2023-04-21,85.0,90,3266,3356
901,TSLA  ,2023-02-07,2023-04-21,90.0,266,2268,2534
902,TSLA  ,2023-02-07,2023-04-21,95.0,151,6172,6323
903,TSLA  ,2023-02-07,2023-04-21,100.0,1632,23735,25367
904,TSLA  ,2023-02-07,2023-04-21,105.0,373,2601,2974
905,TSLA  ,2023-02-07,2023-04-21,108.33,903,4871,5774
906,TSLA  ,2023-02-07,2023-04-21,110.0,1101,5172,6273
907,TSLA  ,2023-02-07,2023-04-21,115.0,1443,3380,4823
908,TSLA  ,2023-02-07,2023-04-21,116.67,2545,9657,12202
909,TSLA  ,2023-02-07,2023-04-21,120.0,7450,6693,14143
910,TSLA  ,2023-02-07,2023-04-21,125.0,11123,12635,23758
911,TSLA  ,2023-02-07,2023-04-21,130.0,1853,6040,7893
912,TSLA  ,2023-02-07,2023-04-21,133.33,4625,3816,8441
913,TSLA  ,2023-02-07,2023-04-21,135.0,1882,2438,4320
914,TSLA  ,2023-02-07,2023-04-21,140.0,2835,7440,10275
915,TSLA  ,2023-02-07,2023-04-21,141.67,6337,3754,10091
916,TSLA  ,2023-02-07,2023-04-21,145.0,1904,2059,3963
917,TSLA  ,2023-02-07,2023-04-21,150.0,7634,15104,22738
918,TSLA  ,2023-02-07,2023-04-21,155.0,1325,1022,2347
919,TSLA  ,2023-02-07,2023-04-21,158.33,2961,3784,6745
920,TSLA  ,2023-02-07,2023-04-21,160.0,2599,3918,6517
921,TSLA  ,2023-02-07,2023-04-21,165.0,1493,1058,2551
922,TSLA  ,2023-02-07,2023-04-21,166.67,2764,5355,8119
923,TSLA  ,2023-02-07,2023-04-21,170.0,2140,2473,4613
924,TSLA  ,2023-02-07,2023-04-21,175.0,10729,7009,17738
925,TSLA  ,2023-02-07,2023-04-21,180.0,2861,2822,5683
926,TSLA  ,2023-02-07,2023-04-21,183.33,2639,4232,6871
927,TSLA  ,2023-02-07,2023-04-21,185.0,1688,2870,4558
928,TSLA  ,2023-02-07,2023-04-21,190.0,1734,2344,4078
929,TSLA  ,2023-02-07,2023-04-21,191.67,3108,4689,7797
930,TSLA  ,2023-02-07,2023-04-21,195.0,2634,1684,4318
931,TSLA  ,2023-02-07,2023-04-21,200.0,10505,5714,16219
932,TSLA  ,2023-02-07,2023-04-21,205.0,3723,1190,4913
933,TSLA  ,2023-02-07,2023-04-21,208.33,6315,2150,8465
934,TSLA  ,2023-02-07,2023-04-21,210.0,2863,1086,3949
935,TSLA  ,2023-02-07,2023-04-21,215.0,1716,390,2106
936,TSLA  ,2023-02-07,2023-04-21,216.67,1701,2171,3872
937,TSLA  ,2023-02-07,2023-04-21,220.0,5887,225,6112
938,TSLA  ,2023-02-07,2023-04-21,225.0,8217,1970,10187
939,TSLA  ,2023-02-07,2023-04-21,230.0,1054,195,1249
940,TSLA  ,2023-02-07,2023-04-21,233.33,1532,605,2137
941,TSLA  ,2023-02-07,2023-04-21,235.0,796,237,1033
942,TSLA  ,2023-02-07,2023-04-21,240.0,13261,192,13453
943,TSLA  ,2023-02-07,2023-04-21,241.67,768,38,806
944,TSLA  ,2023-02-07,2023-04-21,243.33,919,39,958
945,TSLA  ,2023-02-07,2023-04-21,245.0,1580,63,1643
946,TSLA  ,2023-02-07,2023-04-21,246.67,1120,29,1149
947,TSLA  ,2023-02-07,2023-04-21,248.33,764,307,1071
948,TSLA  ,2023-02-07,2023-04-21,250.0,7907,697,8604
949,TSLA  ,2023-02-07,2023-04-21,251.67,1648,26,1674
950,TSLA  ,2023-02-07,2023-04-21,253.33,486,13,499
951,TSLA  ,2023-02-07,2023-04-21,255.0,1210,19,1229
952,TSLA  ,2023-02-07,2023-04-21,258.33,701,895,1596
953,TSLA  ,2023-02-07,2023-04-21,260.0,1431,5,1436
954,TSLA  ,2023-02-07,2023-04-21,265.0,137,0,137
955,TSLA  ,2023-02-07,2023-04-21,266.67,1701,195,1896
956,TSLA  ,2023-02-07,2023-04-21,270.0,66,2,68
957,TSLA  ,2023-02-07,2023-04-21,275.0,1975,90,2065
958,TSLA  ,2023-02-07,2023-04-21,280.0,190,206,396
959,TSLA  ,2023-02-07,2023-04-21,283.33,1288,213,1501
960,TSLA  ,2023-02-07,2023-04-21,285.0,34,0,34
961,TSLA  ,2023-02-07,2023-04-21,291.67,3050,30,3080
962,TSLA  ,2023-02-07,2023-04-21,300.0,7752,37,7789
963,TSLA  ,2023-02-07,2023-04-21,308.33,4535,25,4560
964,TSLA  ,2023-02-07,2023-04-21,316.67,21939,1,21940
965,TSLA  ,2023-02-07,2023-04-21,325.0,2341,0,2341
966,TSLA  ,2023-02-07,2023-04-21,333.33,4452,0,4452
967,TSLA  ,2023-02-07,2023-04-21,341.67,741,8,749
968,TSLA  ,2023-02-07,2023-04-21,350.0,3288,0,3288
969,TSLA  ,2023-02-07,2023-04-21,358.33,909,0,909
970,TSLA  ,2023-02-07,2023-04-21,366.67,977,4,981
971,TSLA  ,2023-02-07,2023-04-21,375.0,1058,8,1066
972,TSLA  ,2023-02-07,2023-04-21,383.33,636,3,639
973,TSLA  ,2023-02-07,2023-04-21,391.67,370,0,370
974,TSLA  ,2023-02-07,2023-04-21,400.0,2454,0,2454
975,TSLA  ,2023-02-07,2023-04-21,408.33,406,0,406
976,TSLA  ,2023-02-07,2023-04-21,416.67,1138,0,1138
977,TSLA  ,2023-02-07,2023-04-21,425.0,4770,0,4770
978,TSLA  ,2023-02-07,2023-04-21,433.33,2785,0,2785
979,TSLA  ,2023-02-07,2023-04-21,441.67,709,0,709
980,TSLA  ,2023-02-07,2023-04-21,450.0,882,0,882
981,TSLA  ,2023-02-07,2023-04-21,458.33,3203,0,3203
982,TSLA  ,2023-02-07,2023-04-21,466.67,438,0,438
983,TSLA  ,2023-02-07,2023-04-21,475.0,1600,0,1600
984,TSLA  ,2023-02-07,2023-04-21,483.33,844,0,844
985,TSLA  ,2023-02-07,2023-04-21,491.67,173,0,173
986,TSLA  ,2023-02-07,2023-04-21,500.0,1999,0,1999
987,TSLA  ,2023-02-07,2023-04-21,508.33,846,0,846
988,TSLA  ,2023-02-07,2023-04-21,516.67,512,0,512
989,TSLA  ,2023-02-07,2023-04-21,525.0,371,0,371
990,TSLA  ,2023-02-07,2023-04-21,533.33,481,0,481
991,TSLA  ,2023-02-07,2023-04-21,541.67,468,0,468
992,TSLA  ,2023-02-07,2023-04-21,550.0,11886,0,11886
993,TSLA  ,2023-02-07,2023-04-21,558.33,207,0,207
994,TSLA  ,2023-02-07,2023-04-21,566.67,692,0,692
995,TSLA  ,2023-02-07,2023-04-21,575.0,2137,0,2137
996,TSLA  ,2023-02-07,2023-04-21,583.33,868,0,868
997,TSLA  ,2023-02-07,2023-04-21,600.0,17951,0,17951
998,TSLA  ,2023-02-07,2023-05-19,50.0,62,2824,2886
999,TSLA  ,2023-02-07,2023-05-19,55.0,51,597,648
1000,TSLA  ,2023-02-07,2023-05-19,60.0,156,950,1106
1001,TSLA  ,2023-02-07,2023-05-19,65.0,65,463,528
1002,TSLA  ,2023-02-07,2023-05-19,70.0,178,1334,1512
1003,TSLA  ,2023-02-07,2023-05-19,75.0,135,1677,1812
1004,TSLA  ,2023-02-07,2023-05-19,80.0,85,1636,1721
1005,TSLA  ,2023-02-07,2023-05-19,85.0,63,1648,1711
1006,TSLA  ,2023-02-07,2023-05-19,90.0,243,2771,3014
1007,TSLA  ,2023-02-07,2023-05-19,95.0,135,1636,1771
1008,TSLA  ,2023-02-07,2023-05-19,100.0,1068,24420,25488
1009,TSLA  ,2023-02-07,2023-05-19,105.0,274,6109,6383
1010,TSLA  ,2023-02-07,2023-05-19,110.0,15994,7249,23243
1011,TSLA  ,2023-02-07,2023-05-19,115.0,1323,1885,3208
1012,TSLA  ,2023-02-07,2023-05-19,120.0,2134,7593,9727
1013,TSLA  ,2023-02-07,2023-05-19,125.0,3628,2454,6082
1014,TSLA  ,2023-02-07,2023-05-19,130.0,2762,2634,5396
1015,TSLA  ,2023-02-07,2023-05-19,135.0,1994,2031,4025
1016,TSLA  ,2023-02-07,2023-05-19,140.0,1902,11225,13127
1017,TSLA  ,2023-02-07,2023-05-19,145.0,2332,2660,4992
1018,TSLA  ,2023-02-07,2023-05-19,150.0,4103,3999,8102
1019,TSLA  ,2023-02-07,2023-05-19,155.0,1515,1384,2899
1020,TSLA  ,2023-02-07,2023-05-19,160.0,3116,2374,5490
1021,TSLA  ,2023-02-07,2023-05-19,165.0,1375,1306,2681
1022,TSLA  ,2023-02-07,2023-05-19,170.0,2793,2317,5110
1023,TSLA  ,2023-02-07,2023-05-19,175.0,2059,1426,3485
1024,TSLA  ,2023-02-07,2023-05-19,180.0,8188,5748,13936
1025,TSLA  ,2023-02-07,2023-05-19,185.0,1725,1300,3025
1026,TSLA  ,2023-02-07,2023-05-19,190.0,2389,3112,5501
1027,TSLA  ,2023-02-07,2023-05-19,195.0,2582,2028,4610
1028,TSLA  ,2023-02-07,2023-05-19,200.0,6000,1806,7806
1029,TSLA  ,2023-02-07,2023-05-19,205.0,3339,1115,4454
1030,TSLA  ,2023-02-07,2023-05-19,210.0,9226,427,9653
1031,TSLA  ,2023-02-07,2023-05-19,215.0,2085,424,2509
1032,TSLA  ,2023-02-07,2023-05-19,220.0,2157,86,2243
1033,TSLA  ,2023-02-07,2023-05-19,225.0,909,15,924
1034,TSLA  ,2023-02-07,2023-05-19,230.0,1430,35,1465
1035,TSLA  ,2023-02-07,2023-05-19,235.0,869,104,973
1036,TSLA  ,2023-02-07,2023-05-19,240.0,645,83,728
1037,TSLA  ,2023-02-07,2023-05-19,245.0,316,127,443
1038,TSLA  ,2023-02-07,2023-05-19,250.0,1200,38,1238
1039,TSLA  ,2023-02-07,2023-05-19,260.0,520,107,627
1040,TSLA  ,2023-02-07,2023-05-19,270.0,1437,121,1558
1041,TSLA  ,2023-02-07,2023-05-19,280.0,348,22,370
1042,TSLA  ,2023-02-07,2023-05-19,290.0,331,367,698
1043,TSLA  ,2023-02-07,2023-05-19,300.0,625,538,1163
1044,TSLA  ,2023-02-07,2023-05-19,310.0,319,5254,5573
1045,TSLA  ,2023-02-07,2023-05-19,320.0,520,1169,1689
1046,TSLA  ,2023-02-07,2023-05-19,330.0,285,26,311
1047,TSLA  ,2023-02-07,2023-05-19,340.0,184,1,185
1048,TSLA  ,2023-02-07,2023-05-19,350.0,205,0,205
1049,TSLA  ,2023-02-07,2023-05-19,360.0,704,1,705
1050,TSLA  ,2023-02-07,2023-05-19,370.0,24,0,24
1051,TSLA  ,2023-02-07,2023-05-19,380.0,11,0,11
1052,TSLA  ,2023-02-07,2023-05-19,390.0,557,0,557
1053,TSLA  ,2023-02-07,2023-06-16,1.67,108,41907,42015
1054,TSLA  ,2023-02-07,2023-06-16,3.33,402,5010,5412
1055,TSLA  ,2023-02-07,2023-06-16,5.0,108,1664,1772
1056,TSLA  ,2023-02-07,2023-06-16,6.67,75,1309,1384
1057,TSLA  ,2023-02-07,2023-06-16,8.33,425,2371,2796
1058,TSLA  ,2023-02-07,2023-06-16,10.0,3234,3724,6958
1059,TSLA  ,2023-02-07,2023-06-16,11.67,155,8573,8728
1060,TSLA  ,2023-02-07,2023-06-16,13.33,1234,5641,6875
1061,TSLA  ,2023-02-07,2023-06-16,15.0,168,4018,4186
1062,TSLA  ,2023-02-07,2023-06-16,16.67,489,9818,10307
1063,TSLA  ,2023-02-07,2023-06-16,18.33,88,4913,5001
1064,TSLA  ,2023-02-07,2023-06-16,33.33,863,16376,17239
1065,TSLA  ,2023-02-07,2023-06-16,50.0,1109,16982,18091
1066,TSLA  ,2023-02-07,2023-06-16,55.0,31,7713,7744
1067,TSLA  ,2023-02-07,2023-06-16,60.0,15,2138,2153
1068,TSLA  ,2023-02-07,2023-06-16,65.0,4,617,621
1069,TSLA  ,2023-02-07,2023-06-16,66.67,1036,14263,15299
1070,TSLA  ,2023-02-07,2023-06-16,70.0,54,4042,4096
1071,TSLA  ,2023-02-07,2023-06-16,75.0,87,6568,6655
1072,TSLA  ,2023-02-07,2023-06-16,80.0,189,3671,3860
1073,TSLA  ,2023-02-07,2023-06-16,83.33,716,5094,5810
1074,TSLA  ,2023-02-07,2023-06-16,85.0,86,4137,4223
1075,TSLA  ,2023-02-07,2023-06-16,90.0,202,3202,3404
1076,TSLA  ,2023-02-07,2023-06-16,95.0,173,1503,1676
1077,TSLA  ,2023-02-07,2023-06-16,100.0,3490,26522,30012
1078,TSLA  ,2023-02-07,2023-06-16,105.0,368,5355,5723
1079,TSLA  ,2023-02-07,2023-06-16,110.0,1162,5873,7035
1080,TSLA  ,2023-02-07,2023-06-16,115.0,588,2906,3494
1081,TSLA  ,2023-02-07,2023-06-16,116.67,1787,5265,7052
1082,TSLA  ,2023-02-07,2023-06-16,120.0,3453,8788,12241
1083,TSLA  ,2023-02-07,2023-06-16,123.33,449,1188,1637
1084,TSLA  ,2023-02-07,2023-06-16,125.0,4107,7417,11524
1085,TSLA  ,2023-02-07,2023-06-16,126.67,867,1334,2201
1086,TSLA  ,2023-02-07,2023-06-16,130.0,3736,8668,12404
1087,TSLA  ,2023-02-07,2023-06-16,133.33,2541,9978,12519
1088,TSLA  ,2023-02-07,2023-06-16,135.0,2777,2738,5515
1089,TSLA  ,2023-02-07,2023-06-16,136.67,1079,2600,3679
1090,TSLA  ,2023-02-07,2023-06-16,140.0,7852,5885,13737
1091,TSLA  ,2023-02-07,2023-06-16,143.33,1278,3405,4683
1092,TSLA  ,2023-02-07,2023-06-16,145.0,2195,3443,5638
1093,TSLA  ,2023-02-07,2023-06-16,146.67,1596,1945,3541
1094,TSLA  ,2023-02-07,2023-06-16,150.0,13079,11046,24125
1095,TSLA  ,2023-02-07,2023-06-16,153.33,2470,3394,5864
1096,TSLA  ,2023-02-07,2023-06-16,155.0,1244,2972,4216
1097,TSLA  ,2023-02-07,2023-06-16,156.67,1688,789,2477
1098,TSLA  ,2023-02-07,2023-06-16,160.0,6679,6789,13468
1099,TSLA  ,2023-02-07,2023-06-16,163.33,979,1225,2204
1100,TSLA  ,2023-02-07,2023-06-16,165.0,1835,2723,4558
1101,TSLA  ,2023-02-07,2023-06-16,166.67,3754,13403,17157
1102,TSLA  ,2023-02-07,2023-06-16,170.0,3072,2120,5192
1103,TSLA  ,2023-02-07,2023-06-16,173.33,1454,6975,8429
1104,TSLA  ,2023-02-07,2023-06-16,175.0,3109,4270,7379
1105,TSLA  ,2023-02-07,2023-06-16,180.0,9234,6010,15244
1106,TSLA  ,2023-02-07,2023-06-16,183.33,10202,10135,20337
1107,TSLA  ,2023-02-07,2023-06-16,185.0,8211,5952,14163
1108,TSLA  ,2023-02-07,2023-06-16,186.67,909,1836,2745
1109,TSLA  ,2023-02-07,2023-06-16,190.0,5942,4615,10557
1110,TSLA  ,2023-02-07,2023-06-16,193.33,1982,7872,9854
1111,TSLA  ,2023-02-07,2023-06-16,195.0,2602,2500,5102
1112,TSLA  ,2023-02-07,2023-06-16,200.0,25293,23664,48957
1113,TSLA  ,2023-02-07,2023-06-16,205.0,2605,910,3515
1114,TSLA  ,2023-02-07,2023-06-16,206.67,2177,3420,5597
1115,TSLA  ,2023-02-07,2023-06-16,210.0,4328,971,5299
1116,TSLA  ,2023-02-07,2023-06-16,213.33,1533,2577,4110
1117,TSLA  ,2023-02-07,2023-06-16,215.0,3193,1047,4240
1118,TSLA  ,2023-02-07,2023-06-16,216.67,7021,6127,13148
1119,TSLA  ,2023-02-07,2023-06-16,220.0,7405,6787,14192
1120,TSLA  ,2023-02-07,2023-06-16,225.0,1774,1191,2965
1121,TSLA  ,2023-02-07,2023-06-16,226.67,1352,1920,3272
1122,TSLA  ,2023-02-07,2023-06-16,230.0,5986,2912,8898
1123,TSLA  ,2023-02-07,2023-06-16,233.33,10813,7302,18115
1124,TSLA  ,2023-02-07,2023-06-16,235.0,2483,664,3147
1125,TSLA  ,2023-02-07,2023-06-16,240.0,6277,3167,9444
1126,TSLA  ,2023-02-07,2023-06-16,243.33,1310,1698,3008
1127,TSLA  ,2023-02-07,2023-06-16,245.0,1468,63,1531
1128,TSLA  ,2023-02-07,2023-06-16,246.67,3040,96,3136
1129,TSLA  ,2023-02-07,2023-06-16,250.0,13823,3362,17185
1130,TSLA  ,2023-02-07,2023-06-16,253.33,1145,195,1340
1131,TSLA  ,2023-02-07,2023-06-16,255.0,996,73,1069
1132,TSLA  ,2023-02-07,2023-06-16,260.0,4803,82,4885
1133,TSLA  ,2023-02-07,2023-06-16,265.0,1932,51,1983
1134,TSLA  ,2023-02-07,2023-06-16,266.67,7268,408,7676
1135,TSLA  ,2023-02-07,2023-06-16,270.0,1363,9,1372
1136,TSLA  ,2023-02-07,2023-06-16,273.33,972,1051,2023
1137,TSLA  ,2023-02-07,2023-06-16,275.0,2008,5,2013
1138,TSLA  ,2023-02-07,2023-06-16,280.0,3583,64,3647
1139,TSLA  ,2023-02-07,2023-06-16,283.33,4541,51,4592
1140,TSLA  ,2023-02-07,2023-06-16,285.0,940,2,942
1141,TSLA  ,2023-02-07,2023-06-16,286.67,766,30,796
1142,TSLA  ,2023-02-07,2023-06-16,290.0,699,823,1522
1143,TSLA  ,2023-02-07,2023-06-16,293.33,1747,62,1809
1144,TSLA  ,2023-02-07,2023-06-16,295.0,330,258,588
1145,TSLA  ,2023-02-07,2023-06-16,300.0,17099,90,17189
1146,TSLA  ,2023-02-07,2023-06-16,305.0,3117,5,3122
1147,TSLA  ,2023-02-07,2023-06-16,306.67,1454,31,1485
1148,TSLA  ,2023-02-07,2023-06-16,310.0,1495,46,1541
1149,TSLA  ,2023-02-07,2023-06-16,313.33,501,36,537
1150,TSLA  ,2023-02-07,2023-06-16,315.0,272,82,354
1151,TSLA  ,2023-02-07,2023-06-16,316.67,6614,241,6855
1152,TSLA  ,2023-02-07,2023-06-16,320.0,2326,3,2329
1153,TSLA  ,2023-02-07,2023-06-16,326.67,9637,6,9643
1154,TSLA  ,2023-02-07,2023-06-16,330.0,1080,48,1128
1155,TSLA  ,2023-02-07,2023-06-16,333.33,33461,231,33692
1156,TSLA  ,2023-02-07,2023-06-16,340.0,1613,3,1616
1157,TSLA  ,2023-02-07,2023-06-16,346.67,1064,0,1064
1158,TSLA  ,2023-02-07,2023-06-16,350.0,8421,331,8752
1159,TSLA  ,2023-02-07,2023-06-16,353.33,812,0,812
1160,TSLA  ,2023-02-07,2023-06-16,360.0,2063,1,2064
1161,TSLA  ,2023-02-07,2023-06-16,366.67,10842,450,11292
1162,TSLA  ,2023-02-07,2023-06-16,370.0,742,0,742
1163,TSLA  ,2023-02-07,2023-06-16,383.33,11769,0,11769
1164,TSLA  ,2023-02-07,2023-06-16,400.0,19097,903,20000
1165,TSLA  ,2023-02-07,2023-06-16,416.67,3610,0,3610
1166,TSLA  ,2023-02-07,2023-06-16,433.33,9547,0,9547
1167,TSLA  ,2023-02-07,2023-06-16,450.0,7995,0,7995
1168,TSLA  ,2023-02-07,2023-06-16,466.67,20791,0,20791
1169,TSLA  ,2023-02-07,2023-06-16,483.33,8277,0,8277
1170,TSLA  ,2023-02-07,2023-06-16,500.0,23982,0,23982
1171,TSLA  ,2023-02-07,2023-06-16,516.67,2502,0,2502
1172,TSLA  ,2023-02-07,2023-06-16,533.33,4884,0,4884
1173,TSLA  ,2023-02-07,2023-06-16,550.0,6197,0,6197
1174,TSLA  ,2023-02-07,2023-06-16,558.33,1714,0,1714
1175,TSLA  ,2023-02-07,2023-06-16,566.67,1358,0,1358
1176,TSLA  ,2023-02-07,2023-06-16,575.0,650,0,650
1177,TSLA  ,2023-02-07,2023-06-16,583.33,1212,0,1212
1178,TSLA  ,2023-02-07,2023-06-16,591.67,399,0,399
1179,TSLA  ,2023-02-07,2023-06-16,600.0,7980,0,7980
1180,TSLA  ,2023-02-07,2023-06-16,608.33,1090,0,1090
1181,TSLA  ,2023-02-07,2023-06-16,616.67,803,0,803
1182,TSLA  ,2023-02-07,2023-06-16,625.0,2157,0,2157
1183,TSLA  ,2023-02-07,2023-06-16,633.33,5537,0,5537
1184,TSLA  ,2023-02-07,2023-06-16,641.67,436,0,436
1185,TSLA  ,2023-02-07,2023-06-16,650.0,530,0,530
1186,TSLA  ,2023-02-07,2023-06-16,666.67,18028,0,18028
1187,TSLA  ,2023-02-07,2023-06-16,675.0,941,0,941
1188,TSLA  ,2023-02-07,2023-06-16,683.33,556,0,556
1189,TSLA  ,2023-02-07,2023-06-16,691.67,849,0,849
1190,TSLA  ,2023-02-07,2023-06-16,700.0,2643,0,2643
1191,TSLA  ,2023-02-07,2023-06-16,708.33,537,0,537
1192,TSLA  ,2023-02-07,2023-06-16,716.67,708,0,708
1193,TSLA  ,2023-02-07,2023-06-16,725.0,1138,0,1138
1194,TSLA  ,2023-02-07,2023-06-16,733.33,2267,0,2267
1195,TSLA  ,2023-02-07,2023-06-16,741.67,793,0,793
1196,TSLA  ,2023-02-07,2023-06-16,750.0,12083,0,12083
1197,TSLA  ,2023-02-07,2023-06-16,758.33,1289,0,1289
1198,TSLA  ,2023-02-07,2023-06-16,766.67,1267,0,1267
1199,TSLA  ,2023-02-07,2023-06-16,775.0,1099,0,1099
1200,TSLA  ,2023-02-07,2023-06-16,783.33,2175,0,2175
1201,TSLA  ,2023-02-07,2023-06-16,791.67,1870,0,1870
1202,TSLA  ,2023-02-07,2023-06-16,800.0,8957,0,8957
1203,TSLA  ,2023-02-07,2023-06-16,808.33,1317,0,1317
1204,TSLA  ,2023-02-07,2023-06-16,816.67,1969,0,1969
1205,TSLA  ,2023-02-07,2023-06-16,825.0,38764,0,38764
1206,TSLA  ,2023-02-07,2023-07-21,5.0,32,721,753
1207,TSLA  ,2023-02-07,2023-07-21,10.0,5,906,911
1208,TSLA  ,2023-02-07,2023-07-21,15.0,4,329,333
1209,TSLA  ,2023-02-07,2023-07-21,20.0,12,1216,1228
1210,TSLA  ,2023-02-07,2023-07-21,25.0,27,915,942
1211,TSLA  ,2023-02-07,2023-07-21,30.0,111,1130,1241
1212,TSLA  ,2023-02-07,2023-07-21,35.0,45,722,767
1213,TSLA  ,2023-02-07,2023-07-21,40.0,22,1140,1162
1214,TSLA  ,2023-02-07,2023-07-21,45.0,38,405,443
1215,TSLA  ,2023-02-07,2023-07-21,50.0,66,5096,5162
1216,TSLA  ,2023-02-07,2023-07-21,55.0,86,1848,1934
1217,TSLA  ,2023-02-07,2023-07-21,60.0,94,3320,3414
1218,TSLA  ,2023-02-07,2023-07-21,65.0,86,395,481
1219,TSLA  ,2023-02-07,2023-07-21,70.0,25,2568,2593
1220,TSLA  ,2023-02-07,2023-07-21,75.0,63,4171,4234
1221,TSLA  ,2023-02-07,2023-07-21,80.0,79,3663,3742
1222,TSLA  ,2023-02-07,2023-07-21,85.0,54,1377,1431
1223,TSLA  ,2023-02-07,2023-07-21,90.0,123,3328,3451
1224,TSLA  ,2023-02-07,2023-07-21,95.0,55,1610,1665
1225,TSLA  ,2023-02-07,2023-07-21,100.0,295,5471,5766
1226,TSLA  ,2023-02-07,2023-07-21,105.0,333,2479,2812
1227,TSLA  ,2023-02-07,2023-07-21,110.0,1128,3077,4205
1228,TSLA  ,2023-02-07,2023-07-21,115.0,466,1033,1499
1229,TSLA  ,2023-02-07,2023-07-21,120.0,1220,4417,5637
1230,TSLA  ,2023-02-07,2023-07-21,125.0,1409,2045,3454
1231,TSLA  ,2023-02-07,2023-07-21,130.0,1513,1711,3224
1232,TSLA  ,2023-02-07,2023-07-21,135.0,1111,2999,4110
1233,TSLA  ,2023-02-07,2023-07-21,140.0,1519,2858,4377
1234,TSLA  ,2023-02-07,2023-07-21,145.0,1087,2090,3177
1235,TSLA  ,2023-02-07,2023-07-21,150.0,3328,3255,6583
1236,TSLA  ,2023-02-07,2023-07-21,155.0,1643,2922,4565
1237,TSLA  ,2023-02-07,2023-07-21,160.0,1677,1555,3232
1238,TSLA  ,2023-02-07,2023-07-21,165.0,601,1312,1913
1239,TSLA  ,2023-02-07,2023-07-21,170.0,1756,1943,3699
1240,TSLA  ,2023-02-07,2023-07-21,175.0,1708,1242,2950
1241,TSLA  ,2023-02-07,2023-07-21,180.0,2051,1446,3497
1242,TSLA  ,2023-02-07,2023-07-21,185.0,7051,12852,19903
1243,TSLA  ,2023-02-07,2023-07-21,190.0,1671,2074,3745
1244,TSLA  ,2023-02-07,2023-07-21,195.0,1300,1901,3201
1245,TSLA  ,2023-02-07,2023-07-21,200.0,5249,2045,7294
1246,TSLA  ,2023-02-07,2023-07-21,205.0,2061,647,2708
1247,TSLA  ,2023-02-07,2023-07-21,210.0,5032,698,5730
1248,TSLA  ,2023-02-07,2023-07-21,215.0,3083,709,3792
1249,TSLA  ,2023-02-07,2023-07-21,220.0,2902,1075,3977
1250,TSLA  ,2023-02-07,2023-07-21,225.0,2573,1556,4129
1251,TSLA  ,2023-02-07,2023-07-21,230.0,2474,746,3220
1252,TSLA  ,2023-02-07,2023-07-21,235.0,927,519,1446
1253,TSLA  ,2023-02-07,2023-07-21,240.0,1258,1614,2872
1254,TSLA  ,2023-02-07,2023-07-21,245.0,752,666,1418
1255,TSLA  ,2023-02-07,2023-07-21,250.0,24267,1575,25842
1256,TSLA  ,2023-02-07,2023-07-21,255.0,845,641,1486
1257,TSLA  ,2023-02-07,2023-07-21,260.0,590,69,659
1258,TSLA  ,2023-02-07,2023-07-21,265.0,240,9,249
1259,TSLA  ,2023-02-07,2023-07-21,270.0,388,125,513
1260,TSLA  ,2023-02-07,2023-07-21,275.0,255,76,331
1261,TSLA  ,2023-02-07,2023-07-21,280.0,1118,141,1259
1262,TSLA  ,2023-02-07,2023-07-21,285.0,806,142,948
1263,TSLA  ,2023-02-07,2023-07-21,290.0,380,31,411
1264,TSLA  ,2023-02-07,2023-07-21,295.0,134,11,145
1265,TSLA  ,2023-02-07,2023-07-21,300.0,1465,4,1469
1266,TSLA  ,2023-02-07,2023-07-21,305.0,201,5,206
1267,TSLA  ,2023-02-07,2023-07-21,310.0,728,6,734
1268,TSLA  ,2023-02-07,2023-07-21,315.0,275,1,276
1269,TSLA  ,2023-02-07,2023-07-21,320.0,449,0,449
1270,TSLA  ,2023-02-07,2023-07-21,325.0,667,0,667
1271,TSLA  ,2023-02-07,2023-07-21,330.0,441,26,467
1272,TSLA  ,2023-02-07,2023-07-21,335.0,163,7,170
1273,TSLA  ,2023-02-07,2023-07-21,340.0,417,16,433
1274,TSLA  ,2023-02-07,2023-07-21,345.0,145,0,145
1275,TSLA  ,2023-02-07,2023-07-21,350.0,611,1,612
1276,TSLA  ,2023-02-07,2023-07-21,355.0,212,1,213
1277,TSLA  ,2023-02-07,2023-07-21,360.0,625,0,625
1278,TSLA  ,2023-02-07,2023-07-21,365.0,954,0,954
1279,TSLA  ,2023-02-07,2023-07-21,370.0,951,0,951
1280,TSLA  ,2023-02-07,2023-07-21,375.0,3055,0,3055
1281,TSLA  ,2023-02-07,2023-07-21,380.0,83,0,83
1282,TSLA  ,2023-02-07,2023-07-21,390.0,70,0,70
1283,TSLA  ,2023-02-07,2023-09-15,1.67,861,20021,20882
1284,TSLA  ,2023-02-07,2023-09-15,3.33,1086,2849,3935
1285,TSLA  ,2023-02-07,2023-09-15,5.0,25,942,967
1286,TSLA  ,2023-02-07,2023-09-15,6.67,29,3364,3393
1287,TSLA  ,2023-02-07,2023-09-15,8.33,32,1175,1207
1288,TSLA  ,2023-02-07,2023-09-15,10.0,26,2172,2198
1289,TSLA  ,2023-02-07,2023-09-15,11.67,49,617,666
1290,TSLA  ,2023-02-07,2023-09-15,13.33,83,230,313
1291,TSLA  ,2023-02-07,2023-09-15,15.0,0,116,116
1292,TSLA  ,2023-02-07,2023-09-15,16.67,143,4178,4321
1293,TSLA  ,2023-02-07,2023-09-15,30.0,0,55,55
1294,TSLA  ,2023-02-07,2023-09-15,33.33,3118,11373,14491
1295,TSLA  ,2023-02-07,2023-09-15,35.0,2,32,34
1296,TSLA  ,2023-02-07,2023-09-15,40.0,3,182,185
1297,TSLA  ,2023-02-07,2023-09-15,45.0,3,47,50
1298,TSLA  ,2023-02-07,2023-09-15,50.0,411,7469,7880
1299,TSLA  ,2023-02-07,2023-09-15,55.0,22,2387,2409
1300,TSLA  ,2023-02-07,2023-09-15,60.0,30,4768,4798
1301,TSLA  ,2023-02-07,2023-09-15,65.0,4,2015,2019
1302,TSLA  ,2023-02-07,2023-09-15,66.67,442,5665,6107
1303,TSLA  ,2023-02-07,2023-09-15,70.0,83,655,738
1304,TSLA  ,2023-02-07,2023-09-15,75.0,26,572,598
1305,TSLA  ,2023-02-07,2023-09-15,80.0,259,793,1052
1306,TSLA  ,2023-02-07,2023-09-15,83.33,407,4457,4864
1307,TSLA  ,2023-02-07,2023-09-15,85.0,50,314,364
1308,TSLA  ,2023-02-07,2023-09-15,90.0,485,2613,3098
1309,TSLA  ,2023-02-07,2023-09-15,95.0,70,2439,2509
1310,TSLA  ,2023-02-07,2023-09-15,100.0,3250,11999,15249
1311,TSLA  ,2023-02-07,2023-09-15,105.0,87,2103,2190
1312,TSLA  ,2023-02-07,2023-09-15,108.33,400,1883,2283
1313,TSLA  ,2023-02-07,2023-09-15,110.0,1368,1516,2884
1314,TSLA  ,2023-02-07,2023-09-15,115.0,180,2968,3148
1315,TSLA  ,2023-02-07,2023-09-15,116.67,570,12245,12815
1316,TSLA  ,2023-02-07,2023-09-15,120.0,353,1517,1870
1317,TSLA  ,2023-02-07,2023-09-15,123.33,544,1335,1879
1318,TSLA  ,2023-02-07,2023-09-15,125.0,1741,5156,6897
1319,TSLA  ,2023-02-07,2023-09-15,126.67,125,1074,1199
1320,TSLA  ,2023-02-07,2023-09-15,130.0,1397,4987,6384
1321,TSLA  ,2023-02-07,2023-09-15,133.33,201,2371,2572
1322,TSLA  ,2023-02-07,2023-09-15,135.0,214,1164,1378
1323,TSLA  ,2023-02-07,2023-09-15,136.67,283,913,1196
1324,TSLA  ,2023-02-07,2023-09-15,140.0,1790,1949,3739
1325,TSLA  ,2023-02-07,2023-09-15,141.67,769,1683,2452
1326,TSLA  ,2023-02-07,2023-09-15,143.33,275,1540,1815
1327,TSLA  ,2023-02-07,2023-09-15,145.0,358,2670,3028
1328,TSLA  ,2023-02-07,2023-09-15,146.67,1373,1081,2454
1329,TSLA  ,2023-02-07,2023-09-15,150.0,33942,9236,43178
1330,TSLA  ,2023-02-07,2023-09-15,153.33,30482,1813,32295
1331,TSLA  ,2023-02-07,2023-09-15,155.0,417,387,804
1332,TSLA  ,2023-02-07,2023-09-15,156.67,395,650,1045
1333,TSLA  ,2023-02-07,2023-09-15,158.33,319,571,890
1334,TSLA  ,2023-02-07,2023-09-15,160.0,3709,5710,9419
1335,TSLA  ,2023-02-07,2023-09-15,163.33,416,1493,1909
1336,TSLA  ,2023-02-07,2023-09-15,165.0,1301,721,2022
1337,TSLA  ,2023-02-07,2023-09-15,166.67,1399,3089,4488
1338,TSLA  ,2023-02-07,2023-09-15,170.0,650,609,1259
1339,TSLA  ,2023-02-07,2023-09-15,173.33,10340,3028,13368
1340,TSLA  ,2023-02-07,2023-09-15,175.0,10894,7632,18526
1341,TSLA  ,2023-02-07,2023-09-15,180.0,33597,6486,40083
1342,TSLA  ,2023-02-07,2023-09-15,183.33,32295,5269,37564
1343,TSLA  ,2023-02-07,2023-09-15,185.0,221,195,416
1344,TSLA  ,2023-02-07,2023-09-15,186.67,528,3351,3879
1345,TSLA  ,2023-02-07,2023-09-15,190.0,816,1342,2158
1346,TSLA  ,2023-02-07,2023-09-15,191.67,485,1086,1571
1347,TSLA  ,2023-02-07,2023-09-15,193.33,946,2622,3568
1348,TSLA  ,2023-02-07,2023-09-15,195.0,308,551,859
1349,TSLA  ,2023-02-07,2023-09-15,200.0,11620,17007,28627
1350,TSLA  ,2023-02-07,2023-09-15,205.0,318,137,455
1351,TSLA  ,2023-02-07,2023-09-15,206.67,982,423,1405
1352,TSLA  ,2023-02-07,2023-09-15,208.33,567,2166,2733
1353,TSLA  ,2023-02-07,2023-09-15,210.0,632,233,865
1354,TSLA  ,2023-02-07,2023-09-15,213.33,433,1272,1705
1355,TSLA  ,2023-02-07,2023-09-15,215.0,507,126,633
1356,TSLA  ,2023-02-07,2023-09-15,216.67,2256,4253,6509
1357,TSLA  ,2023-02-07,2023-09-15,220.0,7432,3123,10555
1358,TSLA  ,2023-02-07,2023-09-15,225.0,2459,3209,5668
1359,TSLA  ,2023-02-07,2023-09-15,226.67,1197,1400,2597
1360,TSLA  ,2023-02-07,2023-09-15,230.0,1998,403,2401
1361,TSLA  ,2023-02-07,2023-09-15,233.33,2793,2824,5617
1362,TSLA  ,2023-02-07,2023-09-15,235.0,239,239,478
1363,TSLA  ,2023-02-07,2023-09-15,240.0,1221,2033,3254
1364,TSLA  ,2023-02-07,2023-09-15,241.67,1138,720,1858
1365,TSLA  ,2023-02-07,2023-09-15,245.0,60,208,268
1366,TSLA  ,2023-02-07,2023-09-15,246.67,507,440,947
1367,TSLA  ,2023-02-07,2023-09-15,250.0,10559,4149,14708
1368,TSLA  ,2023-02-07,2023-09-15,253.33,834,521,1355
1369,TSLA  ,2023-02-07,2023-09-15,255.0,44,11,55
1370,TSLA  ,2023-02-07,2023-09-15,258.33,729,2410,3139
1371,TSLA  ,2023-02-07,2023-09-15,260.0,11740,1418,13158
1372,TSLA  ,2023-02-07,2023-09-15,265.0,65,118,183
1373,TSLA  ,2023-02-07,2023-09-15,266.67,2234,319,2553
1374,TSLA  ,2023-02-07,2023-09-15,270.0,128,92,220
1375,TSLA  ,2023-02-07,2023-09-15,273.33,723,355,1078
1376,TSLA  ,2023-02-07,2023-09-15,275.0,2817,343,3160
1377,TSLA  ,2023-02-07,2023-09-15,280.0,2028,553,2581
1378,TSLA  ,2023-02-07,2023-09-15,283.33,1231,264,1495
1379,TSLA  ,2023-02-07,2023-09-15,286.67,535,96,631
1380,TSLA  ,2023-02-07,2023-09-15,291.67,948,332,1280
1381,TSLA  ,2023-02-07,2023-09-15,293.33,1310,389,1699
1382,TSLA  ,2023-02-07,2023-09-15,300.0,8170,1006,9176
1383,TSLA  ,2023-02-07,2023-09-15,306.67,2668,328,2996
1384,TSLA  ,2023-02-07,2023-09-15,308.33,800,332,1132
1385,TSLA  ,2023-02-07,2023-09-15,313.33,885,286,1171
1386,TSLA  ,2023-02-07,2023-09-15,316.67,1582,161,1743
1387,TSLA  ,2023-02-07,2023-09-15,320.0,1732,168,1900
1388,TSLA  ,2023-02-07,2023-09-15,325.0,2738,75,2813
1389,TSLA  ,2023-02-07,2023-09-15,326.67,1107,5,1112
1390,TSLA  ,2023-02-07,2023-09-15,333.33,6440,84,6524
1391,TSLA  ,2023-02-07,2023-09-15,340.0,23038,127,23165
1392,TSLA  ,2023-02-07,2023-09-15,341.67,177,186,363
1393,TSLA  ,2023-02-07,2023-09-15,346.67,520,134,654
1394,TSLA  ,2023-02-07,2023-09-15,350.0,17662,298,17960
1395,TSLA  ,2023-02-07,2023-09-15,353.33,22087,147,22234
1396,TSLA  ,2023-02-07,2023-09-15,358.33,430,279,709
1397,TSLA  ,2023-02-07,2023-09-15,360.0,3274,340,3614
1398,TSLA  ,2023-02-07,2023-09-15,366.67,2930,488,3418
1399,TSLA  ,2023-02-07,2023-09-15,375.0,3201,155,3356
1400,TSLA  ,2023-02-07,2023-09-15,383.33,4532,10,4542
1401,TSLA  ,2023-02-07,2023-09-15,391.67,825,1,826
1402,TSLA  ,2023-02-07,2023-09-15,400.0,5682,61,5743
1403,TSLA  ,2023-02-07,2023-09-15,408.33,1435,0,1435
1404,TSLA  ,2023-02-07,2023-09-15,416.67,924,0,924
1405,TSLA  ,2023-02-07,2023-09-15,425.0,3319,0,3319
1406,TSLA  ,2023-02-07,2023-09-15,433.33,4954,8,4962
1407,TSLA  ,2023-02-07,2023-09-15,441.67,1019,0,1019
1408,TSLA  ,2023-02-07,2023-09-15,450.0,2288,0,2288
1409,TSLA  ,2023-02-07,2023-09-15,458.33,402,0,402
1410,TSLA  ,2023-02-07,2023-09-15,466.67,2690,9,2699
1411,TSLA  ,2023-02-07,2023-09-15,475.0,330,0,330
1412,TSLA  ,2023-02-07,2023-09-15,483.33,662,0,662
1413,TSLA  ,2023-02-07,2023-09-15,491.67,1097,0,1097
1414,TSLA  ,2023-02-07,2023-09-15,500.0,4972,0,4972
1415,TSLA  ,2023-02-07,2023-09-15,508.33,811,0,811
1416,TSLA  ,2023-02-07,2023-09-15,516.67,1262,0,1262
1417,TSLA  ,2023-02-07,2023-09-15,525.0,1165,0,1165
1418,TSLA  ,2023-02-07,2023-09-15,533.33,1600,6,1606
1419,TSLA  ,2023-02-07,2023-09-15,541.67,1161,0,1161
1420,TSLA  ,2023-02-07,2023-09-15,550.0,11713,0,11713
1421,TSLA  ,2023-02-07,2023-09-15,558.33,165,0,165
1422,TSLA  ,2023-02-07,2023-09-15,566.67,4082,0,4082
1423,TSLA  ,2023-02-07,2023-09-15,575.0,348,0,348
1424,TSLA  ,2023-02-07,2023-09-15,583.33,510,0,510
1425,TSLA  ,2023-02-07,2023-09-15,591.67,2091,0,2091
1426,TSLA  ,2023-02-07,2023-09-15,600.0,8651,0,8651
1427,TSLA  ,2023-02-07,2023-09-15,608.33,671,0,671
1428,TSLA  ,2023-02-07,2023-09-15,616.67,1025,0,1025
1429,TSLA  ,2023-02-07,2023-09-15,625.0,1051,0,1051
1430,TSLA  ,2023-02-07,2023-09-15,633.33,639,0,639
1431,TSLA  ,2023-02-07,2023-09-15,641.67,428,0,428
1432,TSLA  ,2023-02-07,2023-09-15,650.0,27275,0,27275
1433,TSLA  ,2023-02-07,2023-09-15,658.33,1206,0,1206
1434,TSLA  ,2023-02-07,2023-09-15,666.67,1303,0,1303
1435,TSLA  ,2023-02-07,2023-09-15,675.0,489,0,489
1436,TSLA  ,2023-02-07,2023-09-15,683.33,360,0,360
1437,TSLA  ,2023-02-07,2023-09-15,700.0,1527,0,1527
1438,TSLA  ,2023-02-07,2023-09-15,716.67,1140,0,1140
1439,TSLA  ,2023-02-07,2023-09-15,733.33,2327,0,2327
1440,TSLA  ,2023-02-07,2023-09-15,750.0,8207,0,8207
1441,TSLA  ,2023-02-07,2023-09-15,758.33,70574,0,70574
1442,TSLA  ,2023-02-07,2023-12-15,50.0,1277,3362,4639
1443,TSLA  ,2023-02-07,2023-12-15,55.0,64,1124,1188
1444,TSLA  ,2023-02-07,2023-12-15,60.0,37,1112,1149
1445,TSLA  ,2023-02-07,2023-12-15,65.0,4,292,296
1446,TSLA  ,2023-02-07,2023-12-15,70.0,27,3825,3852
1447,TSLA  ,2023-02-07,2023-12-15,75.0,19,3973,3992
1448,TSLA  ,2023-02-07,2023-12-15,80.0,157,839,996
1449,TSLA  ,2023-02-07,2023-12-15,85.0,2577,2372,4949
1450,TSLA  ,2023-02-07,2023-12-15,90.0,1644,5443,7087
1451,TSLA  ,2023-02-07,2023-12-15,95.0,831,466,1297
1452,TSLA  ,2023-02-07,2023-12-15,100.0,2176,5687,7863
1453,TSLA  ,2023-02-07,2023-12-15,105.0,325,604,929
1454,TSLA  ,2023-02-07,2023-12-15,110.0,737,2153,2890
1455,TSLA  ,2023-02-07,2023-12-15,115.0,1721,1056,2777
1456,TSLA  ,2023-02-07,2023-12-15,120.0,1020,1030,2050
1457,TSLA  ,2023-02-07,2023-12-15,125.0,507,922,1429
1458,TSLA  ,2023-02-07,2023-12-15,130.0,792,10545,11337
1459,TSLA  ,2023-02-07,2023-12-15,135.0,796,5867,6663
1460,TSLA  ,2023-02-07,2023-12-15,140.0,1003,1299,2302
1461,TSLA  ,2023-02-07,2023-12-15,145.0,634,831,1465
1462,TSLA  ,2023-02-07,2023-12-15,150.0,1567,11805,13372
1463,TSLA  ,2023-02-07,2023-12-15,155.0,409,978,1387
1464,TSLA  ,2023-02-07,2023-12-15,160.0,2833,10739,13572
1465,TSLA  ,2023-02-07,2023-12-15,165.0,1476,454,1930
1466,TSLA  ,2023-02-07,2023-12-15,170.0,785,3839,4624
1467,TSLA  ,2023-02-07,2023-12-15,175.0,2124,371,2495
1468,TSLA  ,2023-02-07,2023-12-15,180.0,1730,276,2006
1469,TSLA  ,2023-02-07,2023-12-15,185.0,563,527,1090
1470,TSLA  ,2023-02-07,2023-12-15,190.0,1172,501,1673
1471,TSLA  ,2023-02-07,2023-12-15,195.0,749,514,1263
1472,TSLA  ,2023-02-07,2023-12-15,200.0,8788,1240,10028
1473,TSLA  ,2023-02-07,2023-12-15,205.0,6693,301,6994
1474,TSLA  ,2023-02-07,2023-12-15,210.0,2519,347,2866
1475,TSLA  ,2023-02-07,2023-12-15,215.0,1204,263,1467
1476,TSLA  ,2023-02-07,2023-12-15,220.0,1605,1064,2669
1477,TSLA  ,2023-02-07,2023-12-15,225.0,1270,245,1515
1478,TSLA  ,2023-02-07,2023-12-15,230.0,1611,609,2220
1479,TSLA  ,2023-02-07,2023-12-15,235.0,472,428,900
1480,TSLA  ,2023-02-07,2023-12-15,240.0,5741,527,6268
1481,TSLA  ,2023-02-07,2023-12-15,245.0,1860,421,2281
1482,TSLA  ,2023-02-07,2023-12-15,250.0,15794,3098,18892
1483,TSLA  ,2023-02-07,2023-12-15,260.0,10037,447,10484
1484,TSLA  ,2023-02-07,2023-12-15,270.0,3122,493,3615
1485,TSLA  ,2023-02-07,2023-12-15,280.0,341,632,973
1486,TSLA  ,2023-02-07,2023-12-15,290.0,236,410,646
1487,TSLA  ,2023-02-07,2023-12-15,300.0,851,967,1818
1488,TSLA  ,2023-02-07,2023-12-15,310.0,723,532,1255
1489,TSLA  ,2023-02-07,2023-12-15,320.0,517,500,1017
1490,TSLA  ,2023-02-07,2023-12-15,330.0,289,213,502
1491,TSLA  ,2023-02-07,2023-12-15,340.0,247,65,312
1492,TSLA  ,2023-02-07,2023-12-15,350.0,556,154,710
1493,TSLA  ,2023-02-07,2023-12-15,360.0,522,113,635
1494,TSLA  ,2023-02-07,2023-12-15,370.0,15,239,254
1495,TSLA  ,2023-02-07,2023-12-15,380.0,38,308,346
1496,TSLA  ,2023-02-07,2023-12-15,390.0,184,101,285
1497,TSLA  ,2023-02-07,2024-01-19,1.67,2469,28836,31305
1498,TSLA  ,2023-02-07,2024-01-19,3.33,966,5840,6806
1499,TSLA  ,2023-02-07,2024-01-19,5.0,256,9769,10025
1500,TSLA  ,2023-02-07,2024-01-19,6.67,75,3139,3214
1501,TSLA  ,2023-02-07,2024-01-19,8.33,3902,2711,6613
1502,TSLA  ,2023-02-07,2024-01-19,10.0,294,3986,4280
1503,TSLA  ,2023-02-07,2024-01-19,11.67,253,3158,3411
1504,TSLA  ,2023-02-07,2024-01-19,13.33,819,507,1326
1505,TSLA  ,2023-02-07,2024-01-19,15.0,279,2066,2345
1506,TSLA  ,2023-02-07,2024-01-19,16.67,486,4608,5094
1507,TSLA  ,2023-02-07,2024-01-19,18.33,393,6128,6521
1508,TSLA  ,2023-02-07,2024-01-19,20.0,260,7588,7848
1509,TSLA  ,2023-02-07,2024-01-19,21.67,108,842,950
1510,TSLA  ,2023-02-07,2024-01-19,23.33,382,3837,4219
1511,TSLA  ,2023-02-07,2024-01-19,25.0,369,2799,3168
1512,TSLA  ,2023-02-07,2024-01-19,26.67,833,1223,2056
1513,TSLA  ,2023-02-07,2024-01-19,28.33,341,849,1190
1514,TSLA  ,2023-02-07,2024-01-19,30.0,228,8809,9037
1515,TSLA  ,2023-02-07,2024-01-19,31.67,1328,1352,2680
1516,TSLA  ,2023-02-07,2024-01-19,33.33,4315,32868,37183
1517,TSLA  ,2023-02-07,2024-01-19,50.0,2159,29988,32147
1518,TSLA  ,2023-02-07,2024-01-19,55.0,81,1207,1288
1519,TSLA  ,2023-02-07,2024-01-19,60.0,250,2634,2884
1520,TSLA  ,2023-02-07,2024-01-19,65.0,266,807,1073
1521,TSLA  ,2023-02-07,2024-01-19,66.67,4705,14572,19277
1522,TSLA  ,2023-02-07,2024-01-19,70.0,143,876,1019
1523,TSLA  ,2023-02-07,2024-01-19,75.0,93,2710,2803
1524,TSLA  ,2023-02-07,2024-01-19,80.0,414,1730,2144
1525,TSLA  ,2023-02-07,2024-01-19,83.33,1066,7924,8990
1526,TSLA  ,2023-02-07,2024-01-19,85.0,513,511,1024
1527,TSLA  ,2023-02-07,2024-01-19,90.0,3520,1289,4809
1528,TSLA  ,2023-02-07,2024-01-19,95.0,3017,1354,4371
1529,TSLA  ,2023-02-07,2024-01-19,100.0,13813,38158,51971
1530,TSLA  ,2023-02-07,2024-01-19,105.0,1281,1909,3190
1531,TSLA  ,2023-02-07,2024-01-19,110.0,5032,7100,12132
1532,TSLA  ,2023-02-07,2024-01-19,115.0,4711,5590,10301
1533,TSLA  ,2023-02-07,2024-01-19,116.67,1937,8281,10218
1534,TSLA  ,2023-02-07,2024-01-19,120.0,3499,4632,8131
1535,TSLA  ,2023-02-07,2024-01-19,123.33,1985,2364,4349
1536,TSLA  ,2023-02-07,2024-01-19,125.0,2421,12637,15058
1537,TSLA  ,2023-02-07,2024-01-19,126.67,1745,6575,8320
1538,TSLA  ,2023-02-07,2024-01-19,130.0,5072,12059,17131
1539,TSLA  ,2023-02-07,2024-01-19,133.33,2438,10968,13406
1540,TSLA  ,2023-02-07,2024-01-19,135.0,1343,1285,2628
1541,TSLA  ,2023-02-07,2024-01-19,136.67,2441,2298,4739
1542,TSLA  ,2023-02-07,2024-01-19,140.0,5085,4512,9597
1543,TSLA  ,2023-02-07,2024-01-19,143.33,1687,2273,3960
1544,TSLA  ,2023-02-07,2024-01-19,145.0,757,834,1591
1545,TSLA  ,2023-02-07,2024-01-19,146.67,1027,983,2010
1546,TSLA  ,2023-02-07,2024-01-19,150.0,47535,22042,69577
1547,TSLA  ,2023-02-07,2024-01-19,153.33,40749,1044,41793
1548,TSLA  ,2023-02-07,2024-01-19,155.0,519,1457,1976
1549,TSLA  ,2023-02-07,2024-01-19,156.67,1734,787,2521
1550,TSLA  ,2023-02-07,2024-01-19,160.0,3634,12179,15813
1551,TSLA  ,2023-02-07,2024-01-19,163.33,506,7392,7898
1552,TSLA  ,2023-02-07,2024-01-19,165.0,677,447,1124
1553,TSLA  ,2023-02-07,2024-01-19,166.67,6756,6838,13594
1554,TSLA  ,2023-02-07,2024-01-19,170.0,3117,6046,9163
1555,TSLA  ,2023-02-07,2024-01-19,173.33,861,2564,3425
1556,TSLA  ,2023-02-07,2024-01-19,175.0,1702,2122,3824
1557,TSLA  ,2023-02-07,2024-01-19,176.67,1018,1262,2280
1558,TSLA  ,2023-02-07,2024-01-19,180.0,39204,9051,48255
1559,TSLA  ,2023-02-07,2024-01-19,183.33,34397,7357,41754
1560,TSLA  ,2023-02-07,2024-01-19,185.0,1617,717,2334
1561,TSLA  ,2023-02-07,2024-01-19,186.67,1255,2281,3536
1562,TSLA  ,2023-02-07,2024-01-19,190.0,1618,231,1849
1563,TSLA  ,2023-02-07,2024-01-19,193.33,2286,9729,12015
1564,TSLA  ,2023-02-07,2024-01-19,195.0,371,276,647
1565,TSLA  ,2023-02-07,2024-01-19,200.0,33337,24383,57720
1566,TSLA  ,2023-02-07,2024-01-19,203.33,6274,2222,8496
1567,TSLA  ,2023-02-07,2024-01-19,206.67,1631,1190,2821
1568,TSLA  ,2023-02-07,2024-01-19,210.0,4991,6341,11332
1569,TSLA  ,2023-02-07,2024-01-19,213.33,1563,2695,4258
1570,TSLA  ,2023-02-07,2024-01-19,216.67,9166,7347,16513
1571,TSLA  ,2023-02-07,2024-01-19,220.0,6639,7038,13677
1572,TSLA  ,2023-02-07,2024-01-19,223.33,5740,1398,7138
1573,TSLA  ,2023-02-07,2024-01-19,226.67,19981,3025,23006
1574,TSLA  ,2023-02-07,2024-01-19,230.0,13974,19014,32988
1575,TSLA  ,2023-02-07,2024-01-19,233.33,37160,13940,51100
1576,TSLA  ,2023-02-07,2024-01-19,236.67,1918,1679,3597
1577,TSLA  ,2023-02-07,2024-01-19,240.0,2410,4127,6537
1578,TSLA  ,2023-02-07,2024-01-19,243.33,1121,1969,3090
1579,TSLA  ,2023-02-07,2024-01-19,246.67,926,2117,3043
1580,TSLA  ,2023-02-07,2024-01-19,250.0,22165,5225,27390
1581,TSLA  ,2023-02-07,2024-01-19,253.33,2795,2103,4898
1582,TSLA  ,2023-02-07,2024-01-19,256.67,2829,1456,4285
1583,TSLA  ,2023-02-07,2024-01-19,260.0,7233,3161,10394
1584,TSLA  ,2023-02-07,2024-01-19,263.33,7772,2202,9974
1585,TSLA  ,2023-02-07,2024-01-19,266.67,10328,8941,19269
1586,TSLA  ,2023-02-07,2024-01-19,270.0,4351,5188,9539
1587,TSLA  ,2023-02-07,2024-01-19,273.33,3246,3091,6337
1588,TSLA  ,2023-02-07,2024-01-19,276.67,1746,1732,3478
1589,TSLA  ,2023-02-07,2024-01-19,280.0,9284,6487,15771
1590,TSLA  ,2023-02-07,2024-01-19,283.33,3102,2981,6083
1591,TSLA  ,2023-02-07,2024-01-19,286.67,2487,1503,3990
1592,TSLA  ,2023-02-07,2024-01-19,290.0,9094,556,9650
1593,TSLA  ,2023-02-07,2024-01-19,293.33,2085,1988,4073
1594,TSLA  ,2023-02-07,2024-01-19,296.67,2003,1734,3737
1595,TSLA  ,2023-02-07,2024-01-19,300.0,26509,6486,32995
1596,TSLA  ,2023-02-07,2024-01-19,303.33,3402,74,3476
1597,TSLA  ,2023-02-07,2024-01-19,306.67,6456,132,6588
1598,TSLA  ,2023-02-07,2024-01-19,310.0,3731,974,4705
1599,TSLA  ,2023-02-07,2024-01-19,313.33,1154,22,1176
1600,TSLA  ,2023-02-07,2024-01-19,316.67,4154,306,4460
1601,TSLA  ,2023-02-07,2024-01-19,320.0,5898,295,6193
1602,TSLA  ,2023-02-07,2024-01-19,323.33,467,246,713
1603,TSLA  ,2023-02-07,2024-01-19,325.0,10835,113,10948
1604,TSLA  ,2023-02-07,2024-01-19,326.67,1346,633,1979
1605,TSLA  ,2023-02-07,2024-01-19,330.0,7302,11,7313
1606,TSLA  ,2023-02-07,2024-01-19,333.33,29808,1694,31502
1607,TSLA  ,2023-02-07,2024-01-19,336.67,1466,7,1473
1608,TSLA  ,2023-02-07,2024-01-19,340.0,3882,3,3885
1609,TSLA  ,2023-02-07,2024-01-19,341.67,888,8,896
1610,TSLA  ,2023-02-07,2024-01-19,343.33,526,0,526
1611,TSLA  ,2023-02-07,2024-01-19,346.67,2389,3,2392
1612,TSLA  ,2023-02-07,2024-01-19,350.0,15332,312,15644
1613,TSLA  ,2023-02-07,2024-01-19,353.33,1154,0,1154
1614,TSLA  ,2023-02-07,2024-01-19,356.67,877,0,877
1615,TSLA  ,2023-02-07,2024-01-19,358.33,1324,3,1327
1616,TSLA  ,2023-02-07,2024-01-19,360.0,9211,600,9811
1617,TSLA  ,2023-02-07,2024-01-19,363.33,394,2,396
1618,TSLA  ,2023-02-07,2024-01-19,366.67,38773,2842,41615
1619,TSLA  ,2023-02-07,2024-01-19,370.0,6815,3,6818
1620,TSLA  ,2023-02-07,2024-01-19,373.33,1035,11,1046
1621,TSLA  ,2023-02-07,2024-01-19,375.0,11348,7,11355
1622,TSLA  ,2023-02-07,2024-01-19,376.67,520,106,626
1623,TSLA  ,2023-02-07,2024-01-19,380.0,1032,1,1033
1624,TSLA  ,2023-02-07,2024-01-19,383.33,3073,1,3074
1625,TSLA  ,2023-02-07,2024-01-19,386.67,408,203,611
1626,TSLA  ,2023-02-07,2024-01-19,390.0,877,1,878
1627,TSLA  ,2023-02-07,2024-01-19,391.67,2171,0,2171
1628,TSLA  ,2023-02-07,2024-01-19,393.33,555,4,559
1629,TSLA  ,2023-02-07,2024-01-19,396.67,2636,0,2636
1630,TSLA  ,2023-02-07,2024-01-19,400.0,38137,921,39058
1631,TSLA  ,2023-02-07,2024-01-19,408.33,5137,1,5138
1632,TSLA  ,2023-02-07,2024-01-19,416.67,3785,2140,5925
1633,TSLA  ,2023-02-07,2024-01-19,425.0,4651,2,4653
1634,TSLA  ,2023-02-07,2024-01-19,433.33,5677,3,5680
1635,TSLA  ,2023-02-07,2024-01-19,441.67,1146,0,1146
1636,TSLA  ,2023-02-07,2024-01-19,450.0,7985,2253,10238
1637,TSLA  ,2023-02-07,2024-01-19,458.33,1985,0,1985
1638,TSLA  ,2023-02-07,2024-01-19,466.67,28966,0,28966
1639,TSLA  ,2023-02-07,2024-01-19,475.0,4683,10,4693
1640,TSLA  ,2023-02-07,2024-01-19,483.33,1609,0,1609
1641,TSLA  ,2023-02-07,2024-01-19,491.67,2142,0,2142
1642,TSLA  ,2023-02-07,2024-01-19,500.0,36798,80,36878
1643,TSLA  ,2023-02-07,2024-01-19,516.67,4789,0,4789
1644,TSLA  ,2023-02-07,2024-01-19,533.33,20832,0,20832
1645,TSLA  ,2023-02-07,2024-01-19,550.0,16427,9,16436
1646,TSLA  ,2023-02-07,2024-01-19,558.33,1182,0,1182
1647,TSLA  ,2023-02-07,2024-01-19,566.67,11389,0,11389
1648,TSLA  ,2023-02-07,2024-01-19,575.0,13932,0,13932
1649,TSLA  ,2023-02-07,2024-01-19,583.33,13826,0,13826
1650,TSLA  ,2023-02-07,2024-01-19,591.67,2265,0,2265
1651,TSLA  ,2023-02-07,2024-01-19,600.0,18359,0,18359
1652,TSLA  ,2023-02-07,2024-01-19,608.33,2278,0,2278
1653,TSLA  ,2023-02-07,2024-01-19,616.67,11855,0,11855
1654,TSLA  ,2023-02-07,2024-01-19,625.0,2405,0,2405
1655,TSLA  ,2023-02-07,2024-01-19,633.33,5724,0,5724
1656,TSLA  ,2023-02-07,2024-01-19,641.67,926,0,926
1657,TSLA  ,2023-02-07,2024-01-19,650.0,3205,0,3205
1658,TSLA  ,2023-02-07,2024-01-19,666.67,41084,0,41084
1659,TSLA  ,2023-02-07,2024-01-19,675.0,4347,0,4347
1660,TSLA  ,2023-02-07,2024-01-19,683.33,7135,0,7135
1661,TSLA  ,2023-02-07,2024-01-19,691.67,1639,0,1639
1662,TSLA  ,2023-02-07,2024-01-19,700.0,5503,0,5503
1663,TSLA  ,2023-02-07,2024-01-19,708.33,761,0,761
1664,TSLA  ,2023-02-07,2024-01-19,716.67,6045,0,6045
1665,TSLA  ,2023-02-07,2024-01-19,725.0,2696,3,2699
1666,TSLA  ,2023-02-07,2024-01-19,733.33,3420,0,3420
1667,TSLA  ,2023-02-07,2024-01-19,741.67,795,0,795
1668,TSLA  ,2023-02-07,2024-01-19,750.0,2130,0,2130
1669,TSLA  ,2023-02-07,2024-01-19,758.33,939,0,939
1670,TSLA  ,2023-02-07,2024-01-19,766.67,2137,0,2137
1671,TSLA  ,2023-02-07,2024-01-19,775.0,2922,0,2922
1672,TSLA  ,2023-02-07,2024-01-19,783.33,692,0,692
1673,TSLA  ,2023-02-07,2024-01-19,791.67,3178,0,3178
1674,TSLA  ,2023-02-07,2024-01-19,800.0,13705,0,13705
1675,TSLA  ,2023-02-07,2024-01-19,808.33,3928,0,3928
1676,TSLA  ,2023-02-07,2024-01-19,816.67,5811,0,5811
1677,TSLA  ,2023-02-07,2024-01-19,825.0,75386,0,75386
1678,TSLA  ,2023-02-07,2024-03-15,1.67,107,1887,1994
1679,TSLA  ,2023-02-07,2024-03-15,3.33,22,769,791
1680,TSLA  ,2023-02-07,2024-03-15,5.0,64,842,906
1681,TSLA  ,2023-02-07,2024-03-15,6.67,6,93,99
1682,TSLA  ,2023-02-07,2024-03-15,8.33,16,42,58
1683,TSLA  ,2023-02-07,2024-03-15,10.0,6,307,313
1684,TSLA  ,2023-02-07,2024-03-15,11.67,11,189,200
1685,TSLA  ,2023-02-07,2024-03-15,13.33,18,35,53
1686,TSLA  ,2023-02-07,2024-03-15,15.0,24,192,216
1687,TSLA  ,2023-02-07,2024-03-15,16.67,124,209,333
1688,TSLA  ,2023-02-07,2024-03-15,33.33,809,1944,2753
1689,TSLA  ,2023-02-07,2024-03-15,50.0,447,5528,5975
1690,TSLA  ,2023-02-07,2024-03-15,55.0,28,300,328
1691,TSLA  ,2023-02-07,2024-03-15,60.0,44,772,816
1692,TSLA  ,2023-02-07,2024-03-15,65.0,22,649,671
1693,TSLA  ,2023-02-07,2024-03-15,66.67,2035,853,2888
1694,TSLA  ,2023-02-07,2024-03-15,70.0,51,217,268
1695,TSLA  ,2023-02-07,2024-03-15,75.0,20,398,418
1696,TSLA  ,2023-02-07,2024-03-15,80.0,191,472,663
1697,TSLA  ,2023-02-07,2024-03-15,83.33,999,4513,5512
1698,TSLA  ,2023-02-07,2024-03-15,85.0,291,209,500
1699,TSLA  ,2023-02-07,2024-03-15,90.0,742,393,1135
1700,TSLA  ,2023-02-07,2024-03-15,95.0,1558,406,1964
1701,TSLA  ,2023-02-07,2024-03-15,100.0,3366,3017,6383
1702,TSLA  ,2023-02-07,2024-03-15,105.0,818,717,1535
1703,TSLA  ,2023-02-07,2024-03-15,110.0,912,2486,3398
1704,TSLA  ,2023-02-07,2024-03-15,115.0,2033,104,2137
1705,TSLA  ,2023-02-07,2024-03-15,116.67,609,912,1521
1706,TSLA  ,2023-02-07,2024-03-15,120.0,328,567,895
1707,TSLA  ,2023-02-07,2024-03-15,125.0,663,676,1339
1708,TSLA  ,2023-02-07,2024-03-15,130.0,1571,444,2015
1709,TSLA  ,2023-02-07,2024-03-15,133.33,588,5692,6280
1710,TSLA  ,2023-02-07,2024-03-15,135.0,221,161,382
1711,TSLA  ,2023-02-07,2024-03-15,140.0,181,259,440
1712,TSLA  ,2023-02-07,2024-03-15,141.67,515,315,830
1713,TSLA  ,2023-02-07,2024-03-15,145.0,265,278,543
1714,TSLA  ,2023-02-07,2024-03-15,150.0,1293,4410,5703
1715,TSLA  ,2023-02-07,2024-03-15,155.0,86,160,246
1716,TSLA  ,2023-02-07,2024-03-15,158.33,172,556,728
1717,TSLA  ,2023-02-07,2024-03-15,160.0,212,4383,4595
1718,TSLA  ,2023-02-07,2024-03-15,165.0,147,3868,4015
1719,TSLA  ,2023-02-07,2024-03-15,166.67,588,1199,1787
1720,TSLA  ,2023-02-07,2024-03-15,170.0,272,8785,9057
1721,TSLA  ,2023-02-07,2024-03-15,175.0,676,1939,2615
1722,TSLA  ,2023-02-07,2024-03-15,180.0,300,454,754
1723,TSLA  ,2023-02-07,2024-03-15,183.33,529,1146,1675
1724,TSLA  ,2023-02-07,2024-03-15,185.0,217,143,360
1725,TSLA  ,2023-02-07,2024-03-15,190.0,164,208,372
1726,TSLA  ,2023-02-07,2024-03-15,191.67,631,1399,2030
1727,TSLA  ,2023-02-07,2024-03-15,195.0,549,121,670
1728,TSLA  ,2023-02-07,2024-03-15,200.0,4991,4675,9666
1729,TSLA  ,2023-02-07,2024-03-15,208.33,1131,744,1875
1730,TSLA  ,2023-02-07,2024-03-15,210.0,451,117,568
1731,TSLA  ,2023-02-07,2024-03-15,216.67,1167,995,2162
1732,TSLA  ,2023-02-07,2024-03-15,220.0,456,1,457
1733,TSLA  ,2023-02-07,2024-03-15,225.0,1373,2422,3795
1734,TSLA  ,2023-02-07,2024-03-15,230.0,188,16,204
1735,TSLA  ,2023-02-07,2024-03-15,233.33,1619,1230,2849
1736,TSLA  ,2023-02-07,2024-03-15,240.0,112,11,123
1737,TSLA  ,2023-02-07,2024-03-15,241.67,1130,955,2085
1738,TSLA  ,2023-02-07,2024-03-15,250.0,2034,1512,3546
1739,TSLA  ,2023-02-07,2024-03-15,258.33,4134,1096,5230
1740,TSLA  ,2023-02-07,2024-03-15,260.0,345,32,377
1741,TSLA  ,2023-02-07,2024-03-15,266.67,4453,801,5254
1742,TSLA  ,2023-02-07,2024-03-15,270.0,5,0,5
1743,TSLA  ,2023-02-07,2024-03-15,275.0,8959,1007,9966
1744,TSLA  ,2023-02-07,2024-03-15,280.0,13,2,15
1745,TSLA  ,2023-02-07,2024-03-15,283.33,1185,709,1894
1746,TSLA  ,2023-02-07,2024-03-15,291.67,1289,142,1431
1747,TSLA  ,2023-02-07,2024-03-15,300.0,4692,166,4858
1748,TSLA  ,2023-02-07,2024-03-15,308.33,383,36,419
1749,TSLA  ,2023-02-07,2024-03-15,316.67,927,389,1316
1750,TSLA  ,2023-02-07,2024-03-15,325.0,1587,16,1603
1751,TSLA  ,2023-02-07,2024-03-15,333.33,867,24,891
1752,TSLA  ,2023-02-07,2024-03-15,341.67,245,23,268
1753,TSLA  ,2023-02-07,2024-03-15,350.0,844,41,885
1754,TSLA  ,2023-02-07,2024-03-15,358.33,342,63,405
1755,TSLA  ,2023-02-07,2024-03-15,366.67,546,153,699
1756,TSLA  ,2023-02-07,2024-03-15,375.0,706,2,708
1757,TSLA  ,2023-02-07,2024-03-15,383.33,202,1334,1536
1758,TSLA  ,2023-02-07,2024-03-15,391.67,331,8,339
1759,TSLA  ,2023-02-07,2024-03-15,400.0,1093,21,1114
1760,TSLA  ,2023-02-07,2024-03-15,408.33,671,2,673
1761,TSLA  ,2023-02-07,2024-03-15,416.67,335,314,649
1762,TSLA  ,2023-02-07,2024-03-15,425.0,919,1,920
1763,TSLA  ,2023-02-07,2024-03-15,433.33,604,0,604
1764,TSLA  ,2023-02-07,2024-03-15,441.67,121,0,121
1765,TSLA  ,2023-02-07,2024-03-15,450.0,1459,0,1459
1766,TSLA  ,2023-02-07,2024-03-15,458.33,255,0,255
1767,TSLA  ,2023-02-07,2024-03-15,466.67,799,0,799
1768,TSLA  ,2023-02-07,2024-03-15,475.0,420,0,420
1769,TSLA  ,2023-02-07,2024-03-15,483.33,486,0,486
1770,TSLA  ,2023-02-07,2024-03-15,491.67,319,0,319
1771,TSLA  ,2023-02-07,2024-03-15,500.0,2859,0,2859
1772,TSLA  ,2023-02-07,2024-03-15,508.33,228,0,228
1773,TSLA  ,2023-02-07,2024-03-15,516.67,697,0,697
1774,TSLA  ,2023-02-07,2024-03-15,525.0,117,0,117
1775,TSLA  ,2023-02-07,2024-03-15,533.33,156,0,156
1776,TSLA  ,2023-02-07,2024-03-15,541.67,165,0,165
1777,TSLA  ,2023-02-07,2024-03-15,550.0,420,0,420
1778,TSLA  ,2023-02-07,2024-03-15,558.33,265,0,265
1779,TSLA  ,2023-02-07,2024-03-15,566.67,381,0,381
1780,TSLA  ,2023-02-07,2024-03-15,575.0,663,0,663
1781,TSLA  ,2023-02-07,2024-03-15,583.33,465,0,465
1782,TSLA  ,2023-02-07,2024-03-15,600.0,3555,1,3556
1783,TSLA  ,2023-02-07,2024-06-21,1.67,630,16472,17102
1784,TSLA  ,2023-02-07,2024-06-21,3.33,149,3260,3409
1785,TSLA  ,2023-02-07,2024-06-21,5.0,20,1502,1522
1786,TSLA  ,2023-02-07,2024-06-21,6.67,219,1208,1427
1787,TSLA  ,2023-02-07,2024-06-21,8.33,121,368,489
1788,TSLA  ,2023-02-07,2024-06-21,10.0,275,1826,2101
1789,TSLA  ,2023-02-07,2024-06-21,11.67,540,314,854
1790,TSLA  ,2023-02-07,2024-06-21,13.33,39,218,257
1791,TSLA  ,2023-02-07,2024-06-21,16.67,1404,3533,4937
1792,TSLA  ,2023-02-07,2024-06-21,33.33,7803,5382,13185
1793,TSLA  ,2023-02-07,2024-06-21,50.0,1914,3655,5569
1794,TSLA  ,2023-02-07,2024-06-21,55.0,6,363,369
1795,TSLA  ,2023-02-07,2024-06-21,60.0,57,507,564
1796,TSLA  ,2023-02-07,2024-06-21,65.0,111,2098,2209
1797,TSLA  ,2023-02-07,2024-06-21,66.67,1877,4346,6223
1798,TSLA  ,2023-02-07,2024-06-21,70.0,47,242,289
1799,TSLA  ,2023-02-07,2024-06-21,75.0,70,123,193
1800,TSLA  ,2023-02-07,2024-06-21,80.0,111,1100,1211
1801,TSLA  ,2023-02-07,2024-06-21,83.33,30599,4211,34810
1802,TSLA  ,2023-02-07,2024-06-21,85.0,60,745,805
1803,TSLA  ,2023-02-07,2024-06-21,90.0,535,1149,1684
1804,TSLA  ,2023-02-07,2024-06-21,95.0,363,348,711
1805,TSLA  ,2023-02-07,2024-06-21,100.0,5340,9766,15106
1806,TSLA  ,2023-02-07,2024-06-21,105.0,796,794,1590
1807,TSLA  ,2023-02-07,2024-06-21,110.0,496,2178,2674
1808,TSLA  ,2023-02-07,2024-06-21,115.0,413,251,664
1809,TSLA  ,2023-02-07,2024-06-21,116.67,2427,1017,3444
1810,TSLA  ,2023-02-07,2024-06-21,120.0,554,1202,1756
1811,TSLA  ,2023-02-07,2024-06-21,123.33,644,3492,4136
1812,TSLA  ,2023-02-07,2024-06-21,125.0,135,2431,2566
1813,TSLA  ,2023-02-07,2024-06-21,126.67,689,1278,1967
1814,TSLA  ,2023-02-07,2024-06-21,130.0,5843,1507,7350
1815,TSLA  ,2023-02-07,2024-06-21,133.33,6536,2854,9390
1816,TSLA  ,2023-02-07,2024-06-21,135.0,66,353,419
1817,TSLA  ,2023-02-07,2024-06-21,136.67,443,1886,2329
1818,TSLA  ,2023-02-07,2024-06-21,140.0,1460,2360,3820
1819,TSLA  ,2023-02-07,2024-06-21,143.33,1356,1748,3104
1820,TSLA  ,2023-02-07,2024-06-21,145.0,586,215,801
1821,TSLA  ,2023-02-07,2024-06-21,146.67,1614,565,2179
1822,TSLA  ,2023-02-07,2024-06-21,150.0,4346,9883,14229
1823,TSLA  ,2023-02-07,2024-06-21,153.33,257,836,1093
1824,TSLA  ,2023-02-07,2024-06-21,155.0,92,418,510
1825,TSLA  ,2023-02-07,2024-06-21,156.67,392,226,618
1826,TSLA  ,2023-02-07,2024-06-21,160.0,907,2691,3598
1827,TSLA  ,2023-02-07,2024-06-21,163.33,183,1425,1608
1828,TSLA  ,2023-02-07,2024-06-21,165.0,344,891,1235
1829,TSLA  ,2023-02-07,2024-06-21,166.67,1729,5489,7218
1830,TSLA  ,2023-02-07,2024-06-21,170.0,308,822,1130
1831,TSLA  ,2023-02-07,2024-06-21,173.33,526,5883,6409
1832,TSLA  ,2023-02-07,2024-06-21,175.0,1044,349,1393
1833,TSLA  ,2023-02-07,2024-06-21,180.0,1405,6085,7490
1834,TSLA  ,2023-02-07,2024-06-21,183.33,952,3703,4655
1835,TSLA  ,2023-02-07,2024-06-21,185.0,295,228,523
1836,TSLA  ,2023-02-07,2024-06-21,186.67,1326,1750,3076
1837,TSLA  ,2023-02-07,2024-06-21,190.0,306,84,390
1838,TSLA  ,2023-02-07,2024-06-21,193.33,1018,4288,5306
1839,TSLA  ,2023-02-07,2024-06-21,195.0,228,65,293
1840,TSLA  ,2023-02-07,2024-06-21,200.0,4770,9745,14515
1841,TSLA  ,2023-02-07,2024-06-21,206.67,962,2850,3812
1842,TSLA  ,2023-02-07,2024-06-21,210.0,371,91,462
1843,TSLA  ,2023-02-07,2024-06-21,213.33,770,1498,2268
1844,TSLA  ,2023-02-07,2024-06-21,216.67,1513,5251,6764
1845,TSLA  ,2023-02-07,2024-06-21,220.0,2039,2408,4447
1846,TSLA  ,2023-02-07,2024-06-21,226.67,2323,3403,5726
1847,TSLA  ,2023-02-07,2024-06-21,230.0,296,58,354
1848,TSLA  ,2023-02-07,2024-06-21,233.33,6559,7119,13678
1849,TSLA  ,2023-02-07,2024-06-21,240.0,1379,4867,6246
1850,TSLA  ,2023-02-07,2024-06-21,246.67,2026,1307,3333
1851,TSLA  ,2023-02-07,2024-06-21,250.0,5396,3526,8922
1852,TSLA  ,2023-02-07,2024-06-21,253.33,1278,853,2131
1853,TSLA  ,2023-02-07,2024-06-21,260.0,1970,953,2923
1854,TSLA  ,2023-02-07,2024-06-21,266.67,10071,3359,13430
1855,TSLA  ,2023-02-07,2024-06-21,270.0,1468,1818,3286
1856,TSLA  ,2023-02-07,2024-06-21,273.33,1227,792,2019
1857,TSLA  ,2023-02-07,2024-06-21,276.67,1010,790,1800
1858,TSLA  ,2023-02-07,2024-06-21,280.0,1164,1544,2708
1859,TSLA  ,2023-02-07,2024-06-21,283.33,3522,1346,4868
1860,TSLA  ,2023-02-07,2024-06-21,286.67,973,760,1733
1861,TSLA  ,2023-02-07,2024-06-21,290.0,2233,1110,3343
1862,TSLA  ,2023-02-07,2024-06-21,293.33,1029,966,1995
1863,TSLA  ,2023-02-07,2024-06-21,296.67,806,360,1166
1864,TSLA  ,2023-02-07,2024-06-21,300.0,9156,886,10042
1865,TSLA  ,2023-02-07,2024-06-21,303.33,1342,645,1987
1866,TSLA  ,2023-02-07,2024-06-21,306.67,1501,237,1738
1867,TSLA  ,2023-02-07,2024-06-21,310.0,1717,518,2235
1868,TSLA  ,2023-02-07,2024-06-21,313.33,901,719,1620
1869,TSLA  ,2023-02-07,2024-06-21,316.67,2286,12,2298
1870,TSLA  ,2023-02-07,2024-06-21,320.0,690,691,1381
1871,TSLA  ,2023-02-07,2024-06-21,323.33,395,308,703
1872,TSLA  ,2023-02-07,2024-06-21,326.67,582,273,855
1873,TSLA  ,2023-02-07,2024-06-21,330.0,2697,123,2820
1874,TSLA  ,2023-02-07,2024-06-21,333.33,7574,1092,8666
1875,TSLA  ,2023-02-07,2024-06-21,336.67,2289,238,2527
1876,TSLA  ,2023-02-07,2024-06-21,340.0,790,29,819
1877,TSLA  ,2023-02-07,2024-06-21,343.33,1155,89,1244
1878,TSLA  ,2023-02-07,2024-06-21,346.67,397,41,438
1879,TSLA  ,2023-02-07,2024-06-21,350.0,3406,5,3411
1880,TSLA  ,2023-02-07,2024-06-21,353.33,199,69,268
1881,TSLA  ,2023-02-07,2024-06-21,356.67,493,0,493
1882,TSLA  ,2023-02-07,2024-06-21,360.0,2622,12,2634
1883,TSLA  ,2023-02-07,2024-06-21,363.33,366,0,366
1884,TSLA  ,2023-02-07,2024-06-21,366.67,4715,0,4715
1885,TSLA  ,2023-02-07,2024-06-21,370.0,3050,9,3059
1886,TSLA  ,2023-02-07,2024-06-21,373.33,556,0,556
1887,TSLA  ,2023-02-07,2024-06-21,376.67,816,0,816
1888,TSLA  ,2023-02-07,2024-06-21,380.0,683,0,683
1889,TSLA  ,2023-02-07,2024-06-21,383.33,1028,11,1039
1890,TSLA  ,2023-02-07,2024-06-21,386.67,316,5,321
1891,TSLA  ,2023-02-07,2024-06-21,390.0,448,0,448
1892,TSLA  ,2023-02-07,2024-06-21,393.33,884,1,885
1893,TSLA  ,2023-02-07,2024-06-21,396.67,721,0,721
1894,TSLA  ,2023-02-07,2024-06-21,400.0,38921,34,38955
1895,TSLA  ,2023-02-07,2024-06-21,416.67,3090,0,3090
1896,TSLA  ,2023-02-07,2024-06-21,433.33,3268,0,3268
1897,TSLA  ,2023-02-07,2024-06-21,450.0,3185,0,3185
1898,TSLA  ,2023-02-07,2024-06-21,466.67,5346,0,5346
1899,TSLA  ,2023-02-07,2024-06-21,483.33,1100,0,1100
1900,TSLA  ,2023-02-07,2024-06-21,500.0,10915,0,10915
1901,TSLA  ,2023-02-07,2024-06-21,516.67,2087,0,2087
1902,TSLA  ,2023-02-07,2024-06-21,533.33,3138,0,3138
1903,TSLA  ,2023-02-07,2024-06-21,550.0,2605,0,2605
1904,TSLA  ,2023-02-07,2024-06-21,566.67,1010,0,1010
1905,TSLA  ,2023-02-07,2024-06-21,583.33,1035,0,1035
1906,TSLA  ,2023-02-07,2024-06-21,600.0,17160,0,17160
1907,TSLA  ,2023-02-07,2024-06-21,616.67,14001,0,14001
1908,TSLA  ,2023-02-07,2024-06-21,633.33,4574,0,4574
1909,TSLA  ,2023-02-07,2024-06-21,650.0,607,0,607
1910,TSLA  ,2023-02-07,2024-06-21,666.67,6571,0,6571
1911,TSLA  ,2023-02-07,2024-06-21,683.33,1688,0,1688
1912,TSLA  ,2023-02-07,2024-06-21,700.0,3759,0,3759
1913,TSLA  ,2023-02-07,2024-06-21,716.67,889,0,889
1914,TSLA  ,2023-02-07,2024-06-21,733.33,2247,0,2247
1915,TSLA  ,2023-02-07,2024-06-21,750.0,6262,1,6263
1916,TSLA  ,2023-02-07,2024-06-21,758.33,13969,0,13969
1917,TSLA  ,2023-02-07,2024-09-20,50.0,44,877,921
1918,TSLA  ,2023-02-07,2024-09-20,55.0,29,53,82
1919,TSLA  ,2023-02-07,2024-09-20,60.0,10,159,169
1920,TSLA  ,2023-02-07,2024-09-20,65.0,32,69,101
1921,TSLA  ,2023-02-07,2024-09-20,70.0,9,134,143
1922,TSLA  ,2023-02-07,2024-09-20,75.0,10,2322,2332
1923,TSLA  ,2023-02-07,2024-09-20,80.0,63,140,203
1924,TSLA  ,2023-02-07,2024-09-20,85.0,985,454,1439
1925,TSLA  ,2023-02-07,2024-09-20,90.0,47,191,238
1926,TSLA  ,2023-02-07,2024-09-20,95.0,22,421,443
1927,TSLA  ,2023-02-07,2024-09-20,100.0,377,2248,2625
1928,TSLA  ,2023-02-07,2024-09-20,105.0,189,620,809
1929,TSLA  ,2023-02-07,2024-09-20,110.0,170,792,962
1930,TSLA  ,2023-02-07,2024-09-20,115.0,558,582,1140
1931,TSLA  ,2023-02-07,2024-09-20,120.0,738,558,1296
1932,TSLA  ,2023-02-07,2024-09-20,125.0,324,1206,1530
1933,TSLA  ,2023-02-07,2024-09-20,130.0,609,841,1450
1934,TSLA  ,2023-02-07,2024-09-20,135.0,598,284,882
1935,TSLA  ,2023-02-07,2024-09-20,140.0,1097,344,1441
1936,TSLA  ,2023-02-07,2024-09-20,145.0,1280,345,1625
1937,TSLA  ,2023-02-07,2024-09-20,150.0,1428,2724,4152
1938,TSLA  ,2023-02-07,2024-09-20,155.0,532,292,824
1939,TSLA  ,2023-02-07,2024-09-20,160.0,325,830,1155
1940,TSLA  ,2023-02-07,2024-09-20,165.0,254,109,363
1941,TSLA  ,2023-02-07,2024-09-20,170.0,191,240,431
1942,TSLA  ,2023-02-07,2024-09-20,175.0,221,132,353
1943,TSLA  ,2023-02-07,2024-09-20,180.0,743,70,813
1944,TSLA  ,2023-02-07,2024-09-20,185.0,829,997,1826
1945,TSLA  ,2023-02-07,2024-09-20,190.0,1486,94,1580
1946,TSLA  ,2023-02-07,2024-09-20,195.0,1409,117,1526
1947,TSLA  ,2023-02-07,2024-09-20,200.0,1749,1408,3157
1948,TSLA  ,2023-02-07,2024-09-20,210.0,719,262,981
1949,TSLA  ,2023-02-07,2024-09-20,220.0,1328,381,1709
1950,TSLA  ,2023-02-07,2024-09-20,230.0,545,139,684
1951,TSLA  ,2023-02-07,2024-09-20,240.0,409,290,699
1952,TSLA  ,2023-02-07,2024-09-20,250.0,614,324,938
1953,TSLA  ,2023-02-07,2024-09-20,260.0,763,100,863
1954,TSLA  ,2023-02-07,2024-09-20,270.0,255,531,786
1955,TSLA  ,2023-02-07,2024-09-20,280.0,283,445,728
1956,TSLA  ,2023-02-07,2024-09-20,290.0,450,2660,3110
1957,TSLA  ,2023-02-07,2024-09-20,300.0,1066,1071,2137
1958,TSLA  ,2023-02-07,2024-09-20,310.0,123,700,823
1959,TSLA  ,2023-02-07,2024-09-20,320.0,105,192,297
1960,TSLA  ,2023-02-07,2024-09-20,330.0,85,52,137
1961,TSLA  ,2023-02-07,2024-09-20,340.0,697,16,713
1962,TSLA  ,2023-02-07,2024-09-20,350.0,1408,33,1441
1963,TSLA  ,2023-02-07,2024-09-20,360.0,58,37,95
1964,TSLA  ,2023-02-07,2024-09-20,370.0,1,2,3
1965,TSLA  ,2023-02-07,2024-09-20,380.0,10,0,10
1966,TSLA  ,2023-02-07,2024-09-20,390.0,7,16,23
1967,TSLA  ,2023-02-07,2025-01-17,5.0,671,11157,11828
1968,TSLA  ,2023-02-07,2025-01-17,10.0,138,804,942
1969,TSLA  ,2023-02-07,2025-01-17,15.0,29,888,917
1970,TSLA  ,2023-02-07,2025-01-17,20.0,386,5830,6216
1971,TSLA  ,2023-02-07,2025-01-17,25.0,103,2456,2559
1972,TSLA  ,2023-02-07,2025-01-17,30.0,13816,16485,30301
1973,TSLA  ,2023-02-07,2025-01-17,35.0,267,1090,1357
1974,TSLA  ,2023-02-07,2025-01-17,40.0,14712,15779,30491
1975,TSLA  ,2023-02-07,2025-01-17,45.0,2979,3220,6199
1976,TSLA  ,2023-02-07,2025-01-17,50.0,2746,9160,11906
1977,TSLA  ,2023-02-07,2025-01-17,55.0,2004,4212,6216
1978,TSLA  ,2023-02-07,2025-01-17,60.0,590,2030,2620
1979,TSLA  ,2023-02-07,2025-01-17,65.0,1649,1576,3225
1980,TSLA  ,2023-02-07,2025-01-17,70.0,2475,2202,4677
1981,TSLA  ,2023-02-07,2025-01-17,75.0,187,4382,4569
1982,TSLA  ,2023-02-07,2025-01-17,80.0,1310,1865,3175
1983,TSLA  ,2023-02-07,2025-01-17,85.0,1827,1489,3316
1984,TSLA  ,2023-02-07,2025-01-17,90.0,1139,5573,6712
1985,TSLA  ,2023-02-07,2025-01-17,95.0,130,401,531
1986,TSLA  ,2023-02-07,2025-01-17,100.0,5454,17488,22942
1987,TSLA  ,2023-02-07,2025-01-17,105.0,317,1577,1894
1988,TSLA  ,2023-02-07,2025-01-17,110.0,5444,7068,12512
1989,TSLA  ,2023-02-07,2025-01-17,115.0,3624,3541,7165
1990,TSLA  ,2023-02-07,2025-01-17,120.0,8567,6138,14705
1991,TSLA  ,2023-02-07,2025-01-17,125.0,2158,1157,3315
1992,TSLA  ,2023-02-07,2025-01-17,130.0,5690,7171,12861
1993,TSLA  ,2023-02-07,2025-01-17,135.0,5699,692,6391
1994,TSLA  ,2023-02-07,2025-01-17,140.0,8560,4610,13170
1995,TSLA  ,2023-02-07,2025-01-17,145.0,767,680,1447
1996,TSLA  ,2023-02-07,2025-01-17,150.0,12399,11818,24217
1997,TSLA  ,2023-02-07,2025-01-17,155.0,236,469,705
1998,TSLA  ,2023-02-07,2025-01-17,160.0,5963,5552,11515
1999,TSLA  ,2023-02-07,2025-01-17,165.0,246,833,1079
2000,TSLA  ,2023-02-07,2025-01-17,170.0,35462,9684,45146
2001,TSLA  ,2023-02-07,2025-01-17,175.0,33612,4551,38163
2002,TSLA  ,2023-02-07,2025-01-17,180.0,3689,8249,11938
2003,TSLA  ,2023-02-07,2025-01-17,185.0,1327,4494,5821
2004,TSLA  ,2023-02-07,2025-01-17,190.0,5705,4514,10219
2005,TSLA  ,2023-02-07,2025-01-17,195.0,3226,1729,4955
2006,TSLA  ,2023-02-07,2025-01-17,200.0,27919,12381,40300
2007,TSLA  ,2023-02-07,2025-01-17,210.0,4895,2647,7542
2008,TSLA  ,2023-02-07,2025-01-17,220.0,3086,4159,7245
2009,TSLA  ,2023-02-07,2025-01-17,230.0,4045,3262,7307
2010,TSLA  ,2023-02-07,2025-01-17,240.0,4623,4345,8968
2011,TSLA  ,2023-02-07,2025-01-17,250.0,11682,5032,16714
2012,TSLA  ,2023-02-07,2025-01-17,260.0,5672,1777,7449
2013,TSLA  ,2023-02-07,2025-01-17,270.0,3031,1232,4263
2014,TSLA  ,2023-02-07,2025-01-17,280.0,2259,3345,5604
2015,TSLA  ,2023-02-07,2025-01-17,290.0,3437,2808,6245
2016,TSLA  ,2023-02-07,2025-01-17,300.0,31129,3104,34233
2017,TSLA  ,2023-02-07,2025-01-17,310.0,4403,687,5090
2018,TSLA  ,2023-02-07,2025-01-17,320.0,1647,792,2439
2019,TSLA  ,2023-02-07,2025-01-17,330.0,2396,939,3335
2020,TSLA  ,2023-02-07,2025-01-17,340.0,1255,411,1666
2021,TSLA  ,2023-02-07,2025-01-17,350.0,6955,566,7521
2022,TSLA  ,2023-02-07,2025-01-17,360.0,2088,152,2240
2023,TSLA  ,2023-02-07,2025-01-17,370.0,2074,297,2371
2024,TSLA  ,2023-02-07,2025-01-17,380.0,1544,46,1590
2025,TSLA  ,2023-02-07,2025-01-17,390.0,2066,64,2130
2026,TSLA  ,2023-02-07,2025-01-17,400.0,18757,98,18855
2027,TSLA  ,2023-02-07,2025-01-17,410.0,4197,2,4199
2028,TSLA  ,2023-02-07,2025-01-17,420.0,2903,8,2911
2029,TSLA  ,2023-02-07,2025-01-17,430.0,561,2,563
2030,TSLA  ,2023-02-07,2025-01-17,440.0,641,7,648
2031,TSLA  ,2023-02-07,2025-01-17,450.0,3575,3,3578
2032,TSLA  ,2023-02-07,2025-01-17,460.0,910,4,914
2033,TSLA  ,2023-02-07,2025-01-17,470.0,1551,1,1552
2034,TSLA  ,2023-02-07,2025-01-17,480.0,1248,1,1249
2035,TSLA  ,2023-02-07,2025-01-17,490.0,699,0,699
2036,TSLA  ,2023-02-07,2025-01-17,500.0,10768,2,10770
2037,TSLA  ,2023-02-07,2025-01-17,510.0,1148,1,1149
2038,TSLA  ,2023-02-07,2025-01-17,520.0,8333,1,8334
2039,TSLA  ,2023-02-07,2025-01-17,530.0,644,0,644
2040,TSLA  ,2023-02-07,2025-01-17,540.0,595,0,595
2041,TSLA  ,2023-02-07,2025-01-17,550.0,3016,0,3016
2042,TSLA  ,2023-02-07,2025-01-17,560.0,628,0,628
2043,TSLA  ,2023-02-07,2025-01-17,570.0,674,2,676
2044,TSLA  ,2023-02-07,2025-01-17,580.0,846,0,846
2045,TSLA  ,2023-02-07,2025-01-17,590.0,811,0,811
2046,TSLA  ,2023-02-07,2025-01-17,600.0,15212,5,15217
2047,TSLA  ,2023-02-07,2025-01-17,610.0,17784,0,17784
2048,TSLA  ,2023-02-07,2025-06-20,5.0,189,722,911
2049,TSLA  ,2023-02-07,2025-06-20,10.0,2,84,86
2050,TSLA  ,2023-02-07,2025-06-20,15.0,7,4786,4793
2051,TSLA  ,2023-02-07,2025-06-20,20.0,38,301,339
2052,TSLA  ,2023-02-07,2025-06-20,25.0,9,114,123
2053,TSLA  ,2023-02-07,2025-06-20,30.0,83,177,260
2054,TSLA  ,2023-02-07,2025-06-20,35.0,11,178,189
2055,TSLA  ,2023-02-07,2025-06-20,40.0,8,254,262
2056,TSLA  ,2023-02-07,2025-06-20,45.0,16,52,68
2057,TSLA  ,2023-02-07,2025-06-20,50.0,142,600,742
2058,TSLA  ,2023-02-07,2025-06-20,55.0,10,42,52
2059,TSLA  ,2023-02-07,2025-06-20,60.0,16,621,637
2060,TSLA  ,2023-02-07,2025-06-20,65.0,20,573,593
2061,TSLA  ,2023-02-07,2025-06-20,70.0,159,135,294
2062,TSLA  ,2023-02-07,2025-06-20,75.0,119,1279,1398
2063,TSLA  ,2023-02-07,2025-06-20,80.0,805,421,1226
2064,TSLA  ,2023-02-07,2025-06-20,85.0,346,242,588
2065,TSLA  ,2023-02-07,2025-06-20,90.0,10297,433,10730
2066,TSLA  ,2023-02-07,2025-06-20,95.0,46406,537,46943
2067,TSLA  ,2023-02-07,2025-06-20,100.0,856,4388,5244
2068,TSLA  ,2023-02-07,2025-06-20,105.0,158,407,565
2069,TSLA  ,2023-02-07,2025-06-20,110.0,343,1624,1967
2070,TSLA  ,2023-02-07,2025-06-20,115.0,434,304,738
2071,TSLA  ,2023-02-07,2025-06-20,120.0,461,941,1402
2072,TSLA  ,2023-02-07,2025-06-20,125.0,510,354,864
2073,TSLA  ,2023-02-07,2025-06-20,130.0,2640,2121,4761
2074,TSLA  ,2023-02-07,2025-06-20,135.0,4713,148,4861
2075,TSLA  ,2023-02-07,2025-06-20,140.0,985,2252,3237
2076,TSLA  ,2023-02-07,2025-06-20,145.0,396,492,888
2077,TSLA  ,2023-02-07,2025-06-20,150.0,1237,1360,2597
2078,TSLA  ,2023-02-07,2025-06-20,155.0,408,133,541
2079,TSLA  ,2023-02-07,2025-06-20,160.0,1816,1081,2897
2080,TSLA  ,2023-02-07,2025-06-20,165.0,909,343,1252
2081,TSLA  ,2023-02-07,2025-06-20,170.0,587,1431,2018
2082,TSLA  ,2023-02-07,2025-06-20,175.0,720,1095,1815
2083,TSLA  ,2023-02-07,2025-06-20,180.0,615,1068,1683
2084,TSLA  ,2023-02-07,2025-06-20,185.0,166,160,326
2085,TSLA  ,2023-02-07,2025-06-20,190.0,412,252,664
2086,TSLA  ,2023-02-07,2025-06-20,195.0,267,321,588
2087,TSLA  ,2023-02-07,2025-06-20,200.0,3558,2756,6314
2088,TSLA  ,2023-02-07,2025-06-20,205.0,152,206,358
2089,TSLA  ,2023-02-07,2025-06-20,210.0,313,40,353
2090,TSLA  ,2023-02-07,2025-06-20,215.0,91,25,116
2091,TSLA  ,2023-02-07,2025-06-20,220.0,619,78,697
2092,TSLA  ,2023-02-07,2025-06-20,225.0,409,137,546
2093,TSLA  ,2023-02-07,2025-06-20,230.0,279,46,325
2094,TSLA  ,2023-02-07,2025-06-20,235.0,321,167,488
2095,TSLA  ,2023-02-07,2025-06-20,240.0,4318,238,4556
2096,TSLA  ,2023-02-07,2025-06-20,250.0,1280,430,1710
2097,TSLA  ,2023-02-07,2025-06-20,260.0,278,279,557
2098,TSLA  ,2023-02-07,2025-06-20,270.0,463,103,566
2099,TSLA  ,2023-02-07,2025-06-20,280.0,169,187,356
2100,TSLA  ,2023-02-07,2025-06-20,290.0,214,148,362
2101,TSLA  ,2023-02-07,2025-06-20,300.0,2202,581,2783
2102,TSLA  ,2023-02-07,2025-06-20,310.0,137,178,315
2103,TSLA  ,2023-02-07,2025-06-20,320.0,839,284,1123
2104,TSLA  ,2023-02-07,2025-06-20,330.0,104,186,290
2105,TSLA  ,2023-02-07,2025-06-20,340.0,80,106,186
2106,TSLA  ,2023-02-07,2025-06-20,350.0,1688,160,1848
2107,TSLA  ,2023-02-07,2025-06-20,360.0,584,196,780
2108,TSLA  ,2023-02-07,2025-06-20,370.0,7,149,156
2109,TSLA  ,2023-02-07,2025-06-20,380.0,26,1,27
2110,TSLA  ,2023-02-07,2025-06-20,390.0,399,2,401
