index,ProductSymbol,DateGen,ExpDate,Strike,Call,Put,TotalOI
0,TSLA  ,2023-02-14,2023-02-17,15.0,171,310,481
1,TSLA  ,2023-02-14,2023-02-17,20.0,35,46,81
2,TSLA  ,2023-02-14,2023-02-17,25.0,4,99,103
3,TSLA  ,2023-02-14,2023-02-17,30.0,71,2723,2794
4,TSLA  ,2023-02-14,2023-02-17,35.0,0,5414,5414
5,TSLA  ,2023-02-14,2023-02-17,40.0,163,10382,10545
6,TSLA  ,2023-02-14,2023-02-17,45.0,0,1739,1739
7,TSLA  ,2023-02-14,2023-02-17,50.0,852,17127,17979
8,TSLA  ,2023-02-14,2023-02-17,55.0,44,5311,5355
9,TSLA  ,2023-02-14,2023-02-17,60.0,321,9057,9378
10,TSLA  ,2023-02-14,2023-02-17,65.0,28,6534,6562
11,TSLA  ,2023-02-14,2023-02-17,70.0,72,54689,54761
12,TSLA  ,2023-02-14,2023-02-17,75.0,124,7654,7778
13,TSLA  ,2023-02-14,2023-02-17,80.0,189,52817,53006
14,TSLA  ,2023-02-14,2023-02-17,85.0,259,14038,14297
15,TSLA  ,2023-02-14,2023-02-17,90.0,283,17204,17487
16,TSLA  ,2023-02-14,2023-02-17,95.0,822,20345,21167
17,TSLA  ,2023-02-14,2023-02-17,100.0,3235,39674,42909
18,TSLA  ,2023-02-14,2023-02-17,105.0,20720,29926,50646
19,TSLA  ,2023-02-14,2023-02-17,110.0,3347,26853,30200
20,TSLA  ,2023-02-14,2023-02-17,115.0,15313,28403,43716
21,TSLA  ,2023-02-14,2023-02-17,118.0,297,2416,2713
22,TSLA  ,2023-02-14,2023-02-17,119.0,22,2223,2245
23,TSLA  ,2023-02-14,2023-02-17,120.0,25869,48891,74760
24,TSLA  ,2023-02-14,2023-02-17,121.0,37,2016,2053
25,TSLA  ,2023-02-14,2023-02-17,122.0,185,1328,1513
26,TSLA  ,2023-02-14,2023-02-17,123.0,141,2419,2560
27,TSLA  ,2023-02-14,2023-02-17,124.0,51,3065,3116
28,TSLA  ,2023-02-14,2023-02-17,125.0,12175,18095,30270
29,TSLA  ,2023-02-14,2023-02-17,126.0,43,1292,1335
30,TSLA  ,2023-02-14,2023-02-17,127.0,78,1531,1609
31,TSLA  ,2023-02-14,2023-02-17,128.0,52,2642,2694
32,TSLA  ,2023-02-14,2023-02-17,129.0,95,2205,2300
33,TSLA  ,2023-02-14,2023-02-17,130.0,13439,15796,29235
34,TSLA  ,2023-02-14,2023-02-17,131.0,151,1373,1524
35,TSLA  ,2023-02-14,2023-02-17,132.0,239,2484,2723
36,TSLA  ,2023-02-14,2023-02-17,133.0,71,1922,1993
37,TSLA  ,2023-02-14,2023-02-17,134.0,429,3420,3849
38,TSLA  ,2023-02-14,2023-02-17,135.0,7606,11830,19436
39,TSLA  ,2023-02-14,2023-02-17,136.0,1453,4765,6218
40,TSLA  ,2023-02-14,2023-02-17,137.0,868,1987,2855
41,TSLA  ,2023-02-14,2023-02-17,138.0,1247,4443,5690
42,TSLA  ,2023-02-14,2023-02-17,139.0,977,1719,2696
43,TSLA  ,2023-02-14,2023-02-17,140.0,7901,16639,24540
44,TSLA  ,2023-02-14,2023-02-17,141.0,651,3654,4305
45,TSLA  ,2023-02-14,2023-02-17,142.0,1010,2285,3295
46,TSLA  ,2023-02-14,2023-02-17,143.0,385,1455,1840
47,TSLA  ,2023-02-14,2023-02-17,144.0,323,2774,3097
48,TSLA  ,2023-02-14,2023-02-17,145.0,11917,23252,35169
49,TSLA  ,2023-02-14,2023-02-17,146.0,1800,2241,4041
50,TSLA  ,2023-02-14,2023-02-17,147.0,531,5585,6116
51,TSLA  ,2023-02-14,2023-02-17,148.0,240,3760,4000
52,TSLA  ,2023-02-14,2023-02-17,149.0,448,3189,3637
53,TSLA  ,2023-02-14,2023-02-17,150.0,15217,34507,49724
54,TSLA  ,2023-02-14,2023-02-17,152.5,1024,3101,4125
55,TSLA  ,2023-02-14,2023-02-17,155.0,9077,12517,21594
56,TSLA  ,2023-02-14,2023-02-17,157.5,1685,5327,7012
57,TSLA  ,2023-02-14,2023-02-17,160.0,29102,31916,61018
58,TSLA  ,2023-02-14,2023-02-17,162.5,1575,6731,8306
59,TSLA  ,2023-02-14,2023-02-17,165.0,12809,16716,29525
60,TSLA  ,2023-02-14,2023-02-17,167.5,1134,5573,6707
61,TSLA  ,2023-02-14,2023-02-17,170.0,22860,40401,63261
62,TSLA  ,2023-02-14,2023-02-17,172.5,2223,7934,10157
63,TSLA  ,2023-02-14,2023-02-17,175.0,9330,21850,31180
64,TSLA  ,2023-02-14,2023-02-17,177.5,2414,5932,8346
65,TSLA  ,2023-02-14,2023-02-17,180.0,17578,28176,45754
66,TSLA  ,2023-02-14,2023-02-17,182.5,5064,4756,9820
67,TSLA  ,2023-02-14,2023-02-17,185.0,14355,19568,33923
68,TSLA  ,2023-02-14,2023-02-17,187.5,2728,7718,10446
69,TSLA  ,2023-02-14,2023-02-17,190.0,20020,25890,45910
70,TSLA  ,2023-02-14,2023-02-17,192.5,5797,5934,11731
71,TSLA  ,2023-02-14,2023-02-17,195.0,17226,9460,26686
72,TSLA  ,2023-02-14,2023-02-17,197.5,9784,4320,14104
73,TSLA  ,2023-02-14,2023-02-17,200.0,48950,19032,67982
74,TSLA  ,2023-02-14,2023-02-17,202.5,12622,2976,15598
75,TSLA  ,2023-02-14,2023-02-17,205.0,17037,3942,20979
76,TSLA  ,2023-02-14,2023-02-17,207.5,5706,2700,8406
77,TSLA  ,2023-02-14,2023-02-17,210.0,30668,6361,37029
78,TSLA  ,2023-02-14,2023-02-17,212.5,6941,1736,8677
79,TSLA  ,2023-02-14,2023-02-17,215.0,21216,2932,24148
80,TSLA  ,2023-02-14,2023-02-17,217.5,11252,566,11818
81,TSLA  ,2023-02-14,2023-02-17,220.0,37311,4228,41539
82,TSLA  ,2023-02-14,2023-02-17,222.5,3603,319,3922
83,TSLA  ,2023-02-14,2023-02-17,225.0,14020,1588,15608
84,TSLA  ,2023-02-14,2023-02-17,227.5,3104,107,3211
85,TSLA  ,2023-02-14,2023-02-17,230.0,15846,1513,17359
86,TSLA  ,2023-02-14,2023-02-17,232.5,2226,117,2343
87,TSLA  ,2023-02-14,2023-02-17,235.0,8477,657,9134
88,TSLA  ,2023-02-14,2023-02-17,237.5,2153,103,2256
89,TSLA  ,2023-02-14,2023-02-17,240.0,12928,1743,14671
90,TSLA  ,2023-02-14,2023-02-17,242.5,2706,20,2726
91,TSLA  ,2023-02-14,2023-02-17,245.0,6754,189,6943
92,TSLA  ,2023-02-14,2023-02-17,247.5,1941,49,1990
93,TSLA  ,2023-02-14,2023-02-17,250.0,46208,242,46450
94,TSLA  ,2023-02-14,2023-02-17,252.5,2230,15,2245
95,TSLA  ,2023-02-14,2023-02-17,255.0,14328,34,14362
96,TSLA  ,2023-02-14,2023-02-17,257.5,3517,0,3517
97,TSLA  ,2023-02-14,2023-02-17,260.0,11762,77,11839
98,TSLA  ,2023-02-14,2023-02-17,262.5,2449,1,2450
99,TSLA  ,2023-02-14,2023-02-17,265.0,8531,50,8581
100,TSLA  ,2023-02-14,2023-02-17,267.5,411,0,411
101,TSLA  ,2023-02-14,2023-02-17,270.0,13444,37,13481
102,TSLA  ,2023-02-14,2023-02-17,272.5,3624,0,3624
103,TSLA  ,2023-02-14,2023-02-17,275.0,11842,0,11842
104,TSLA  ,2023-02-14,2023-02-17,277.5,713,0,713
105,TSLA  ,2023-02-14,2023-02-17,280.0,6124,12,6136
106,TSLA  ,2023-02-14,2023-02-17,285.0,10872,0,10872
107,TSLA  ,2023-02-14,2023-02-17,290.0,7827,0,7827
108,TSLA  ,2023-02-14,2023-02-17,295.0,4104,0,4104
109,TSLA  ,2023-02-14,2023-02-17,300.0,13258,0,13258
110,TSLA  ,2023-02-14,2023-02-17,305.0,4943,0,4943
111,TSLA  ,2023-02-14,2023-02-17,310.0,3737,15,3752
112,TSLA  ,2023-02-14,2023-02-17,315.0,3743,0,3743
113,TSLA  ,2023-02-14,2023-02-17,320.0,11786,1,11787
114,TSLA  ,2023-02-14,2023-02-17,325.0,2040,0,2040
115,TSLA  ,2023-02-14,2023-02-17,330.0,1810,0,1810
116,TSLA  ,2023-02-14,2023-02-17,335.0,4077,0,4077
117,TSLA  ,2023-02-14,2023-02-17,340.0,3188,0,3188
118,TSLA  ,2023-02-14,2023-02-17,345.0,2800,0,2800
119,TSLA  ,2023-02-14,2023-02-17,350.0,4073,0,4073
120,TSLA  ,2023-02-14,2023-02-17,355.0,1318,0,1318
121,TSLA  ,2023-02-14,2023-02-17,360.0,2051,0,2051
122,TSLA  ,2023-02-14,2023-02-17,365.0,2038,0,2038
123,TSLA  ,2023-02-14,2023-02-17,370.0,1526,0,1526
124,TSLA  ,2023-02-14,2023-02-17,375.0,4634,0,4634
125,TSLA  ,2023-02-14,2023-02-17,380.0,2162,0,2162
126,TSLA  ,2023-02-14,2023-02-17,385.0,963,0,963
127,TSLA  ,2023-02-14,2023-02-17,390.0,1495,0,1495
128,TSLA  ,2023-02-14,2023-02-17,395.0,2035,0,2035
129,TSLA  ,2023-02-14,2023-02-17,400.0,4208,0,4208
130,TSLA  ,2023-02-14,2023-02-17,405.0,560,0,560
131,TSLA  ,2023-02-14,2023-02-17,410.0,801,0,801
132,TSLA  ,2023-02-14,2023-02-17,415.0,755,0,755
133,TSLA  ,2023-02-14,2023-02-17,420.0,794,0,794
134,TSLA  ,2023-02-14,2023-02-17,425.0,674,0,674
135,TSLA  ,2023-02-14,2023-02-17,430.0,728,0,728
136,TSLA  ,2023-02-14,2023-02-17,435.0,358,0,358
137,TSLA  ,2023-02-14,2023-02-17,440.0,822,0,822
138,TSLA  ,2023-02-14,2023-02-17,445.0,235,0,235
139,TSLA  ,2023-02-14,2023-02-17,450.0,753,0,753
140,TSLA  ,2023-02-14,2023-02-17,455.0,1720,0,1720
141,TSLA  ,2023-02-14,2023-02-17,460.0,350,0,350
142,TSLA  ,2023-02-14,2023-02-17,465.0,1039,0,1039
143,TSLA  ,2023-02-14,2023-02-17,470.0,1347,0,1347
144,TSLA  ,2023-02-14,2023-02-17,475.0,589,0,589
145,TSLA  ,2023-02-14,2023-02-17,480.0,347,0,347
146,TSLA  ,2023-02-14,2023-02-17,485.0,689,0,689
147,TSLA  ,2023-02-14,2023-02-17,490.0,242,0,242
148,TSLA  ,2023-02-14,2023-02-17,495.0,400,0,400
149,TSLA  ,2023-02-14,2023-02-17,500.0,3739,0,3739
150,TSLA  ,2023-02-14,2023-02-17,505.0,357,0,357
151,TSLA  ,2023-02-14,2023-02-17,510.0,356,0,356
152,TSLA  ,2023-02-14,2023-02-17,515.0,58,0,58
153,TSLA  ,2023-02-14,2023-02-17,520.0,327,0,327
154,TSLA  ,2023-02-14,2023-02-17,525.0,150,0,150
155,TSLA  ,2023-02-14,2023-02-17,530.0,391,0,391
156,TSLA  ,2023-02-14,2023-02-17,535.0,171,0,171
157,TSLA  ,2023-02-14,2023-02-17,540.0,219,0,219
158,TSLA  ,2023-02-14,2023-02-17,545.0,110,0,110
159,TSLA  ,2023-02-14,2023-02-17,550.0,799,0,799
160,TSLA  ,2023-02-14,2023-02-17,555.0,837,0,837
161,TSLA  ,2023-02-14,2023-02-17,560.0,573,0,573
162,TSLA  ,2023-02-14,2023-02-17,565.0,661,0,661
163,TSLA  ,2023-02-14,2023-02-17,570.0,317,0,317
164,TSLA  ,2023-02-14,2023-02-17,575.0,278,0,278
165,TSLA  ,2023-02-14,2023-02-17,580.0,1203,0,1203
166,TSLA  ,2023-02-14,2023-02-17,585.0,956,0,956
167,TSLA  ,2023-02-14,2023-02-17,590.0,297,0,297
168,TSLA  ,2023-02-14,2023-02-17,595.0,2011,0,2011
169,TSLA  ,2023-02-14,2023-02-17,600.0,2970,0,2970
170,TSLA  ,2023-02-14,2023-02-24,15.0,3,8,11
171,TSLA  ,2023-02-14,2023-02-24,20.0,3,1,4
172,TSLA  ,2023-02-14,2023-02-24,25.0,3,3,6
173,TSLA  ,2023-02-14,2023-02-24,30.0,3,748,751
174,TSLA  ,2023-02-14,2023-02-24,35.0,0,20,20
175,TSLA  ,2023-02-14,2023-02-24,40.0,0,439,439
176,TSLA  ,2023-02-14,2023-02-24,45.0,0,2041,2041
177,TSLA  ,2023-02-14,2023-02-24,50.0,0,1898,1898
178,TSLA  ,2023-02-14,2023-02-24,55.0,3,806,809
179,TSLA  ,2023-02-14,2023-02-24,60.0,11,1451,1462
180,TSLA  ,2023-02-14,2023-02-24,65.0,6,698,704
181,TSLA  ,2023-02-14,2023-02-24,70.0,6,599,605
182,TSLA  ,2023-02-14,2023-02-24,75.0,1,851,852
183,TSLA  ,2023-02-14,2023-02-24,80.0,7,1111,1118
184,TSLA  ,2023-02-14,2023-02-24,85.0,1,639,640
185,TSLA  ,2023-02-14,2023-02-24,90.0,43,1412,1455
186,TSLA  ,2023-02-14,2023-02-24,95.0,19,1847,1866
187,TSLA  ,2023-02-14,2023-02-24,98.0,14,463,477
188,TSLA  ,2023-02-14,2023-02-24,99.0,10,585,595
189,TSLA  ,2023-02-14,2023-02-24,100.0,69,2478,2547
190,TSLA  ,2023-02-14,2023-02-24,101.0,14,335,349
191,TSLA  ,2023-02-14,2023-02-24,102.0,12,241,253
192,TSLA  ,2023-02-14,2023-02-24,103.0,8,214,222
193,TSLA  ,2023-02-14,2023-02-24,104.0,16,335,351
194,TSLA  ,2023-02-14,2023-02-24,105.0,53,1937,1990
195,TSLA  ,2023-02-14,2023-02-24,106.0,15,545,560
196,TSLA  ,2023-02-14,2023-02-24,107.0,8,668,676
197,TSLA  ,2023-02-14,2023-02-24,108.0,9,412,421
198,TSLA  ,2023-02-14,2023-02-24,109.0,9,488,497
199,TSLA  ,2023-02-14,2023-02-24,110.0,330,1592,1922
200,TSLA  ,2023-02-14,2023-02-24,111.0,47,497,544
201,TSLA  ,2023-02-14,2023-02-24,112.0,52,528,580
202,TSLA  ,2023-02-14,2023-02-24,113.0,46,677,723
203,TSLA  ,2023-02-14,2023-02-24,114.0,380,937,1317
204,TSLA  ,2023-02-14,2023-02-24,115.0,369,1193,1562
205,TSLA  ,2023-02-14,2023-02-24,116.0,307,739,1046
206,TSLA  ,2023-02-14,2023-02-24,117.0,266,510,776
207,TSLA  ,2023-02-14,2023-02-24,118.0,191,583,774
208,TSLA  ,2023-02-14,2023-02-24,119.0,207,642,849
209,TSLA  ,2023-02-14,2023-02-24,120.0,463,2980,3443
210,TSLA  ,2023-02-14,2023-02-24,121.0,313,735,1048
211,TSLA  ,2023-02-14,2023-02-24,122.0,300,2503,2803
212,TSLA  ,2023-02-14,2023-02-24,123.0,442,591,1033
213,TSLA  ,2023-02-14,2023-02-24,124.0,157,379,536
214,TSLA  ,2023-02-14,2023-02-24,125.0,537,2591,3128
215,TSLA  ,2023-02-14,2023-02-24,126.0,167,664,831
216,TSLA  ,2023-02-14,2023-02-24,127.0,100,1144,1244
217,TSLA  ,2023-02-14,2023-02-24,128.0,160,737,897
218,TSLA  ,2023-02-14,2023-02-24,129.0,238,1252,1490
219,TSLA  ,2023-02-14,2023-02-24,130.0,2686,2747,5433
220,TSLA  ,2023-02-14,2023-02-24,131.0,417,359,776
221,TSLA  ,2023-02-14,2023-02-24,132.0,249,855,1104
222,TSLA  ,2023-02-14,2023-02-24,133.0,144,420,564
223,TSLA  ,2023-02-14,2023-02-24,134.0,273,709,982
224,TSLA  ,2023-02-14,2023-02-24,135.0,1890,1701,3591
225,TSLA  ,2023-02-14,2023-02-24,136.0,80,461,541
226,TSLA  ,2023-02-14,2023-02-24,137.0,66,541,607
227,TSLA  ,2023-02-14,2023-02-24,138.0,66,495,561
228,TSLA  ,2023-02-14,2023-02-24,139.0,471,354,825
229,TSLA  ,2023-02-14,2023-02-24,140.0,1758,2153,3911
230,TSLA  ,2023-02-14,2023-02-24,141.0,362,1350,1712
231,TSLA  ,2023-02-14,2023-02-24,142.0,461,849,1310
232,TSLA  ,2023-02-14,2023-02-24,143.0,89,317,406
233,TSLA  ,2023-02-14,2023-02-24,144.0,69,393,462
234,TSLA  ,2023-02-14,2023-02-24,145.0,1592,4918,6510
235,TSLA  ,2023-02-14,2023-02-24,146.0,69,688,757
236,TSLA  ,2023-02-14,2023-02-24,147.0,48,443,491
237,TSLA  ,2023-02-14,2023-02-24,148.0,147,499,646
238,TSLA  ,2023-02-14,2023-02-24,149.0,103,1215,1318
239,TSLA  ,2023-02-14,2023-02-24,150.0,3264,6230,9494
240,TSLA  ,2023-02-14,2023-02-24,152.5,111,1471,1582
241,TSLA  ,2023-02-14,2023-02-24,155.0,3053,5886,8939
242,TSLA  ,2023-02-14,2023-02-24,157.5,851,811,1662
243,TSLA  ,2023-02-14,2023-02-24,160.0,2891,4528,7419
244,TSLA  ,2023-02-14,2023-02-24,162.5,402,1359,1761
245,TSLA  ,2023-02-14,2023-02-24,165.0,2365,2089,4454
246,TSLA  ,2023-02-14,2023-02-24,167.5,918,1976,2894
247,TSLA  ,2023-02-14,2023-02-24,170.0,7389,3963,11352
248,TSLA  ,2023-02-14,2023-02-24,172.5,735,819,1554
249,TSLA  ,2023-02-14,2023-02-24,175.0,3878,2884,6762
250,TSLA  ,2023-02-14,2023-02-24,177.5,404,3018,3422
251,TSLA  ,2023-02-14,2023-02-24,180.0,7842,5038,12880
252,TSLA  ,2023-02-14,2023-02-24,182.5,530,1607,2137
253,TSLA  ,2023-02-14,2023-02-24,185.0,1754,3062,4816
254,TSLA  ,2023-02-14,2023-02-24,187.5,765,1150,1915
255,TSLA  ,2023-02-14,2023-02-24,190.0,11400,4965,16365
256,TSLA  ,2023-02-14,2023-02-24,192.5,2446,5780,8226
257,TSLA  ,2023-02-14,2023-02-24,195.0,5346,2643,7989
258,TSLA  ,2023-02-14,2023-02-24,197.5,2414,1782,4196
259,TSLA  ,2023-02-14,2023-02-24,200.0,17704,4026,21730
260,TSLA  ,2023-02-14,2023-02-24,202.5,1816,922,2738
261,TSLA  ,2023-02-14,2023-02-24,205.0,3312,896,4208
262,TSLA  ,2023-02-14,2023-02-24,207.5,1269,510,1779
263,TSLA  ,2023-02-14,2023-02-24,210.0,6651,905,7556
264,TSLA  ,2023-02-14,2023-02-24,212.5,1399,594,1993
265,TSLA  ,2023-02-14,2023-02-24,215.0,2741,435,3176
266,TSLA  ,2023-02-14,2023-02-24,217.5,1073,236,1309
267,TSLA  ,2023-02-14,2023-02-24,220.0,6524,530,7054
268,TSLA  ,2023-02-14,2023-02-24,222.5,732,133,865
269,TSLA  ,2023-02-14,2023-02-24,225.0,4083,211,4294
270,TSLA  ,2023-02-14,2023-02-24,227.5,617,35,652
271,TSLA  ,2023-02-14,2023-02-24,230.0,3361,512,3873
272,TSLA  ,2023-02-14,2023-02-24,232.5,820,10,830
273,TSLA  ,2023-02-14,2023-02-24,235.0,1650,40,1690
274,TSLA  ,2023-02-14,2023-02-24,237.5,101,9,110
275,TSLA  ,2023-02-14,2023-02-24,240.0,11060,623,11683
276,TSLA  ,2023-02-14,2023-02-24,242.5,214,9,223
277,TSLA  ,2023-02-14,2023-02-24,245.0,2713,7,2720
278,TSLA  ,2023-02-14,2023-02-24,247.5,322,0,322
279,TSLA  ,2023-02-14,2023-02-24,250.0,5746,182,5928
280,TSLA  ,2023-02-14,2023-02-24,252.5,61,3,64
281,TSLA  ,2023-02-14,2023-02-24,255.0,1142,4,1146
282,TSLA  ,2023-02-14,2023-02-24,257.5,169,0,169
283,TSLA  ,2023-02-14,2023-02-24,260.0,5773,5,5778
284,TSLA  ,2023-02-14,2023-02-24,262.5,27,0,27
285,TSLA  ,2023-02-14,2023-02-24,265.0,3359,2,3361
286,TSLA  ,2023-02-14,2023-02-24,270.0,2306,4,2310
287,TSLA  ,2023-02-14,2023-02-24,275.0,1499,3,1502
288,TSLA  ,2023-02-14,2023-02-24,280.0,3273,4,3277
289,TSLA  ,2023-02-14,2023-02-24,285.0,5152,0,5152
290,TSLA  ,2023-02-14,2023-02-24,290.0,1265,0,1265
291,TSLA  ,2023-02-14,2023-02-24,295.0,758,0,758
292,TSLA  ,2023-02-14,2023-02-24,300.0,2749,0,2749
293,TSLA  ,2023-02-14,2023-02-24,310.0,1960,0,1960
294,TSLA  ,2023-02-14,2023-02-24,320.0,1250,0,1250
295,TSLA  ,2023-02-14,2023-02-24,330.0,851,0,851
296,TSLA  ,2023-02-14,2023-02-24,340.0,1656,0,1656
297,TSLA  ,2023-02-14,2023-02-24,350.0,2908,0,2908
298,TSLA  ,2023-02-14,2023-02-24,360.0,2835,0,2835
299,TSLA  ,2023-02-14,2023-03-03,15.0,11,256,267
300,TSLA  ,2023-02-14,2023-03-03,20.0,1,0,1
301,TSLA  ,2023-02-14,2023-03-03,25.0,4,47,51
302,TSLA  ,2023-02-14,2023-03-03,30.0,3,340,343
303,TSLA  ,2023-02-14,2023-03-03,35.0,3,1,4
304,TSLA  ,2023-02-14,2023-03-03,40.0,0,10,10
305,TSLA  ,2023-02-14,2023-03-03,45.0,0,2457,2457
306,TSLA  ,2023-02-14,2023-03-03,50.0,1,886,887
307,TSLA  ,2023-02-14,2023-03-03,55.0,0,156,156
308,TSLA  ,2023-02-14,2023-03-03,60.0,2,1118,1120
309,TSLA  ,2023-02-14,2023-03-03,65.0,1,99,100
310,TSLA  ,2023-02-14,2023-03-03,70.0,2,692,694
311,TSLA  ,2023-02-14,2023-03-03,75.0,1,274,275
312,TSLA  ,2023-02-14,2023-03-03,80.0,112,1361,1473
313,TSLA  ,2023-02-14,2023-03-03,85.0,4,578,582
314,TSLA  ,2023-02-14,2023-03-03,90.0,7,1014,1021
315,TSLA  ,2023-02-14,2023-03-03,95.0,7,1839,1846
316,TSLA  ,2023-02-14,2023-03-03,100.0,111,2051,2162
317,TSLA  ,2023-02-14,2023-03-03,105.0,19,755,774
318,TSLA  ,2023-02-14,2023-03-03,108.0,51,491,542
319,TSLA  ,2023-02-14,2023-03-03,109.0,34,306,340
320,TSLA  ,2023-02-14,2023-03-03,110.0,109,3029,3138
321,TSLA  ,2023-02-14,2023-03-03,111.0,7,556,563
322,TSLA  ,2023-02-14,2023-03-03,112.0,41,711,752
323,TSLA  ,2023-02-14,2023-03-03,113.0,33,798,831
324,TSLA  ,2023-02-14,2023-03-03,114.0,154,511,665
325,TSLA  ,2023-02-14,2023-03-03,115.0,186,895,1081
326,TSLA  ,2023-02-14,2023-03-03,116.0,158,403,561
327,TSLA  ,2023-02-14,2023-03-03,117.0,472,750,1222
328,TSLA  ,2023-02-14,2023-03-03,118.0,309,322,631
329,TSLA  ,2023-02-14,2023-03-03,119.0,318,527,845
330,TSLA  ,2023-02-14,2023-03-03,120.0,902,2821,3723
331,TSLA  ,2023-02-14,2023-03-03,121.0,96,557,653
332,TSLA  ,2023-02-14,2023-03-03,122.0,117,929,1046
333,TSLA  ,2023-02-14,2023-03-03,123.0,264,610,874
334,TSLA  ,2023-02-14,2023-03-03,124.0,444,826,1270
335,TSLA  ,2023-02-14,2023-03-03,125.0,297,899,1196
336,TSLA  ,2023-02-14,2023-03-03,126.0,669,388,1057
337,TSLA  ,2023-02-14,2023-03-03,127.0,428,251,679
338,TSLA  ,2023-02-14,2023-03-03,128.0,455,797,1252
339,TSLA  ,2023-02-14,2023-03-03,129.0,646,604,1250
340,TSLA  ,2023-02-14,2023-03-03,130.0,677,1567,2244
341,TSLA  ,2023-02-14,2023-03-03,131.0,305,751,1056
342,TSLA  ,2023-02-14,2023-03-03,132.0,813,651,1464
343,TSLA  ,2023-02-14,2023-03-03,133.0,538,114,652
344,TSLA  ,2023-02-14,2023-03-03,134.0,569,1250,1819
345,TSLA  ,2023-02-14,2023-03-03,135.0,869,1136,2005
346,TSLA  ,2023-02-14,2023-03-03,136.0,93,72,165
347,TSLA  ,2023-02-14,2023-03-03,137.0,69,126,195
348,TSLA  ,2023-02-14,2023-03-03,138.0,151,334,485
349,TSLA  ,2023-02-14,2023-03-03,139.0,108,182,290
350,TSLA  ,2023-02-14,2023-03-03,140.0,647,1459,2106
351,TSLA  ,2023-02-14,2023-03-03,141.0,70,548,618
352,TSLA  ,2023-02-14,2023-03-03,142.0,296,265,561
353,TSLA  ,2023-02-14,2023-03-03,143.0,48,45,93
354,TSLA  ,2023-02-14,2023-03-03,144.0,22,2130,2152
355,TSLA  ,2023-02-14,2023-03-03,145.0,635,3586,4221
356,TSLA  ,2023-02-14,2023-03-03,146.0,36,583,619
357,TSLA  ,2023-02-14,2023-03-03,147.0,42,183,225
358,TSLA  ,2023-02-14,2023-03-03,148.0,39,461,500
359,TSLA  ,2023-02-14,2023-03-03,149.0,300,1678,1978
360,TSLA  ,2023-02-14,2023-03-03,150.0,1037,7387,8424
361,TSLA  ,2023-02-14,2023-03-03,152.5,184,1227,1411
362,TSLA  ,2023-02-14,2023-03-03,155.0,1275,990,2265
363,TSLA  ,2023-02-14,2023-03-03,157.5,144,764,908
364,TSLA  ,2023-02-14,2023-03-03,160.0,1087,10629,11716
365,TSLA  ,2023-02-14,2023-03-03,162.5,191,4325,4516
366,TSLA  ,2023-02-14,2023-03-03,165.0,1838,1846,3684
367,TSLA  ,2023-02-14,2023-03-03,167.5,263,770,1033
368,TSLA  ,2023-02-14,2023-03-03,170.0,2406,4566,6972
369,TSLA  ,2023-02-14,2023-03-03,172.5,1164,767,1931
370,TSLA  ,2023-02-14,2023-03-03,175.0,1234,1980,3214
371,TSLA  ,2023-02-14,2023-03-03,177.5,428,353,781
372,TSLA  ,2023-02-14,2023-03-03,180.0,2263,2849,5112
373,TSLA  ,2023-02-14,2023-03-03,182.5,313,742,1055
374,TSLA  ,2023-02-14,2023-03-03,185.0,1682,1406,3088
375,TSLA  ,2023-02-14,2023-03-03,187.5,1421,850,2271
376,TSLA  ,2023-02-14,2023-03-03,190.0,2521,2010,4531
377,TSLA  ,2023-02-14,2023-03-03,192.5,958,1041,1999
378,TSLA  ,2023-02-14,2023-03-03,195.0,3713,1970,5683
379,TSLA  ,2023-02-14,2023-03-03,197.5,2843,811,3654
380,TSLA  ,2023-02-14,2023-03-03,200.0,7374,2633,10007
381,TSLA  ,2023-02-14,2023-03-03,202.5,2270,1351,3621
382,TSLA  ,2023-02-14,2023-03-03,205.0,3731,679,4410
383,TSLA  ,2023-02-14,2023-03-03,207.5,1227,764,1991
384,TSLA  ,2023-02-14,2023-03-03,210.0,4167,748,4915
385,TSLA  ,2023-02-14,2023-03-03,212.5,1036,329,1365
386,TSLA  ,2023-02-14,2023-03-03,215.0,4653,273,4926
387,TSLA  ,2023-02-14,2023-03-03,217.5,669,326,995
388,TSLA  ,2023-02-14,2023-03-03,220.0,3942,482,4424
389,TSLA  ,2023-02-14,2023-03-03,222.5,422,51,473
390,TSLA  ,2023-02-14,2023-03-03,225.0,3139,29,3168
391,TSLA  ,2023-02-14,2023-03-03,227.5,98,0,98
392,TSLA  ,2023-02-14,2023-03-03,230.0,4975,216,5191
393,TSLA  ,2023-02-14,2023-03-03,235.0,1469,32,1501
394,TSLA  ,2023-02-14,2023-03-03,240.0,4093,34,4127
395,TSLA  ,2023-02-14,2023-03-03,245.0,2734,19,2753
396,TSLA  ,2023-02-14,2023-03-03,250.0,5389,66,5455
397,TSLA  ,2023-02-14,2023-03-03,255.0,1216,5,1221
398,TSLA  ,2023-02-14,2023-03-03,260.0,1197,11,1208
399,TSLA  ,2023-02-14,2023-03-03,265.0,653,1,654
400,TSLA  ,2023-02-14,2023-03-03,270.0,2349,3,2352
401,TSLA  ,2023-02-14,2023-03-03,275.0,1569,7,1576
402,TSLA  ,2023-02-14,2023-03-03,280.0,1272,26,1298
403,TSLA  ,2023-02-14,2023-03-03,285.0,807,24,831
404,TSLA  ,2023-02-14,2023-03-03,290.0,1549,2,1551
405,TSLA  ,2023-02-14,2023-03-03,295.0,473,22,495
406,TSLA  ,2023-02-14,2023-03-03,300.0,6915,48,6963
407,TSLA  ,2023-02-14,2023-03-03,310.0,1728,0,1728
408,TSLA  ,2023-02-14,2023-03-03,320.0,917,5,922
409,TSLA  ,2023-02-14,2023-03-03,330.0,402,0,402
410,TSLA  ,2023-02-14,2023-03-03,340.0,556,0,556
411,TSLA  ,2023-02-14,2023-03-03,350.0,529,2,531
412,TSLA  ,2023-02-14,2023-03-03,360.0,1454,0,1454
413,TSLA  ,2023-02-14,2023-03-10,15.0,3,46,49
414,TSLA  ,2023-02-14,2023-03-10,20.0,3,0,3
415,TSLA  ,2023-02-14,2023-03-10,25.0,0,0,0
416,TSLA  ,2023-02-14,2023-03-10,30.0,3,2,5
417,TSLA  ,2023-02-14,2023-03-10,35.0,0,0,0
418,TSLA  ,2023-02-14,2023-03-10,40.0,0,10,10
419,TSLA  ,2023-02-14,2023-03-10,45.0,0,0,0
420,TSLA  ,2023-02-14,2023-03-10,50.0,5,451,456
421,TSLA  ,2023-02-14,2023-03-10,55.0,0,1209,1209
422,TSLA  ,2023-02-14,2023-03-10,60.0,0,13,13
423,TSLA  ,2023-02-14,2023-03-10,65.0,0,14,14
424,TSLA  ,2023-02-14,2023-03-10,70.0,0,25,25
425,TSLA  ,2023-02-14,2023-03-10,75.0,0,438,438
426,TSLA  ,2023-02-14,2023-03-10,80.0,0,88,88
427,TSLA  ,2023-02-14,2023-03-10,85.0,0,59,59
428,TSLA  ,2023-02-14,2023-03-10,90.0,0,90,90
429,TSLA  ,2023-02-14,2023-03-10,95.0,11,345,356
430,TSLA  ,2023-02-14,2023-03-10,100.0,23,721,744
431,TSLA  ,2023-02-14,2023-03-10,105.0,4,342,346
432,TSLA  ,2023-02-14,2023-03-10,110.0,14,746,760
433,TSLA  ,2023-02-14,2023-03-10,115.0,5,446,451
434,TSLA  ,2023-02-14,2023-03-10,120.0,22,1310,1332
435,TSLA  ,2023-02-14,2023-03-10,125.0,14,677,691
436,TSLA  ,2023-02-14,2023-03-10,130.0,80,338,418
437,TSLA  ,2023-02-14,2023-03-10,134.0,5,157,162
438,TSLA  ,2023-02-14,2023-03-10,135.0,33,584,617
439,TSLA  ,2023-02-14,2023-03-10,136.0,31,165,196
440,TSLA  ,2023-02-14,2023-03-10,137.0,8,81,89
441,TSLA  ,2023-02-14,2023-03-10,138.0,14,106,120
442,TSLA  ,2023-02-14,2023-03-10,139.0,4,112,116
443,TSLA  ,2023-02-14,2023-03-10,140.0,53,1110,1163
444,TSLA  ,2023-02-14,2023-03-10,141.0,143,456,599
445,TSLA  ,2023-02-14,2023-03-10,142.0,16,239,255
446,TSLA  ,2023-02-14,2023-03-10,143.0,8,480,488
447,TSLA  ,2023-02-14,2023-03-10,144.0,11,62,73
448,TSLA  ,2023-02-14,2023-03-10,145.0,104,363,467
449,TSLA  ,2023-02-14,2023-03-10,146.0,39,54,93
450,TSLA  ,2023-02-14,2023-03-10,147.0,81,128,209
451,TSLA  ,2023-02-14,2023-03-10,148.0,98,797,895
452,TSLA  ,2023-02-14,2023-03-10,149.0,3,206,209
453,TSLA  ,2023-02-14,2023-03-10,150.0,254,974,1228
454,TSLA  ,2023-02-14,2023-03-10,152.5,116,274,390
455,TSLA  ,2023-02-14,2023-03-10,155.0,289,732,1021
456,TSLA  ,2023-02-14,2023-03-10,157.5,92,364,456
457,TSLA  ,2023-02-14,2023-03-10,160.0,245,792,1037
458,TSLA  ,2023-02-14,2023-03-10,162.5,114,427,541
459,TSLA  ,2023-02-14,2023-03-10,165.0,270,885,1155
460,TSLA  ,2023-02-14,2023-03-10,167.5,275,450,725
461,TSLA  ,2023-02-14,2023-03-10,170.0,384,1454,1838
462,TSLA  ,2023-02-14,2023-03-10,172.5,185,391,576
463,TSLA  ,2023-02-14,2023-03-10,175.0,419,1466,1885
464,TSLA  ,2023-02-14,2023-03-10,177.5,1790,282,2072
465,TSLA  ,2023-02-14,2023-03-10,180.0,615,1729,2344
466,TSLA  ,2023-02-14,2023-03-10,182.5,177,344,521
467,TSLA  ,2023-02-14,2023-03-10,185.0,428,758,1186
468,TSLA  ,2023-02-14,2023-03-10,187.5,1213,158,1371
469,TSLA  ,2023-02-14,2023-03-10,190.0,1166,1025,2191
470,TSLA  ,2023-02-14,2023-03-10,192.5,672,369,1041
471,TSLA  ,2023-02-14,2023-03-10,195.0,612,713,1325
472,TSLA  ,2023-02-14,2023-03-10,197.5,408,707,1115
473,TSLA  ,2023-02-14,2023-03-10,200.0,2464,1242,3706
474,TSLA  ,2023-02-14,2023-03-10,202.5,1365,942,2307
475,TSLA  ,2023-02-14,2023-03-10,205.0,1065,654,1719
476,TSLA  ,2023-02-14,2023-03-10,207.5,258,273,531
477,TSLA  ,2023-02-14,2023-03-10,210.0,1661,447,2108
478,TSLA  ,2023-02-14,2023-03-10,212.5,389,335,724
479,TSLA  ,2023-02-14,2023-03-10,215.0,726,172,898
480,TSLA  ,2023-02-14,2023-03-10,217.5,214,104,318
481,TSLA  ,2023-02-14,2023-03-10,220.0,1656,37,1693
482,TSLA  ,2023-02-14,2023-03-10,222.5,195,40,235
483,TSLA  ,2023-02-14,2023-03-10,225.0,1083,132,1215
484,TSLA  ,2023-02-14,2023-03-10,230.0,811,37,848
485,TSLA  ,2023-02-14,2023-03-10,235.0,484,4,488
486,TSLA  ,2023-02-14,2023-03-10,240.0,1187,14,1201
487,TSLA  ,2023-02-14,2023-03-10,245.0,548,44,592
488,TSLA  ,2023-02-14,2023-03-10,250.0,2077,152,2229
489,TSLA  ,2023-02-14,2023-03-10,255.0,383,2,385
490,TSLA  ,2023-02-14,2023-03-10,260.0,981,58,1039
491,TSLA  ,2023-02-14,2023-03-10,265.0,3147,0,3147
492,TSLA  ,2023-02-14,2023-03-10,270.0,444,0,444
493,TSLA  ,2023-02-14,2023-03-10,275.0,295,0,295
494,TSLA  ,2023-02-14,2023-03-10,280.0,1050,6,1056
495,TSLA  ,2023-02-14,2023-03-10,285.0,597,0,597
496,TSLA  ,2023-02-14,2023-03-10,290.0,341,3,344
497,TSLA  ,2023-02-14,2023-03-10,295.0,435,0,435
498,TSLA  ,2023-02-14,2023-03-10,300.0,1878,0,1878
499,TSLA  ,2023-02-14,2023-03-10,310.0,2914,11,2925
500,TSLA  ,2023-02-14,2023-03-10,320.0,383,1,384
501,TSLA  ,2023-02-14,2023-03-10,330.0,328,0,328
502,TSLA  ,2023-02-14,2023-03-10,340.0,550,0,550
503,TSLA  ,2023-02-14,2023-03-10,350.0,255,0,255
504,TSLA  ,2023-02-14,2023-03-10,360.0,896,0,896
505,TSLA  ,2023-02-14,2023-03-17,1.67,50,24714,24764
506,TSLA  ,2023-02-14,2023-03-17,3.33,29,6941,6970
507,TSLA  ,2023-02-14,2023-03-17,5.0,2,8008,8010
508,TSLA  ,2023-02-14,2023-03-17,6.67,52,4669,4721
509,TSLA  ,2023-02-14,2023-03-17,8.33,15,1379,1394
510,TSLA  ,2023-02-14,2023-03-17,10.0,842,4105,4947
511,TSLA  ,2023-02-14,2023-03-17,11.67,1711,5414,7125
512,TSLA  ,2023-02-14,2023-03-17,13.33,1657,2125,3782
513,TSLA  ,2023-02-14,2023-03-17,15.0,987,5169,6156
514,TSLA  ,2023-02-14,2023-03-17,16.67,875,15329,16204
515,TSLA  ,2023-02-14,2023-03-17,18.33,467,12018,12485
516,TSLA  ,2023-02-14,2023-03-17,33.33,406,33637,34043
517,TSLA  ,2023-02-14,2023-03-17,50.0,502,21423,21925
518,TSLA  ,2023-02-14,2023-03-17,55.0,33,4701,4734
519,TSLA  ,2023-02-14,2023-03-17,60.0,201,6712,6913
520,TSLA  ,2023-02-14,2023-03-17,65.0,25,2921,2946
521,TSLA  ,2023-02-14,2023-03-17,66.67,898,17821,18719
522,TSLA  ,2023-02-14,2023-03-17,70.0,49,7616,7665
523,TSLA  ,2023-02-14,2023-03-17,75.0,54,5479,5533
524,TSLA  ,2023-02-14,2023-03-17,80.0,243,11961,12204
525,TSLA  ,2023-02-14,2023-03-17,83.33,886,5149,6035
526,TSLA  ,2023-02-14,2023-03-17,85.0,87,3487,3574
527,TSLA  ,2023-02-14,2023-03-17,90.0,664,16127,16791
528,TSLA  ,2023-02-14,2023-03-17,95.0,334,3526,3860
529,TSLA  ,2023-02-14,2023-03-17,100.0,1784,39154,40938
530,TSLA  ,2023-02-14,2023-03-17,105.0,1411,4334,5745
531,TSLA  ,2023-02-14,2023-03-17,110.0,2896,13760,16656
532,TSLA  ,2023-02-14,2023-03-17,115.0,3390,8784,12174
533,TSLA  ,2023-02-14,2023-03-17,116.67,1371,10920,12291
534,TSLA  ,2023-02-14,2023-03-17,120.0,12397,26555,38952
535,TSLA  ,2023-02-14,2023-03-17,123.33,2743,6320,9063
536,TSLA  ,2023-02-14,2023-03-17,125.0,3566,10964,14530
537,TSLA  ,2023-02-14,2023-03-17,126.67,1682,4715,6397
538,TSLA  ,2023-02-14,2023-03-17,130.0,7362,11269,18631
539,TSLA  ,2023-02-14,2023-03-17,133.33,3432,9805,13237
540,TSLA  ,2023-02-14,2023-03-17,135.0,27658,33568,61226
541,TSLA  ,2023-02-14,2023-03-17,136.67,2876,3508,6384
542,TSLA  ,2023-02-14,2023-03-17,140.0,7123,30005,37128
543,TSLA  ,2023-02-14,2023-03-17,143.33,2461,5034,7495
544,TSLA  ,2023-02-14,2023-03-17,145.0,2936,8906,11842
545,TSLA  ,2023-02-14,2023-03-17,146.67,1863,4349,6212
546,TSLA  ,2023-02-14,2023-03-17,150.0,13584,23325,36909
547,TSLA  ,2023-02-14,2023-03-17,153.33,1665,2944,4609
548,TSLA  ,2023-02-14,2023-03-17,155.0,3677,7190,10867
549,TSLA  ,2023-02-14,2023-03-17,156.67,2242,3403,5645
550,TSLA  ,2023-02-14,2023-03-17,160.0,7780,23381,31161
551,TSLA  ,2023-02-14,2023-03-17,163.33,3019,5677,8696
552,TSLA  ,2023-02-14,2023-03-17,165.0,6975,5644,12619
553,TSLA  ,2023-02-14,2023-03-17,166.67,6347,11725,18072
554,TSLA  ,2023-02-14,2023-03-17,170.0,11309,20668,31977
555,TSLA  ,2023-02-14,2023-03-17,173.33,3152,11085,14237
556,TSLA  ,2023-02-14,2023-03-17,175.0,4971,7074,12045
557,TSLA  ,2023-02-14,2023-03-17,176.67,5222,2877,8099
558,TSLA  ,2023-02-14,2023-03-17,180.0,20303,22296,42599
559,TSLA  ,2023-02-14,2023-03-17,183.33,3387,8044,11431
560,TSLA  ,2023-02-14,2023-03-17,185.0,3570,4531,8101
561,TSLA  ,2023-02-14,2023-03-17,186.67,2667,4345,7012
562,TSLA  ,2023-02-14,2023-03-17,190.0,12072,12812,24884
563,TSLA  ,2023-02-14,2023-03-17,193.33,2343,2585,4928
564,TSLA  ,2023-02-14,2023-03-17,195.0,11538,10325,21863
565,TSLA  ,2023-02-14,2023-03-17,196.67,2944,1678,4622
566,TSLA  ,2023-02-14,2023-03-17,198.33,3937,2126,6063
567,TSLA  ,2023-02-14,2023-03-17,200.0,42136,35637,77773
568,TSLA  ,2023-02-14,2023-03-17,201.67,1964,1650,3614
569,TSLA  ,2023-02-14,2023-03-17,203.33,3133,2302,5435
570,TSLA  ,2023-02-14,2023-03-17,205.0,3998,2419,6417
571,TSLA  ,2023-02-14,2023-03-17,206.67,2530,2337,4867
572,TSLA  ,2023-02-14,2023-03-17,208.33,2412,894,3306
573,TSLA  ,2023-02-14,2023-03-17,210.0,10655,5136,15791
574,TSLA  ,2023-02-14,2023-03-17,211.67,2264,650,2914
575,TSLA  ,2023-02-14,2023-03-17,213.33,1739,620,2359
576,TSLA  ,2023-02-14,2023-03-17,215.0,8884,870,9754
577,TSLA  ,2023-02-14,2023-03-17,216.67,4826,2929,7755
578,TSLA  ,2023-02-14,2023-03-17,218.33,1334,182,1516
579,TSLA  ,2023-02-14,2023-03-17,220.0,12051,1372,13423
580,TSLA  ,2023-02-14,2023-03-17,221.67,1360,213,1573
581,TSLA  ,2023-02-14,2023-03-17,223.33,978,196,1174
582,TSLA  ,2023-02-14,2023-03-17,225.0,5256,1353,6609
583,TSLA  ,2023-02-14,2023-03-17,226.67,1958,205,2163
584,TSLA  ,2023-02-14,2023-03-17,228.33,4940,57,4997
585,TSLA  ,2023-02-14,2023-03-17,230.0,8102,1682,9784
586,TSLA  ,2023-02-14,2023-03-17,231.67,1453,64,1517
587,TSLA  ,2023-02-14,2023-03-17,233.33,7259,421,7680
588,TSLA  ,2023-02-14,2023-03-17,235.0,8253,106,8359
589,TSLA  ,2023-02-14,2023-03-17,236.67,1044,69,1113
590,TSLA  ,2023-02-14,2023-03-17,238.33,1048,83,1131
591,TSLA  ,2023-02-14,2023-03-17,240.0,6613,344,6957
592,TSLA  ,2023-02-14,2023-03-17,241.67,1065,60,1125
593,TSLA  ,2023-02-14,2023-03-17,243.33,1380,412,1792
594,TSLA  ,2023-02-14,2023-03-17,245.0,2272,70,2342
595,TSLA  ,2023-02-14,2023-03-17,246.67,964,32,996
596,TSLA  ,2023-02-14,2023-03-17,248.33,1129,29,1158
597,TSLA  ,2023-02-14,2023-03-17,250.0,20829,790,21619
598,TSLA  ,2023-02-14,2023-03-17,251.67,1380,67,1447
599,TSLA  ,2023-02-14,2023-03-17,253.33,642,28,670
600,TSLA  ,2023-02-14,2023-03-17,255.0,4254,69,4323
601,TSLA  ,2023-02-14,2023-03-17,256.67,662,16,678
602,TSLA  ,2023-02-14,2023-03-17,258.33,892,28,920
603,TSLA  ,2023-02-14,2023-03-17,260.0,6636,43,6679
604,TSLA  ,2023-02-14,2023-03-17,261.67,1459,12,1471
605,TSLA  ,2023-02-14,2023-03-17,263.33,1052,55,1107
606,TSLA  ,2023-02-14,2023-03-17,265.0,2662,16,2678
607,TSLA  ,2023-02-14,2023-03-17,266.67,11086,376,11462
608,TSLA  ,2023-02-14,2023-03-17,270.0,4698,32,4730
609,TSLA  ,2023-02-14,2023-03-17,273.33,3835,80,3915
610,TSLA  ,2023-02-14,2023-03-17,275.0,747,13,760
611,TSLA  ,2023-02-14,2023-03-17,276.67,1385,38,1423
612,TSLA  ,2023-02-14,2023-03-17,280.0,3154,138,3292
613,TSLA  ,2023-02-14,2023-03-17,283.33,6912,54,6966
614,TSLA  ,2023-02-14,2023-03-17,285.0,297,1,298
615,TSLA  ,2023-02-14,2023-03-17,286.67,1977,17,1994
616,TSLA  ,2023-02-14,2023-03-17,290.0,3782,65,3847
617,TSLA  ,2023-02-14,2023-03-17,293.33,7285,343,7628
618,TSLA  ,2023-02-14,2023-03-17,295.0,3053,11,3064
619,TSLA  ,2023-02-14,2023-03-17,296.67,968,16,984
620,TSLA  ,2023-02-14,2023-03-17,298.33,1123,2,1125
621,TSLA  ,2023-02-14,2023-03-17,300.0,71048,450,71498
622,TSLA  ,2023-02-14,2023-03-17,301.67,1474,17,1491
623,TSLA  ,2023-02-14,2023-03-17,303.33,1415,3,1418
624,TSLA  ,2023-02-14,2023-03-17,305.0,2669,26,2695
625,TSLA  ,2023-02-14,2023-03-17,306.67,1918,3,1921
626,TSLA  ,2023-02-14,2023-03-17,308.33,3843,2,3845
627,TSLA  ,2023-02-14,2023-03-17,310.0,4567,36,4603
628,TSLA  ,2023-02-14,2023-03-17,311.67,2050,5,2055
629,TSLA  ,2023-02-14,2023-03-17,313.33,2461,1,2462
630,TSLA  ,2023-02-14,2023-03-17,316.67,29538,11,29549
631,TSLA  ,2023-02-14,2023-03-17,320.0,15254,202,15456
632,TSLA  ,2023-02-14,2023-03-17,323.33,465,0,465
633,TSLA  ,2023-02-14,2023-03-17,326.67,701,1,702
634,TSLA  ,2023-02-14,2023-03-17,330.0,3249,6,3255
635,TSLA  ,2023-02-14,2023-03-17,333.33,20454,27,20481
636,TSLA  ,2023-02-14,2023-03-17,336.67,637,0,637
637,TSLA  ,2023-02-14,2023-03-17,340.0,5220,0,5220
638,TSLA  ,2023-02-14,2023-03-17,343.33,1866,0,1866
639,TSLA  ,2023-02-14,2023-03-17,346.67,627,0,627
640,TSLA  ,2023-02-14,2023-03-17,350.0,10916,5,10921
641,TSLA  ,2023-02-14,2023-03-17,353.33,747,0,747
642,TSLA  ,2023-02-14,2023-03-17,356.67,525,0,525
643,TSLA  ,2023-02-14,2023-03-17,360.0,2068,0,2068
644,TSLA  ,2023-02-14,2023-03-17,363.33,574,0,574
645,TSLA  ,2023-02-14,2023-03-17,366.67,7780,0,7780
646,TSLA  ,2023-02-14,2023-03-17,370.0,1504,0,1504
647,TSLA  ,2023-02-14,2023-03-17,373.33,677,0,677
648,TSLA  ,2023-02-14,2023-03-17,383.33,12647,0,12647
649,TSLA  ,2023-02-14,2023-03-17,400.0,25410,0,25410
650,TSLA  ,2023-02-14,2023-03-17,416.67,13267,0,13267
651,TSLA  ,2023-02-14,2023-03-17,433.33,19385,0,19385
652,TSLA  ,2023-02-14,2023-03-17,441.67,2007,0,2007
653,TSLA  ,2023-02-14,2023-03-17,450.0,5496,0,5496
654,TSLA  ,2023-02-14,2023-03-17,458.33,2461,0,2461
655,TSLA  ,2023-02-14,2023-03-17,466.67,2837,4,2841
656,TSLA  ,2023-02-14,2023-03-17,475.0,3784,0,3784
657,TSLA  ,2023-02-14,2023-03-17,483.33,1989,0,1989
658,TSLA  ,2023-02-14,2023-03-17,491.67,2464,0,2464
659,TSLA  ,2023-02-14,2023-03-17,500.0,13538,6,13544
660,TSLA  ,2023-02-14,2023-03-17,508.33,3539,0,3539
661,TSLA  ,2023-02-14,2023-03-17,516.67,1128,0,1128
662,TSLA  ,2023-02-14,2023-03-17,525.0,4713,0,4713
663,TSLA  ,2023-02-14,2023-03-17,533.33,4774,0,4774
664,TSLA  ,2023-02-14,2023-03-17,541.67,1031,0,1031
665,TSLA  ,2023-02-14,2023-03-17,550.0,5035,0,5035
666,TSLA  ,2023-02-14,2023-03-17,558.33,3779,0,3779
667,TSLA  ,2023-02-14,2023-03-17,566.67,7607,0,7607
668,TSLA  ,2023-02-14,2023-03-17,575.0,11865,0,11865
669,TSLA  ,2023-02-14,2023-03-17,583.33,2651,0,2651
670,TSLA  ,2023-02-14,2023-03-17,591.67,918,0,918
671,TSLA  ,2023-02-14,2023-03-17,600.0,5404,0,5404
672,TSLA  ,2023-02-14,2023-03-17,608.33,530,0,530
673,TSLA  ,2023-02-14,2023-03-17,616.67,3994,0,3994
674,TSLA  ,2023-02-14,2023-03-17,625.0,978,0,978
675,TSLA  ,2023-02-14,2023-03-17,633.33,2360,0,2360
676,TSLA  ,2023-02-14,2023-03-17,641.67,1498,0,1498
677,TSLA  ,2023-02-14,2023-03-17,650.0,8412,0,8412
678,TSLA  ,2023-02-14,2023-03-17,666.67,70207,0,70207
679,TSLA  ,2023-02-14,2023-03-17,675.0,21560,0,21560
680,TSLA  ,2023-02-14,2023-03-17,683.33,3815,0,3815
681,TSLA  ,2023-02-14,2023-03-17,691.67,1167,0,1167
682,TSLA  ,2023-02-14,2023-03-17,700.0,4668,0,4668
683,TSLA  ,2023-02-14,2023-03-17,708.33,587,0,587
684,TSLA  ,2023-02-14,2023-03-17,716.67,783,0,783
685,TSLA  ,2023-02-14,2023-03-17,725.0,1042,0,1042
686,TSLA  ,2023-02-14,2023-03-17,733.33,1723,0,1723
687,TSLA  ,2023-02-14,2023-03-17,741.67,754,0,754
688,TSLA  ,2023-02-14,2023-03-17,750.0,754,0,754
689,TSLA  ,2023-02-14,2023-03-17,758.33,1235,0,1235
690,TSLA  ,2023-02-14,2023-03-17,766.67,1260,0,1260
691,TSLA  ,2023-02-14,2023-03-17,775.0,849,0,849
692,TSLA  ,2023-02-14,2023-03-17,783.33,1306,0,1306
693,TSLA  ,2023-02-14,2023-03-17,791.67,1447,0,1447
694,TSLA  ,2023-02-14,2023-03-17,800.0,5378,0,5378
695,TSLA  ,2023-02-14,2023-03-17,808.33,1842,0,1842
696,TSLA  ,2023-02-14,2023-03-17,816.67,2608,0,2608
697,TSLA  ,2023-02-14,2023-03-17,825.0,60223,0,60223
698,TSLA  ,2023-02-14,2023-03-24,20.0,6,122,128
699,TSLA  ,2023-02-14,2023-03-24,25.0,0,0,0
700,TSLA  ,2023-02-14,2023-03-24,30.0,0,0,0
701,TSLA  ,2023-02-14,2023-03-24,35.0,0,0,0
702,TSLA  ,2023-02-14,2023-03-24,40.0,0,0,0
703,TSLA  ,2023-02-14,2023-03-24,45.0,0,1,1
704,TSLA  ,2023-02-14,2023-03-24,50.0,11,1543,1554
705,TSLA  ,2023-02-14,2023-03-24,55.0,3,0,3
706,TSLA  ,2023-02-14,2023-03-24,60.0,0,13,13
707,TSLA  ,2023-02-14,2023-03-24,65.0,0,0,0
708,TSLA  ,2023-02-14,2023-03-24,70.0,0,12,12
709,TSLA  ,2023-02-14,2023-03-24,75.0,0,5,5
710,TSLA  ,2023-02-14,2023-03-24,80.0,0,44,44
711,TSLA  ,2023-02-14,2023-03-24,85.0,1,25,26
712,TSLA  ,2023-02-14,2023-03-24,90.0,0,34,34
713,TSLA  ,2023-02-14,2023-03-24,95.0,0,69,69
714,TSLA  ,2023-02-14,2023-03-24,100.0,11,280,291
715,TSLA  ,2023-02-14,2023-03-24,105.0,10,98,108
716,TSLA  ,2023-02-14,2023-03-24,110.0,6,90,96
717,TSLA  ,2023-02-14,2023-03-24,115.0,1,46,47
718,TSLA  ,2023-02-14,2023-03-24,120.0,2,232,234
719,TSLA  ,2023-02-14,2023-03-24,125.0,5,256,261
720,TSLA  ,2023-02-14,2023-03-24,130.0,137,337,474
721,TSLA  ,2023-02-14,2023-03-24,135.0,16,358,374
722,TSLA  ,2023-02-14,2023-03-24,140.0,25,367,392
723,TSLA  ,2023-02-14,2023-03-24,145.0,58,244,302
724,TSLA  ,2023-02-14,2023-03-24,146.0,7,14,21
725,TSLA  ,2023-02-14,2023-03-24,147.0,86,23,109
726,TSLA  ,2023-02-14,2023-03-24,148.0,76,93,169
727,TSLA  ,2023-02-14,2023-03-24,149.0,59,83,142
728,TSLA  ,2023-02-14,2023-03-24,150.0,70,755,825
729,TSLA  ,2023-02-14,2023-03-24,152.5,14,52,66
730,TSLA  ,2023-02-14,2023-03-24,155.0,471,583,1054
731,TSLA  ,2023-02-14,2023-03-24,157.5,31,418,449
732,TSLA  ,2023-02-14,2023-03-24,160.0,85,473,558
733,TSLA  ,2023-02-14,2023-03-24,162.5,19,97,116
734,TSLA  ,2023-02-14,2023-03-24,165.0,67,534,601
735,TSLA  ,2023-02-14,2023-03-24,167.5,20,476,496
736,TSLA  ,2023-02-14,2023-03-24,170.0,170,822,992
737,TSLA  ,2023-02-14,2023-03-24,172.5,28,242,270
738,TSLA  ,2023-02-14,2023-03-24,175.0,128,418,546
739,TSLA  ,2023-02-14,2023-03-24,177.5,30,456,486
740,TSLA  ,2023-02-14,2023-03-24,180.0,191,966,1157
741,TSLA  ,2023-02-14,2023-03-24,182.5,6,131,137
742,TSLA  ,2023-02-14,2023-03-24,185.0,97,278,375
743,TSLA  ,2023-02-14,2023-03-24,187.5,125,48,173
744,TSLA  ,2023-02-14,2023-03-24,190.0,391,661,1052
745,TSLA  ,2023-02-14,2023-03-24,192.5,74,176,250
746,TSLA  ,2023-02-14,2023-03-24,195.0,533,222,755
747,TSLA  ,2023-02-14,2023-03-24,197.5,332,96,428
748,TSLA  ,2023-02-14,2023-03-24,200.0,1913,1656,3569
749,TSLA  ,2023-02-14,2023-03-24,202.5,239,99,338
750,TSLA  ,2023-02-14,2023-03-24,205.0,1314,116,1430
751,TSLA  ,2023-02-14,2023-03-24,207.5,124,98,222
752,TSLA  ,2023-02-14,2023-03-24,210.0,2411,138,2549
753,TSLA  ,2023-02-14,2023-03-24,212.5,189,25,214
754,TSLA  ,2023-02-14,2023-03-24,215.0,417,19,436
755,TSLA  ,2023-02-14,2023-03-24,217.5,184,37,221
756,TSLA  ,2023-02-14,2023-03-24,220.0,2722,565,3287
757,TSLA  ,2023-02-14,2023-03-24,222.5,203,12,215
758,TSLA  ,2023-02-14,2023-03-24,225.0,276,108,384
759,TSLA  ,2023-02-14,2023-03-24,230.0,675,127,802
760,TSLA  ,2023-02-14,2023-03-24,235.0,290,64,354
761,TSLA  ,2023-02-14,2023-03-24,240.0,183,136,319
762,TSLA  ,2023-02-14,2023-03-24,245.0,506,20,526
763,TSLA  ,2023-02-14,2023-03-24,250.0,1103,37,1140
764,TSLA  ,2023-02-14,2023-03-24,255.0,191,21,212
765,TSLA  ,2023-02-14,2023-03-24,260.0,724,2,726
766,TSLA  ,2023-02-14,2023-03-24,265.0,205,1,206
767,TSLA  ,2023-02-14,2023-03-24,270.0,85,1,86
768,TSLA  ,2023-02-14,2023-03-24,275.0,184,3,187
769,TSLA  ,2023-02-14,2023-03-24,280.0,294,0,294
770,TSLA  ,2023-02-14,2023-03-24,285.0,117,0,117
771,TSLA  ,2023-02-14,2023-03-24,290.0,184,0,184
772,TSLA  ,2023-02-14,2023-03-24,295.0,26,0,26
773,TSLA  ,2023-02-14,2023-03-24,300.0,605,0,605
774,TSLA  ,2023-02-14,2023-03-24,310.0,255,0,255
775,TSLA  ,2023-02-14,2023-03-24,320.0,139,0,139
776,TSLA  ,2023-02-14,2023-03-24,330.0,25,0,25
777,TSLA  ,2023-02-14,2023-03-24,340.0,342,0,342
778,TSLA  ,2023-02-14,2023-03-24,350.0,139,0,139
779,TSLA  ,2023-02-14,2023-03-24,360.0,442,0,442
780,TSLA  ,2023-02-14,2023-03-31,25.0,0,0,0
781,TSLA  ,2023-02-14,2023-03-31,30.0,0,0,0
782,TSLA  ,2023-02-14,2023-03-31,35.0,0,0,0
783,TSLA  ,2023-02-14,2023-03-31,40.0,0,0,0
784,TSLA  ,2023-02-14,2023-03-31,45.0,0,0,0
785,TSLA  ,2023-02-14,2023-03-31,50.0,0,2,2
786,TSLA  ,2023-02-14,2023-03-31,55.0,0,0,0
787,TSLA  ,2023-02-14,2023-03-31,60.0,0,12,12
788,TSLA  ,2023-02-14,2023-03-31,65.0,0,1,1
789,TSLA  ,2023-02-14,2023-03-31,70.0,0,8,8
790,TSLA  ,2023-02-14,2023-03-31,75.0,0,5,5
791,TSLA  ,2023-02-14,2023-03-31,80.0,4,4,8
792,TSLA  ,2023-02-14,2023-03-31,85.0,0,2,2
793,TSLA  ,2023-02-14,2023-03-31,90.0,0,18,18
794,TSLA  ,2023-02-14,2023-03-31,95.0,0,82,82
795,TSLA  ,2023-02-14,2023-03-31,100.0,1,46,47
796,TSLA  ,2023-02-14,2023-03-31,105.0,0,159,159
797,TSLA  ,2023-02-14,2023-03-31,110.0,0,49,49
798,TSLA  ,2023-02-14,2023-03-31,115.0,1,95,96
799,TSLA  ,2023-02-14,2023-03-31,120.0,1,80,81
800,TSLA  ,2023-02-14,2023-03-31,125.0,1,31,32
801,TSLA  ,2023-02-14,2023-03-31,130.0,1,85,86
802,TSLA  ,2023-02-14,2023-03-31,135.0,4,223,227
803,TSLA  ,2023-02-14,2023-03-31,140.0,12,87,99
804,TSLA  ,2023-02-14,2023-03-31,145.0,16,114,130
805,TSLA  ,2023-02-14,2023-03-31,150.0,115,183,298
806,TSLA  ,2023-02-14,2023-03-31,155.0,100,61,161
807,TSLA  ,2023-02-14,2023-03-31,160.0,32,103,135
808,TSLA  ,2023-02-14,2023-03-31,165.0,40,180,220
809,TSLA  ,2023-02-14,2023-03-31,170.0,4,770,774
810,TSLA  ,2023-02-14,2023-03-31,172.5,0,53,53
811,TSLA  ,2023-02-14,2023-03-31,175.0,10,109,119
812,TSLA  ,2023-02-14,2023-03-31,177.5,3,49,52
813,TSLA  ,2023-02-14,2023-03-31,180.0,42,155,197
814,TSLA  ,2023-02-14,2023-03-31,182.5,1,15,16
815,TSLA  ,2023-02-14,2023-03-31,185.0,34,43,77
816,TSLA  ,2023-02-14,2023-03-31,187.5,16,32,48
817,TSLA  ,2023-02-14,2023-03-31,190.0,48,87,135
818,TSLA  ,2023-02-14,2023-03-31,192.5,15,29,44
819,TSLA  ,2023-02-14,2023-03-31,195.0,152,69,221
820,TSLA  ,2023-02-14,2023-03-31,197.5,63,23,86
821,TSLA  ,2023-02-14,2023-03-31,200.0,231,139,370
822,TSLA  ,2023-02-14,2023-03-31,202.5,65,27,92
823,TSLA  ,2023-02-14,2023-03-31,205.0,97,66,163
824,TSLA  ,2023-02-14,2023-03-31,207.5,59,30,89
825,TSLA  ,2023-02-14,2023-03-31,210.0,218,40,258
826,TSLA  ,2023-02-14,2023-03-31,212.5,136,22,158
827,TSLA  ,2023-02-14,2023-03-31,215.0,222,10,232
828,TSLA  ,2023-02-14,2023-03-31,217.5,6,0,6
829,TSLA  ,2023-02-14,2023-03-31,220.0,258,4,262
830,TSLA  ,2023-02-14,2023-03-31,222.5,33,0,33
831,TSLA  ,2023-02-14,2023-03-31,225.0,96,2,98
832,TSLA  ,2023-02-14,2023-03-31,230.0,75,1,76
833,TSLA  ,2023-02-14,2023-03-31,235.0,65,22,87
834,TSLA  ,2023-02-14,2023-03-31,240.0,81,1,82
835,TSLA  ,2023-02-14,2023-03-31,245.0,83,1,84
836,TSLA  ,2023-02-14,2023-03-31,250.0,317,0,317
837,TSLA  ,2023-02-14,2023-03-31,255.0,224,1,225
838,TSLA  ,2023-02-14,2023-03-31,260.0,193,21,214
839,TSLA  ,2023-02-14,2023-03-31,265.0,77,0,77
840,TSLA  ,2023-02-14,2023-03-31,270.0,213,1,214
841,TSLA  ,2023-02-14,2023-03-31,275.0,282,0,282
842,TSLA  ,2023-02-14,2023-03-31,280.0,247,1,248
843,TSLA  ,2023-02-14,2023-03-31,285.0,150,0,150
844,TSLA  ,2023-02-14,2023-03-31,290.0,50,0,50
845,TSLA  ,2023-02-14,2023-03-31,295.0,13,0,13
846,TSLA  ,2023-02-14,2023-03-31,300.0,178,0,178
847,TSLA  ,2023-02-14,2023-03-31,310.0,35,0,35
848,TSLA  ,2023-02-14,2023-03-31,320.0,10,0,10
849,TSLA  ,2023-02-14,2023-03-31,330.0,32,0,32
850,TSLA  ,2023-02-14,2023-03-31,340.0,7,0,7
851,TSLA  ,2023-02-14,2023-03-31,350.0,10,0,10
852,TSLA  ,2023-02-14,2023-03-31,360.0,30,0,30
853,TSLA  ,2023-02-14,2023-04-21,5.0,14,101,115
854,TSLA  ,2023-02-14,2023-04-21,10.0,0,8,8
855,TSLA  ,2023-02-14,2023-04-21,15.0,0,41,41
856,TSLA  ,2023-02-14,2023-04-21,20.0,4,320,324
857,TSLA  ,2023-02-14,2023-04-21,25.0,8,2484,2492
858,TSLA  ,2023-02-14,2023-04-21,30.0,0,2020,2020
859,TSLA  ,2023-02-14,2023-04-21,35.0,5,440,445
860,TSLA  ,2023-02-14,2023-04-21,40.0,6,508,514
861,TSLA  ,2023-02-14,2023-04-21,45.0,2,796,798
862,TSLA  ,2023-02-14,2023-04-21,50.0,128,5262,5390
863,TSLA  ,2023-02-14,2023-04-21,55.0,15,2750,2765
864,TSLA  ,2023-02-14,2023-04-21,60.0,19,1973,1992
865,TSLA  ,2023-02-14,2023-04-21,65.0,65,5170,5235
866,TSLA  ,2023-02-14,2023-04-21,70.0,65,4396,4461
867,TSLA  ,2023-02-14,2023-04-21,75.0,123,13203,13326
868,TSLA  ,2023-02-14,2023-04-21,80.0,25226,4567,29793
869,TSLA  ,2023-02-14,2023-04-21,85.0,90,3310,3400
870,TSLA  ,2023-02-14,2023-04-21,90.0,266,2216,2482
871,TSLA  ,2023-02-14,2023-04-21,95.0,151,6129,6280
872,TSLA  ,2023-02-14,2023-04-21,100.0,1564,24621,26185
873,TSLA  ,2023-02-14,2023-04-21,105.0,359,2525,2884
874,TSLA  ,2023-02-14,2023-04-21,108.33,900,4893,5793
875,TSLA  ,2023-02-14,2023-04-21,110.0,1079,7785,8864
876,TSLA  ,2023-02-14,2023-04-21,115.0,1444,3348,4792
877,TSLA  ,2023-02-14,2023-04-21,116.67,2538,9629,12167
878,TSLA  ,2023-02-14,2023-04-21,120.0,7449,10786,18235
879,TSLA  ,2023-02-14,2023-04-21,125.0,11084,12324,23408
880,TSLA  ,2023-02-14,2023-04-21,130.0,1818,7513,9331
881,TSLA  ,2023-02-14,2023-04-21,133.33,4580,3687,8267
882,TSLA  ,2023-02-14,2023-04-21,135.0,1853,2288,4141
883,TSLA  ,2023-02-14,2023-04-21,140.0,2973,7202,10175
884,TSLA  ,2023-02-14,2023-04-21,141.67,6325,3556,9881
885,TSLA  ,2023-02-14,2023-04-21,145.0,1920,2410,4330
886,TSLA  ,2023-02-14,2023-04-21,150.0,7236,17899,25135
887,TSLA  ,2023-02-14,2023-04-21,155.0,1296,1370,2666
888,TSLA  ,2023-02-14,2023-04-21,158.33,2998,4036,7034
889,TSLA  ,2023-02-14,2023-04-21,160.0,2779,4336,7115
890,TSLA  ,2023-02-14,2023-04-21,165.0,1549,1558,3107
891,TSLA  ,2023-02-14,2023-04-21,166.67,2673,5362,8035
892,TSLA  ,2023-02-14,2023-04-21,170.0,1914,3368,5282
893,TSLA  ,2023-02-14,2023-04-21,175.0,10767,7777,18544
894,TSLA  ,2023-02-14,2023-04-21,180.0,2943,4738,7681
895,TSLA  ,2023-02-14,2023-04-21,183.33,2695,3974,6669
896,TSLA  ,2023-02-14,2023-04-21,185.0,2073,3605,5678
897,TSLA  ,2023-02-14,2023-04-21,190.0,2223,6769,8992
898,TSLA  ,2023-02-14,2023-04-21,191.67,3009,13926,16935
899,TSLA  ,2023-02-14,2023-04-21,195.0,3228,2354,5582
900,TSLA  ,2023-02-14,2023-04-21,200.0,12933,9111,22044
901,TSLA  ,2023-02-14,2023-04-21,205.0,3944,2247,6191
902,TSLA  ,2023-02-14,2023-04-21,208.33,6151,2800,8951
903,TSLA  ,2023-02-14,2023-04-21,210.0,4883,2123,7006
904,TSLA  ,2023-02-14,2023-04-21,215.0,2431,1099,3530
905,TSLA  ,2023-02-14,2023-04-21,216.67,1840,2370,4210
906,TSLA  ,2023-02-14,2023-04-21,220.0,6764,788,7552
907,TSLA  ,2023-02-14,2023-04-21,225.0,8681,1927,10608
908,TSLA  ,2023-02-14,2023-04-21,230.0,2052,495,2547
909,TSLA  ,2023-02-14,2023-04-21,233.33,1666,770,2436
910,TSLA  ,2023-02-14,2023-04-21,235.0,1024,282,1306
911,TSLA  ,2023-02-14,2023-04-21,240.0,4395,535,4930
912,TSLA  ,2023-02-14,2023-04-21,241.67,970,86,1056
913,TSLA  ,2023-02-14,2023-04-21,243.33,1230,64,1294
914,TSLA  ,2023-02-14,2023-04-21,245.0,1441,149,1590
915,TSLA  ,2023-02-14,2023-04-21,246.67,1332,76,1408
916,TSLA  ,2023-02-14,2023-04-21,248.33,917,330,1247
917,TSLA  ,2023-02-14,2023-04-21,250.0,9183,817,10000
918,TSLA  ,2023-02-14,2023-04-21,251.67,1621,58,1679
919,TSLA  ,2023-02-14,2023-04-21,253.33,360,37,397
920,TSLA  ,2023-02-14,2023-04-21,255.0,1438,35,1473
921,TSLA  ,2023-02-14,2023-04-21,258.33,1062,894,1956
922,TSLA  ,2023-02-14,2023-04-21,260.0,1952,6,1958
923,TSLA  ,2023-02-14,2023-04-21,265.0,430,1,431
924,TSLA  ,2023-02-14,2023-04-21,266.67,1474,194,1668
925,TSLA  ,2023-02-14,2023-04-21,270.0,736,2,738
926,TSLA  ,2023-02-14,2023-04-21,275.0,2208,91,2299
927,TSLA  ,2023-02-14,2023-04-21,280.0,2130,206,2336
928,TSLA  ,2023-02-14,2023-04-21,283.33,1326,213,1539
929,TSLA  ,2023-02-14,2023-04-21,285.0,196,15,211
930,TSLA  ,2023-02-14,2023-04-21,290.0,226,0,226
931,TSLA  ,2023-02-14,2023-04-21,291.67,3082,30,3112
932,TSLA  ,2023-02-14,2023-04-21,295.0,43,0,43
933,TSLA  ,2023-02-14,2023-04-21,300.0,8447,38,8485
934,TSLA  ,2023-02-14,2023-04-21,305.0,122,0,122
935,TSLA  ,2023-02-14,2023-04-21,308.33,4431,26,4457
936,TSLA  ,2023-02-14,2023-04-21,310.0,707,0,707
937,TSLA  ,2023-02-14,2023-04-21,316.67,22105,2,22107
938,TSLA  ,2023-02-14,2023-04-21,325.0,2623,11,2634
939,TSLA  ,2023-02-14,2023-04-21,333.33,4522,0,4522
940,TSLA  ,2023-02-14,2023-04-21,341.67,761,8,769
941,TSLA  ,2023-02-14,2023-04-21,350.0,3151,0,3151
942,TSLA  ,2023-02-14,2023-04-21,358.33,952,0,952
943,TSLA  ,2023-02-14,2023-04-21,366.67,1078,4,1082
944,TSLA  ,2023-02-14,2023-04-21,375.0,1126,8,1134
945,TSLA  ,2023-02-14,2023-04-21,383.33,675,0,675
946,TSLA  ,2023-02-14,2023-04-21,391.67,424,0,424
947,TSLA  ,2023-02-14,2023-04-21,400.0,3025,0,3025
948,TSLA  ,2023-02-14,2023-04-21,408.33,383,0,383
949,TSLA  ,2023-02-14,2023-04-21,416.67,1159,0,1159
950,TSLA  ,2023-02-14,2023-04-21,425.0,5136,0,5136
951,TSLA  ,2023-02-14,2023-04-21,433.33,12429,0,12429
952,TSLA  ,2023-02-14,2023-04-21,441.67,773,0,773
953,TSLA  ,2023-02-14,2023-04-21,450.0,947,0,947
954,TSLA  ,2023-02-14,2023-04-21,458.33,3188,0,3188
955,TSLA  ,2023-02-14,2023-04-21,466.67,433,0,433
956,TSLA  ,2023-02-14,2023-04-21,475.0,1690,0,1690
957,TSLA  ,2023-02-14,2023-04-21,483.33,827,0,827
958,TSLA  ,2023-02-14,2023-04-21,491.67,176,0,176
959,TSLA  ,2023-02-14,2023-04-21,500.0,3578,0,3578
960,TSLA  ,2023-02-14,2023-04-21,508.33,899,0,899
961,TSLA  ,2023-02-14,2023-04-21,516.67,505,0,505
962,TSLA  ,2023-02-14,2023-04-21,525.0,451,0,451
963,TSLA  ,2023-02-14,2023-04-21,533.33,492,0,492
964,TSLA  ,2023-02-14,2023-04-21,541.67,555,0,555
965,TSLA  ,2023-02-14,2023-04-21,550.0,11216,0,11216
966,TSLA  ,2023-02-14,2023-04-21,558.33,178,0,178
967,TSLA  ,2023-02-14,2023-04-21,566.67,614,0,614
968,TSLA  ,2023-02-14,2023-04-21,575.0,1622,0,1622
969,TSLA  ,2023-02-14,2023-04-21,583.33,991,0,991
970,TSLA  ,2023-02-14,2023-04-21,600.0,20787,0,20787
971,TSLA  ,2023-02-14,2023-05-19,50.0,62,2815,2877
972,TSLA  ,2023-02-14,2023-05-19,55.0,51,600,651
973,TSLA  ,2023-02-14,2023-05-19,60.0,159,954,1113
974,TSLA  ,2023-02-14,2023-05-19,65.0,65,437,502
975,TSLA  ,2023-02-14,2023-05-19,70.0,178,1429,1607
976,TSLA  ,2023-02-14,2023-05-19,75.0,135,1684,1819
977,TSLA  ,2023-02-14,2023-05-19,80.0,85,1568,1653
978,TSLA  ,2023-02-14,2023-05-19,85.0,63,1776,1839
979,TSLA  ,2023-02-14,2023-05-19,90.0,243,2738,2981
980,TSLA  ,2023-02-14,2023-05-19,95.0,132,1720,1852
981,TSLA  ,2023-02-14,2023-05-19,100.0,1077,19502,20579
982,TSLA  ,2023-02-14,2023-05-19,105.0,275,6127,6402
983,TSLA  ,2023-02-14,2023-05-19,110.0,16002,7209,23211
984,TSLA  ,2023-02-14,2023-05-19,115.0,1363,1899,3262
985,TSLA  ,2023-02-14,2023-05-19,120.0,2131,7958,10089
986,TSLA  ,2023-02-14,2023-05-19,125.0,3715,2540,6255
987,TSLA  ,2023-02-14,2023-05-19,130.0,2696,5004,7700
988,TSLA  ,2023-02-14,2023-05-19,135.0,2011,2110,4121
989,TSLA  ,2023-02-14,2023-05-19,140.0,1879,11327,13206
990,TSLA  ,2023-02-14,2023-05-19,145.0,2348,2396,4744
991,TSLA  ,2023-02-14,2023-05-19,150.0,3942,4977,8919
992,TSLA  ,2023-02-14,2023-05-19,155.0,1477,1681,3158
993,TSLA  ,2023-02-14,2023-05-19,160.0,3123,4658,7781
994,TSLA  ,2023-02-14,2023-05-19,165.0,1379,1552,2931
995,TSLA  ,2023-02-14,2023-05-19,170.0,2773,4875,7648
996,TSLA  ,2023-02-14,2023-05-19,175.0,2057,1870,3927
997,TSLA  ,2023-02-14,2023-05-19,180.0,8214,4136,12350
998,TSLA  ,2023-02-14,2023-05-19,185.0,1651,1637,3288
999,TSLA  ,2023-02-14,2023-05-19,190.0,2822,3135,5957
1000,TSLA  ,2023-02-14,2023-05-19,195.0,2796,2243,5039
1001,TSLA  ,2023-02-14,2023-05-19,200.0,7501,2319,9820
1002,TSLA  ,2023-02-14,2023-05-19,205.0,3445,1297,4742
1003,TSLA  ,2023-02-14,2023-05-19,210.0,9957,881,10838
1004,TSLA  ,2023-02-14,2023-05-19,215.0,25248,1294,26542
1005,TSLA  ,2023-02-14,2023-05-19,220.0,2735,1121,3856
1006,TSLA  ,2023-02-14,2023-05-19,225.0,1483,355,1838
1007,TSLA  ,2023-02-14,2023-05-19,230.0,2282,406,2688
1008,TSLA  ,2023-02-14,2023-05-19,235.0,1125,162,1287
1009,TSLA  ,2023-02-14,2023-05-19,240.0,2037,102,2139
1010,TSLA  ,2023-02-14,2023-05-19,245.0,677,135,812
1011,TSLA  ,2023-02-14,2023-05-19,250.0,2497,37,2534
1012,TSLA  ,2023-02-14,2023-05-19,260.0,782,117,899
1013,TSLA  ,2023-02-14,2023-05-19,270.0,2402,133,2535
1014,TSLA  ,2023-02-14,2023-05-19,280.0,656,22,678
1015,TSLA  ,2023-02-14,2023-05-19,290.0,387,367,754
1016,TSLA  ,2023-02-14,2023-05-19,300.0,1331,545,1876
1017,TSLA  ,2023-02-14,2023-05-19,310.0,418,5253,5671
1018,TSLA  ,2023-02-14,2023-05-19,320.0,782,1169,1951
1019,TSLA  ,2023-02-14,2023-05-19,330.0,468,26,494
1020,TSLA  ,2023-02-14,2023-05-19,340.0,392,1,393
1021,TSLA  ,2023-02-14,2023-05-19,350.0,324,5,329
1022,TSLA  ,2023-02-14,2023-05-19,360.0,700,1,701
1023,TSLA  ,2023-02-14,2023-05-19,370.0,111,0,111
1024,TSLA  ,2023-02-14,2023-05-19,380.0,113,0,113
1025,TSLA  ,2023-02-14,2023-05-19,390.0,843,0,843
1026,TSLA  ,2023-02-14,2023-06-16,1.67,106,41911,42017
1027,TSLA  ,2023-02-14,2023-06-16,3.33,399,5010,5409
1028,TSLA  ,2023-02-14,2023-06-16,5.0,108,1684,1792
1029,TSLA  ,2023-02-14,2023-06-16,6.67,75,1309,1384
1030,TSLA  ,2023-02-14,2023-06-16,8.33,425,2371,2796
1031,TSLA  ,2023-02-14,2023-06-16,10.0,3234,3745,6979
1032,TSLA  ,2023-02-14,2023-06-16,11.67,155,8573,8728
1033,TSLA  ,2023-02-14,2023-06-16,13.33,1234,5643,6877
1034,TSLA  ,2023-02-14,2023-06-16,15.0,168,4103,4271
1035,TSLA  ,2023-02-14,2023-06-16,16.67,489,9827,10316
1036,TSLA  ,2023-02-14,2023-06-16,18.33,93,4964,5057
1037,TSLA  ,2023-02-14,2023-06-16,33.33,862,16684,17546
1038,TSLA  ,2023-02-14,2023-06-16,50.0,1108,17423,18531
1039,TSLA  ,2023-02-14,2023-06-16,55.0,31,7343,7374
1040,TSLA  ,2023-02-14,2023-06-16,60.0,15,2295,2310
1041,TSLA  ,2023-02-14,2023-06-16,65.0,4,614,618
1042,TSLA  ,2023-02-14,2023-06-16,66.67,1012,14238,15250
1043,TSLA  ,2023-02-14,2023-06-16,70.0,51,4059,4110
1044,TSLA  ,2023-02-14,2023-06-16,75.0,86,6631,6717
1045,TSLA  ,2023-02-14,2023-06-16,80.0,184,3795,3979
1046,TSLA  ,2023-02-14,2023-06-16,83.33,712,5058,5770
1047,TSLA  ,2023-02-14,2023-06-16,85.0,86,4274,4360
1048,TSLA  ,2023-02-14,2023-06-16,90.0,202,3576,3778
1049,TSLA  ,2023-02-14,2023-06-16,95.0,123,1583,1706
1050,TSLA  ,2023-02-14,2023-06-16,100.0,3480,27562,31042
1051,TSLA  ,2023-02-14,2023-06-16,105.0,362,5351,5713
1052,TSLA  ,2023-02-14,2023-06-16,110.0,1181,5631,6812
1053,TSLA  ,2023-02-14,2023-06-16,115.0,597,2725,3322
1054,TSLA  ,2023-02-14,2023-06-16,116.67,1786,5252,7038
1055,TSLA  ,2023-02-14,2023-06-16,120.0,3436,9869,13305
1056,TSLA  ,2023-02-14,2023-06-16,123.33,456,1141,1597
1057,TSLA  ,2023-02-14,2023-06-16,125.0,4100,7058,11158
1058,TSLA  ,2023-02-14,2023-06-16,126.67,862,1329,2191
1059,TSLA  ,2023-02-14,2023-06-16,130.0,3685,8589,12274
1060,TSLA  ,2023-02-14,2023-06-16,133.33,2533,8910,11443
1061,TSLA  ,2023-02-14,2023-06-16,135.0,2755,2745,5500
1062,TSLA  ,2023-02-14,2023-06-16,136.67,1079,2572,3651
1063,TSLA  ,2023-02-14,2023-06-16,140.0,7782,6483,14265
1064,TSLA  ,2023-02-14,2023-06-16,143.33,1232,3305,4537
1065,TSLA  ,2023-02-14,2023-06-16,145.0,2162,3415,5577
1066,TSLA  ,2023-02-14,2023-06-16,146.67,1590,1929,3519
1067,TSLA  ,2023-02-14,2023-06-16,150.0,12801,13477,26278
1068,TSLA  ,2023-02-14,2023-06-16,153.33,2441,3525,5966
1069,TSLA  ,2023-02-14,2023-06-16,155.0,1231,3101,4332
1070,TSLA  ,2023-02-14,2023-06-16,156.67,1646,756,2402
1071,TSLA  ,2023-02-14,2023-06-16,160.0,6585,7122,13707
1072,TSLA  ,2023-02-14,2023-06-16,163.33,977,1177,2154
1073,TSLA  ,2023-02-14,2023-06-16,165.0,1835,2928,4763
1074,TSLA  ,2023-02-14,2023-06-16,166.67,3671,12897,16568
1075,TSLA  ,2023-02-14,2023-06-16,170.0,2776,4282,7058
1076,TSLA  ,2023-02-14,2023-06-16,173.33,1454,6221,7675
1077,TSLA  ,2023-02-14,2023-06-16,175.0,2759,5486,8245
1078,TSLA  ,2023-02-14,2023-06-16,180.0,8363,8592,16955
1079,TSLA  ,2023-02-14,2023-06-16,183.33,9951,10316,20267
1080,TSLA  ,2023-02-14,2023-06-16,185.0,8039,7098,15137
1081,TSLA  ,2023-02-14,2023-06-16,186.67,965,1926,2891
1082,TSLA  ,2023-02-14,2023-06-16,190.0,5839,4630,10469
1083,TSLA  ,2023-02-14,2023-06-16,193.33,1894,7784,9678
1084,TSLA  ,2023-02-14,2023-06-16,195.0,2705,2705,5410
1085,TSLA  ,2023-02-14,2023-06-16,200.0,24213,21618,45831
1086,TSLA  ,2023-02-14,2023-06-16,205.0,2556,1099,3655
1087,TSLA  ,2023-02-14,2023-06-16,206.67,2337,3085,5422
1088,TSLA  ,2023-02-14,2023-06-16,210.0,4633,1959,6592
1089,TSLA  ,2023-02-14,2023-06-16,213.33,1873,2618,4491
1090,TSLA  ,2023-02-14,2023-06-16,215.0,3380,1165,4545
1091,TSLA  ,2023-02-14,2023-06-16,216.67,6614,6161,12775
1092,TSLA  ,2023-02-14,2023-06-16,220.0,7626,6935,14561
1093,TSLA  ,2023-02-14,2023-06-16,225.0,1707,1239,2946
1094,TSLA  ,2023-02-14,2023-06-16,226.67,1369,2015,3384
1095,TSLA  ,2023-02-14,2023-06-16,230.0,6573,3036,9609
1096,TSLA  ,2023-02-14,2023-06-16,233.33,10583,7536,18119
1097,TSLA  ,2023-02-14,2023-06-16,235.0,2248,692,2940
1098,TSLA  ,2023-02-14,2023-06-16,240.0,7716,3074,10790
1099,TSLA  ,2023-02-14,2023-06-16,243.33,1310,1694,3004
1100,TSLA  ,2023-02-14,2023-06-16,245.0,1860,64,1924
1101,TSLA  ,2023-02-14,2023-06-16,246.67,3028,90,3118
1102,TSLA  ,2023-02-14,2023-06-16,250.0,15238,3412,18650
1103,TSLA  ,2023-02-14,2023-06-16,253.33,1364,195,1559
1104,TSLA  ,2023-02-14,2023-06-16,255.0,1200,73,1273
1105,TSLA  ,2023-02-14,2023-06-16,260.0,5132,79,5211
1106,TSLA  ,2023-02-14,2023-06-16,265.0,1950,56,2006
1107,TSLA  ,2023-02-14,2023-06-16,266.67,7278,409,7687
1108,TSLA  ,2023-02-14,2023-06-16,270.0,1390,7,1397
1109,TSLA  ,2023-02-14,2023-06-16,273.33,1334,1051,2385
1110,TSLA  ,2023-02-14,2023-06-16,275.0,2359,5,2364
1111,TSLA  ,2023-02-14,2023-06-16,280.0,3898,61,3959
1112,TSLA  ,2023-02-14,2023-06-16,283.33,4640,51,4691
1113,TSLA  ,2023-02-14,2023-06-16,285.0,999,2,1001
1114,TSLA  ,2023-02-14,2023-06-16,286.67,757,30,787
1115,TSLA  ,2023-02-14,2023-06-16,290.0,726,827,1553
1116,TSLA  ,2023-02-14,2023-06-16,293.33,1619,62,1681
1117,TSLA  ,2023-02-14,2023-06-16,295.0,297,258,555
1118,TSLA  ,2023-02-14,2023-06-16,300.0,18104,112,18216
1119,TSLA  ,2023-02-14,2023-06-16,305.0,994,5,999
1120,TSLA  ,2023-02-14,2023-06-16,306.67,1470,30,1500
1121,TSLA  ,2023-02-14,2023-06-16,310.0,1681,44,1725
1122,TSLA  ,2023-02-14,2023-06-16,313.33,538,33,571
1123,TSLA  ,2023-02-14,2023-06-16,315.0,329,82,411
1124,TSLA  ,2023-02-14,2023-06-16,316.67,7183,241,7424
1125,TSLA  ,2023-02-14,2023-06-16,320.0,2458,3,2461
1126,TSLA  ,2023-02-14,2023-06-16,326.67,9728,6,9734
1127,TSLA  ,2023-02-14,2023-06-16,330.0,1235,50,1285
1128,TSLA  ,2023-02-14,2023-06-16,333.33,33831,231,34062
1129,TSLA  ,2023-02-14,2023-06-16,340.0,1659,3,1662
1130,TSLA  ,2023-02-14,2023-06-16,346.67,1312,0,1312
1131,TSLA  ,2023-02-14,2023-06-16,350.0,8587,334,8921
1132,TSLA  ,2023-02-14,2023-06-16,353.33,890,0,890
1133,TSLA  ,2023-02-14,2023-06-16,360.0,1870,1,1871
1134,TSLA  ,2023-02-14,2023-06-16,366.67,10905,450,11355
1135,TSLA  ,2023-02-14,2023-06-16,370.0,912,0,912
1136,TSLA  ,2023-02-14,2023-06-16,383.33,10931,0,10931
1137,TSLA  ,2023-02-14,2023-06-16,400.0,18525,919,19444
1138,TSLA  ,2023-02-14,2023-06-16,416.67,3612,0,3612
1139,TSLA  ,2023-02-14,2023-06-16,433.33,9698,0,9698
1140,TSLA  ,2023-02-14,2023-06-16,450.0,8188,0,8188
1141,TSLA  ,2023-02-14,2023-06-16,466.67,20905,0,20905
1142,TSLA  ,2023-02-14,2023-06-16,483.33,8238,0,8238
1143,TSLA  ,2023-02-14,2023-06-16,500.0,20932,0,20932
1144,TSLA  ,2023-02-14,2023-06-16,516.67,2703,0,2703
1145,TSLA  ,2023-02-14,2023-06-16,533.33,4878,0,4878
1146,TSLA  ,2023-02-14,2023-06-16,550.0,6121,0,6121
1147,TSLA  ,2023-02-14,2023-06-16,558.33,1693,0,1693
1148,TSLA  ,2023-02-14,2023-06-16,566.67,1259,0,1259
1149,TSLA  ,2023-02-14,2023-06-16,575.0,696,0,696
1150,TSLA  ,2023-02-14,2023-06-16,583.33,1198,0,1198
1151,TSLA  ,2023-02-14,2023-06-16,591.67,391,0,391
1152,TSLA  ,2023-02-14,2023-06-16,600.0,6765,0,6765
1153,TSLA  ,2023-02-14,2023-06-16,608.33,1140,0,1140
1154,TSLA  ,2023-02-14,2023-06-16,616.67,599,0,599
1155,TSLA  ,2023-02-14,2023-06-16,625.0,2173,0,2173
1156,TSLA  ,2023-02-14,2023-06-16,633.33,5396,0,5396
1157,TSLA  ,2023-02-14,2023-06-16,641.67,435,0,435
1158,TSLA  ,2023-02-14,2023-06-16,650.0,593,0,593
1159,TSLA  ,2023-02-14,2023-06-16,666.67,17917,0,17917
1160,TSLA  ,2023-02-14,2023-06-16,675.0,921,0,921
1161,TSLA  ,2023-02-14,2023-06-16,683.33,605,0,605
1162,TSLA  ,2023-02-14,2023-06-16,691.67,886,0,886
1163,TSLA  ,2023-02-14,2023-06-16,700.0,2726,0,2726
1164,TSLA  ,2023-02-14,2023-06-16,708.33,552,0,552
1165,TSLA  ,2023-02-14,2023-06-16,716.67,715,0,715
1166,TSLA  ,2023-02-14,2023-06-16,725.0,1170,0,1170
1167,TSLA  ,2023-02-14,2023-06-16,733.33,2256,0,2256
1168,TSLA  ,2023-02-14,2023-06-16,741.67,777,0,777
1169,TSLA  ,2023-02-14,2023-06-16,750.0,11840,0,11840
1170,TSLA  ,2023-02-14,2023-06-16,758.33,1298,0,1298
1171,TSLA  ,2023-02-14,2023-06-16,766.67,1263,0,1263
1172,TSLA  ,2023-02-14,2023-06-16,775.0,1166,0,1166
1173,TSLA  ,2023-02-14,2023-06-16,783.33,2176,0,2176
1174,TSLA  ,2023-02-14,2023-06-16,791.67,1856,0,1856
1175,TSLA  ,2023-02-14,2023-06-16,800.0,10125,0,10125
1176,TSLA  ,2023-02-14,2023-06-16,808.33,1233,0,1233
1177,TSLA  ,2023-02-14,2023-06-16,816.67,1872,0,1872
1178,TSLA  ,2023-02-14,2023-06-16,825.0,41690,0,41690
1179,TSLA  ,2023-02-14,2023-07-21,5.0,32,721,753
1180,TSLA  ,2023-02-14,2023-07-21,10.0,5,906,911
1181,TSLA  ,2023-02-14,2023-07-21,15.0,4,383,387
1182,TSLA  ,2023-02-14,2023-07-21,20.0,12,1205,1217
1183,TSLA  ,2023-02-14,2023-07-21,25.0,25,1089,1114
1184,TSLA  ,2023-02-14,2023-07-21,30.0,111,1375,1486
1185,TSLA  ,2023-02-14,2023-07-21,35.0,45,838,883
1186,TSLA  ,2023-02-14,2023-07-21,40.0,21,1136,1157
1187,TSLA  ,2023-02-14,2023-07-21,45.0,38,623,661
1188,TSLA  ,2023-02-14,2023-07-21,50.0,71,5104,5175
1189,TSLA  ,2023-02-14,2023-07-21,55.0,86,1856,1942
1190,TSLA  ,2023-02-14,2023-07-21,60.0,94,3334,3428
1191,TSLA  ,2023-02-14,2023-07-21,65.0,86,401,487
1192,TSLA  ,2023-02-14,2023-07-21,70.0,25,2399,2424
1193,TSLA  ,2023-02-14,2023-07-21,75.0,63,4152,4215
1194,TSLA  ,2023-02-14,2023-07-21,80.0,79,3656,3735
1195,TSLA  ,2023-02-14,2023-07-21,85.0,54,1384,1438
1196,TSLA  ,2023-02-14,2023-07-21,90.0,121,3410,3531
1197,TSLA  ,2023-02-14,2023-07-21,95.0,66,1613,1679
1198,TSLA  ,2023-02-14,2023-07-21,100.0,296,5629,5925
1199,TSLA  ,2023-02-14,2023-07-21,105.0,377,2492,2869
1200,TSLA  ,2023-02-14,2023-07-21,110.0,1129,3009,4138
1201,TSLA  ,2023-02-14,2023-07-21,115.0,467,1017,1484
1202,TSLA  ,2023-02-14,2023-07-21,120.0,1241,4577,5818
1203,TSLA  ,2023-02-14,2023-07-21,125.0,1417,2184,3601
1204,TSLA  ,2023-02-14,2023-07-21,130.0,1496,1771,3267
1205,TSLA  ,2023-02-14,2023-07-21,135.0,1152,2879,4031
1206,TSLA  ,2023-02-14,2023-07-21,140.0,1467,3173,4640
1207,TSLA  ,2023-02-14,2023-07-21,145.0,1059,2192,3251
1208,TSLA  ,2023-02-14,2023-07-21,150.0,3170,3861,7031
1209,TSLA  ,2023-02-14,2023-07-21,155.0,1680,2873,4553
1210,TSLA  ,2023-02-14,2023-07-21,160.0,1761,1464,3225
1211,TSLA  ,2023-02-14,2023-07-21,165.0,658,1475,2133
1212,TSLA  ,2023-02-14,2023-07-21,170.0,1774,2203,3977
1213,TSLA  ,2023-02-14,2023-07-21,175.0,1636,1484,3120
1214,TSLA  ,2023-02-14,2023-07-21,180.0,2125,1928,4053
1215,TSLA  ,2023-02-14,2023-07-21,185.0,3904,12984,16888
1216,TSLA  ,2023-02-14,2023-07-21,190.0,2552,2268,4820
1217,TSLA  ,2023-02-14,2023-07-21,195.0,1385,1969,3354
1218,TSLA  ,2023-02-14,2023-07-21,200.0,4223,2516,6739
1219,TSLA  ,2023-02-14,2023-07-21,205.0,1961,1002,2963
1220,TSLA  ,2023-02-14,2023-07-21,210.0,4524,1778,6302
1221,TSLA  ,2023-02-14,2023-07-21,215.0,3483,1183,4666
1222,TSLA  ,2023-02-14,2023-07-21,220.0,2708,1731,4439
1223,TSLA  ,2023-02-14,2023-07-21,225.0,4879,2159,7038
1224,TSLA  ,2023-02-14,2023-07-21,230.0,1600,1287,2887
1225,TSLA  ,2023-02-14,2023-07-21,235.0,1331,661,1992
1226,TSLA  ,2023-02-14,2023-07-21,240.0,1313,1738,3051
1227,TSLA  ,2023-02-14,2023-07-21,245.0,700,678,1378
1228,TSLA  ,2023-02-14,2023-07-21,250.0,24460,1578,26038
1229,TSLA  ,2023-02-14,2023-07-21,255.0,797,644,1441
1230,TSLA  ,2023-02-14,2023-07-21,260.0,1052,83,1135
1231,TSLA  ,2023-02-14,2023-07-21,265.0,504,9,513
1232,TSLA  ,2023-02-14,2023-07-21,270.0,609,126,735
1233,TSLA  ,2023-02-14,2023-07-21,275.0,284,82,366
1234,TSLA  ,2023-02-14,2023-07-21,280.0,1182,147,1329
1235,TSLA  ,2023-02-14,2023-07-21,285.0,829,147,976
1236,TSLA  ,2023-02-14,2023-07-21,290.0,444,35,479
1237,TSLA  ,2023-02-14,2023-07-21,295.0,304,11,315
1238,TSLA  ,2023-02-14,2023-07-21,300.0,2075,9,2084
1239,TSLA  ,2023-02-14,2023-07-21,305.0,257,6,263
1240,TSLA  ,2023-02-14,2023-07-21,310.0,1373,6,1379
1241,TSLA  ,2023-02-14,2023-07-21,315.0,392,1,393
1242,TSLA  ,2023-02-14,2023-07-21,320.0,587,0,587
1243,TSLA  ,2023-02-14,2023-07-21,325.0,678,0,678
1244,TSLA  ,2023-02-14,2023-07-21,330.0,411,25,436
1245,TSLA  ,2023-02-14,2023-07-21,335.0,152,7,159
1246,TSLA  ,2023-02-14,2023-07-21,340.0,432,16,448
1247,TSLA  ,2023-02-14,2023-07-21,345.0,156,0,156
1248,TSLA  ,2023-02-14,2023-07-21,350.0,676,1,677
1249,TSLA  ,2023-02-14,2023-07-21,355.0,266,1,267
1250,TSLA  ,2023-02-14,2023-07-21,360.0,552,0,552
1251,TSLA  ,2023-02-14,2023-07-21,365.0,877,0,877
1252,TSLA  ,2023-02-14,2023-07-21,370.0,1053,0,1053
1253,TSLA  ,2023-02-14,2023-07-21,375.0,3171,0,3171
1254,TSLA  ,2023-02-14,2023-07-21,380.0,165,0,165
1255,TSLA  ,2023-02-14,2023-07-21,390.0,445,0,445
1256,TSLA  ,2023-02-14,2023-09-15,1.67,861,20022,20883
1257,TSLA  ,2023-02-14,2023-09-15,3.33,1085,2849,3934
1258,TSLA  ,2023-02-14,2023-09-15,5.0,25,942,967
1259,TSLA  ,2023-02-14,2023-09-15,6.67,29,3366,3395
1260,TSLA  ,2023-02-14,2023-09-15,8.33,32,1178,1210
1261,TSLA  ,2023-02-14,2023-09-15,10.0,26,2196,2222
1262,TSLA  ,2023-02-14,2023-09-15,11.67,49,617,666
1263,TSLA  ,2023-02-14,2023-09-15,13.33,83,230,313
1264,TSLA  ,2023-02-14,2023-09-15,15.0,0,116,116
1265,TSLA  ,2023-02-14,2023-09-15,16.67,143,4195,4338
1266,TSLA  ,2023-02-14,2023-09-15,30.0,0,74,74
1267,TSLA  ,2023-02-14,2023-09-15,33.33,3118,11363,14481
1268,TSLA  ,2023-02-14,2023-09-15,35.0,5,36,41
1269,TSLA  ,2023-02-14,2023-09-15,40.0,6,272,278
1270,TSLA  ,2023-02-14,2023-09-15,45.0,6,49,55
1271,TSLA  ,2023-02-14,2023-09-15,50.0,414,7543,7957
1272,TSLA  ,2023-02-14,2023-09-15,55.0,22,2374,2396
1273,TSLA  ,2023-02-14,2023-09-15,60.0,30,4738,4768
1274,TSLA  ,2023-02-14,2023-09-15,65.0,4,2122,2126
1275,TSLA  ,2023-02-14,2023-09-15,66.67,434,5671,6105
1276,TSLA  ,2023-02-14,2023-09-15,70.0,88,613,701
1277,TSLA  ,2023-02-14,2023-09-15,75.0,26,635,661
1278,TSLA  ,2023-02-14,2023-09-15,80.0,260,806,1066
1279,TSLA  ,2023-02-14,2023-09-15,83.33,407,4464,4871
1280,TSLA  ,2023-02-14,2023-09-15,85.0,52,321,373
1281,TSLA  ,2023-02-14,2023-09-15,90.0,485,2653,3138
1282,TSLA  ,2023-02-14,2023-09-15,95.0,70,2476,2546
1283,TSLA  ,2023-02-14,2023-09-15,100.0,2362,11941,14303
1284,TSLA  ,2023-02-14,2023-09-15,105.0,88,2150,2238
1285,TSLA  ,2023-02-14,2023-09-15,108.33,397,2143,2540
1286,TSLA  ,2023-02-14,2023-09-15,110.0,1243,1503,2746
1287,TSLA  ,2023-02-14,2023-09-15,115.0,187,2717,2904
1288,TSLA  ,2023-02-14,2023-09-15,116.67,569,12225,12794
1289,TSLA  ,2023-02-14,2023-09-15,120.0,1014,2049,3063
1290,TSLA  ,2023-02-14,2023-09-15,123.33,543,1349,1892
1291,TSLA  ,2023-02-14,2023-09-15,125.0,1731,7602,9333
1292,TSLA  ,2023-02-14,2023-09-15,126.67,130,1072,1202
1293,TSLA  ,2023-02-14,2023-09-15,130.0,1395,4931,6326
1294,TSLA  ,2023-02-14,2023-09-15,133.33,208,2369,2577
1295,TSLA  ,2023-02-14,2023-09-15,135.0,206,1224,1430
1296,TSLA  ,2023-02-14,2023-09-15,136.67,285,954,1239
1297,TSLA  ,2023-02-14,2023-09-15,140.0,1761,2189,3950
1298,TSLA  ,2023-02-14,2023-09-15,141.67,765,1679,2444
1299,TSLA  ,2023-02-14,2023-09-15,143.33,283,1540,1823
1300,TSLA  ,2023-02-14,2023-09-15,145.0,366,2606,2972
1301,TSLA  ,2023-02-14,2023-09-15,146.67,1372,1084,2456
1302,TSLA  ,2023-02-14,2023-09-15,150.0,33801,9210,43011
1303,TSLA  ,2023-02-14,2023-09-15,153.33,30481,1844,32325
1304,TSLA  ,2023-02-14,2023-09-15,155.0,419,386,805
1305,TSLA  ,2023-02-14,2023-09-15,156.67,394,668,1062
1306,TSLA  ,2023-02-14,2023-09-15,158.33,314,556,870
1307,TSLA  ,2023-02-14,2023-09-15,160.0,3725,7032,10757
1308,TSLA  ,2023-02-14,2023-09-15,163.33,415,1492,1907
1309,TSLA  ,2023-02-14,2023-09-15,165.0,1295,857,2152
1310,TSLA  ,2023-02-14,2023-09-15,166.67,1397,3073,4470
1311,TSLA  ,2023-02-14,2023-09-15,170.0,658,700,1358
1312,TSLA  ,2023-02-14,2023-09-15,173.33,10314,2961,13275
1313,TSLA  ,2023-02-14,2023-09-15,175.0,10955,7544,18499
1314,TSLA  ,2023-02-14,2023-09-15,180.0,33758,6478,40236
1315,TSLA  ,2023-02-14,2023-09-15,183.33,32300,5242,37542
1316,TSLA  ,2023-02-14,2023-09-15,185.0,339,697,1036
1317,TSLA  ,2023-02-14,2023-09-15,186.67,524,3458,3982
1318,TSLA  ,2023-02-14,2023-09-15,190.0,741,2919,3660
1319,TSLA  ,2023-02-14,2023-09-15,191.67,483,1161,1644
1320,TSLA  ,2023-02-14,2023-09-15,193.33,906,2814,3720
1321,TSLA  ,2023-02-14,2023-09-15,195.0,431,767,1198
1322,TSLA  ,2023-02-14,2023-09-15,200.0,11750,17122,28872
1323,TSLA  ,2023-02-14,2023-09-15,205.0,401,152,553
1324,TSLA  ,2023-02-14,2023-09-15,206.67,1060,484,1544
1325,TSLA  ,2023-02-14,2023-09-15,208.33,566,1975,2541
1326,TSLA  ,2023-02-14,2023-09-15,210.0,2425,307,2732
1327,TSLA  ,2023-02-14,2023-09-15,213.33,645,1299,1944
1328,TSLA  ,2023-02-14,2023-09-15,215.0,687,192,879
1329,TSLA  ,2023-02-14,2023-09-15,216.67,1807,4252,6059
1330,TSLA  ,2023-02-14,2023-09-15,220.0,6785,3180,9965
1331,TSLA  ,2023-02-14,2023-09-15,225.0,2559,3297,5856
1332,TSLA  ,2023-02-14,2023-09-15,226.67,1310,1436,2746
1333,TSLA  ,2023-02-14,2023-09-15,230.0,2535,839,3374
1334,TSLA  ,2023-02-14,2023-09-15,233.33,2788,3270,6058
1335,TSLA  ,2023-02-14,2023-09-15,235.0,353,609,962
1336,TSLA  ,2023-02-14,2023-09-15,240.0,1350,2208,3558
1337,TSLA  ,2023-02-14,2023-09-15,241.67,1350,826,2176
1338,TSLA  ,2023-02-14,2023-09-15,245.0,165,211,376
1339,TSLA  ,2023-02-14,2023-09-15,246.67,525,488,1013
1340,TSLA  ,2023-02-14,2023-09-15,250.0,10719,4570,15289
1341,TSLA  ,2023-02-14,2023-09-15,253.33,794,541,1335
1342,TSLA  ,2023-02-14,2023-09-15,255.0,282,12,294
1343,TSLA  ,2023-02-14,2023-09-15,258.33,937,2408,3345
1344,TSLA  ,2023-02-14,2023-09-15,260.0,11952,1418,13370
1345,TSLA  ,2023-02-14,2023-09-15,265.0,292,150,442
1346,TSLA  ,2023-02-14,2023-09-15,266.67,2419,319,2738
1347,TSLA  ,2023-02-14,2023-09-15,270.0,435,162,597
1348,TSLA  ,2023-02-14,2023-09-15,273.33,716,354,1070
1349,TSLA  ,2023-02-14,2023-09-15,275.0,2813,345,3158
1350,TSLA  ,2023-02-14,2023-09-15,280.0,2135,569,2704
1351,TSLA  ,2023-02-14,2023-09-15,283.33,1263,315,1578
1352,TSLA  ,2023-02-14,2023-09-15,286.67,619,97,716
1353,TSLA  ,2023-02-14,2023-09-15,290.0,1337,60,1397
1354,TSLA  ,2023-02-14,2023-09-15,291.67,991,376,1367
1355,TSLA  ,2023-02-14,2023-09-15,293.33,1350,402,1752
1356,TSLA  ,2023-02-14,2023-09-15,300.0,7533,965,8498
1357,TSLA  ,2023-02-14,2023-09-15,306.67,2706,327,3033
1358,TSLA  ,2023-02-14,2023-09-15,308.33,841,335,1176
1359,TSLA  ,2023-02-14,2023-09-15,310.0,63,0,63
1360,TSLA  ,2023-02-14,2023-09-15,313.33,796,286,1082
1361,TSLA  ,2023-02-14,2023-09-15,316.67,1598,161,1759
1362,TSLA  ,2023-02-14,2023-09-15,320.0,1787,169,1956
1363,TSLA  ,2023-02-14,2023-09-15,325.0,2750,75,2825
1364,TSLA  ,2023-02-14,2023-09-15,326.67,1070,5,1075
1365,TSLA  ,2023-02-14,2023-09-15,333.33,6442,84,6526
1366,TSLA  ,2023-02-14,2023-09-15,340.0,23347,147,23494
1367,TSLA  ,2023-02-14,2023-09-15,341.67,176,187,363
1368,TSLA  ,2023-02-14,2023-09-15,346.67,549,135,684
1369,TSLA  ,2023-02-14,2023-09-15,350.0,20977,328,21305
1370,TSLA  ,2023-02-14,2023-09-15,353.33,22687,149,22836
1371,TSLA  ,2023-02-14,2023-09-15,358.33,459,287,746
1372,TSLA  ,2023-02-14,2023-09-15,360.0,3283,305,3588
1373,TSLA  ,2023-02-14,2023-09-15,366.67,3056,561,3617
1374,TSLA  ,2023-02-14,2023-09-15,375.0,3275,160,3435
1375,TSLA  ,2023-02-14,2023-09-15,383.33,4637,17,4654
1376,TSLA  ,2023-02-14,2023-09-15,391.67,838,14,852
1377,TSLA  ,2023-02-14,2023-09-15,400.0,5668,69,5737
1378,TSLA  ,2023-02-14,2023-09-15,408.33,1598,1,1599
1379,TSLA  ,2023-02-14,2023-09-15,416.67,973,0,973
1380,TSLA  ,2023-02-14,2023-09-15,425.0,3226,0,3226
1381,TSLA  ,2023-02-14,2023-09-15,433.33,4932,8,4940
1382,TSLA  ,2023-02-14,2023-09-15,441.67,1034,0,1034
1383,TSLA  ,2023-02-14,2023-09-15,450.0,2453,0,2453
1384,TSLA  ,2023-02-14,2023-09-15,458.33,402,0,402
1385,TSLA  ,2023-02-14,2023-09-15,466.67,2692,0,2692
1386,TSLA  ,2023-02-14,2023-09-15,475.0,340,0,340
1387,TSLA  ,2023-02-14,2023-09-15,483.33,669,0,669
1388,TSLA  ,2023-02-14,2023-09-15,491.67,1097,0,1097
1389,TSLA  ,2023-02-14,2023-09-15,500.0,5192,0,5192
1390,TSLA  ,2023-02-14,2023-09-15,508.33,811,0,811
1391,TSLA  ,2023-02-14,2023-09-15,516.67,1265,0,1265
1392,TSLA  ,2023-02-14,2023-09-15,525.0,1195,0,1195
1393,TSLA  ,2023-02-14,2023-09-15,533.33,1617,0,1617
1394,TSLA  ,2023-02-14,2023-09-15,541.67,1161,0,1161
1395,TSLA  ,2023-02-14,2023-09-15,550.0,11715,0,11715
1396,TSLA  ,2023-02-14,2023-09-15,558.33,189,0,189
1397,TSLA  ,2023-02-14,2023-09-15,566.67,4041,0,4041
1398,TSLA  ,2023-02-14,2023-09-15,575.0,377,0,377
1399,TSLA  ,2023-02-14,2023-09-15,583.33,512,0,512
1400,TSLA  ,2023-02-14,2023-09-15,591.67,2112,0,2112
1401,TSLA  ,2023-02-14,2023-09-15,600.0,8631,0,8631
1402,TSLA  ,2023-02-14,2023-09-15,608.33,672,0,672
1403,TSLA  ,2023-02-14,2023-09-15,616.67,1021,0,1021
1404,TSLA  ,2023-02-14,2023-09-15,625.0,1065,0,1065
1405,TSLA  ,2023-02-14,2023-09-15,633.33,693,0,693
1406,TSLA  ,2023-02-14,2023-09-15,641.67,416,0,416
1407,TSLA  ,2023-02-14,2023-09-15,650.0,27469,0,27469
1408,TSLA  ,2023-02-14,2023-09-15,658.33,1207,0,1207
1409,TSLA  ,2023-02-14,2023-09-15,666.67,1348,0,1348
1410,TSLA  ,2023-02-14,2023-09-15,675.0,497,0,497
1411,TSLA  ,2023-02-14,2023-09-15,683.33,454,0,454
1412,TSLA  ,2023-02-14,2023-09-15,700.0,1538,0,1538
1413,TSLA  ,2023-02-14,2023-09-15,716.67,1062,0,1062
1414,TSLA  ,2023-02-14,2023-09-15,733.33,2321,0,2321
1415,TSLA  ,2023-02-14,2023-09-15,750.0,8185,0,8185
1416,TSLA  ,2023-02-14,2023-09-15,758.33,71849,0,71849
1417,TSLA  ,2023-02-14,2023-12-15,50.0,1277,13770,15047
1418,TSLA  ,2023-02-14,2023-12-15,55.0,63,1160,1223
1419,TSLA  ,2023-02-14,2023-12-15,60.0,40,1138,1178
1420,TSLA  ,2023-02-14,2023-12-15,65.0,4,372,376
1421,TSLA  ,2023-02-14,2023-12-15,70.0,27,3824,3851
1422,TSLA  ,2023-02-14,2023-12-15,75.0,18,4151,4169
1423,TSLA  ,2023-02-14,2023-12-15,80.0,156,815,971
1424,TSLA  ,2023-02-14,2023-12-15,85.0,2576,2380,4956
1425,TSLA  ,2023-02-14,2023-12-15,90.0,1646,6036,7682
1426,TSLA  ,2023-02-14,2023-12-15,95.0,831,498,1329
1427,TSLA  ,2023-02-14,2023-12-15,100.0,1916,6166,8082
1428,TSLA  ,2023-02-14,2023-12-15,105.0,323,740,1063
1429,TSLA  ,2023-02-14,2023-12-15,110.0,680,2150,2830
1430,TSLA  ,2023-02-14,2023-12-15,115.0,1714,962,2676
1431,TSLA  ,2023-02-14,2023-12-15,120.0,1022,1284,2306
1432,TSLA  ,2023-02-14,2023-12-15,125.0,492,1448,1940
1433,TSLA  ,2023-02-14,2023-12-15,130.0,769,10913,11682
1434,TSLA  ,2023-02-14,2023-12-15,135.0,790,6062,6852
1435,TSLA  ,2023-02-14,2023-12-15,140.0,959,1721,2680
1436,TSLA  ,2023-02-14,2023-12-15,145.0,629,941,1570
1437,TSLA  ,2023-02-14,2023-12-15,150.0,1507,12313,13820
1438,TSLA  ,2023-02-14,2023-12-15,155.0,405,1018,1423
1439,TSLA  ,2023-02-14,2023-12-15,160.0,2839,10956,13795
1440,TSLA  ,2023-02-14,2023-12-15,165.0,1446,506,1952
1441,TSLA  ,2023-02-14,2023-12-15,170.0,729,4490,5219
1442,TSLA  ,2023-02-14,2023-12-15,175.0,2173,421,2594
1443,TSLA  ,2023-02-14,2023-12-15,180.0,1617,1213,2830
1444,TSLA  ,2023-02-14,2023-12-15,185.0,554,645,1199
1445,TSLA  ,2023-02-14,2023-12-15,190.0,1159,562,1721
1446,TSLA  ,2023-02-14,2023-12-15,195.0,739,591,1330
1447,TSLA  ,2023-02-14,2023-12-15,200.0,8301,1571,9872
1448,TSLA  ,2023-02-14,2023-12-15,205.0,6475,745,7220
1449,TSLA  ,2023-02-14,2023-12-15,210.0,2590,641,3231
1450,TSLA  ,2023-02-14,2023-12-15,215.0,1279,599,1878
1451,TSLA  ,2023-02-14,2023-12-15,220.0,1632,1151,2783
1452,TSLA  ,2023-02-14,2023-12-15,225.0,1197,286,1483
1453,TSLA  ,2023-02-14,2023-12-15,230.0,1668,715,2383
1454,TSLA  ,2023-02-14,2023-12-15,235.0,516,437,953
1455,TSLA  ,2023-02-14,2023-12-15,240.0,5745,711,6456
1456,TSLA  ,2023-02-14,2023-12-15,245.0,1958,513,2471
1457,TSLA  ,2023-02-14,2023-12-15,250.0,15658,3658,19316
1458,TSLA  ,2023-02-14,2023-12-15,260.0,10091,752,10843
1459,TSLA  ,2023-02-14,2023-12-15,270.0,3973,517,4490
1460,TSLA  ,2023-02-14,2023-12-15,280.0,1226,677,1903
1461,TSLA  ,2023-02-14,2023-12-15,290.0,578,491,1069
1462,TSLA  ,2023-02-14,2023-12-15,300.0,1406,1026,2432
1463,TSLA  ,2023-02-14,2023-12-15,310.0,760,620,1380
1464,TSLA  ,2023-02-14,2023-12-15,320.0,1169,537,1706
1465,TSLA  ,2023-02-14,2023-12-15,330.0,436,232,668
1466,TSLA  ,2023-02-14,2023-12-15,340.0,333,120,453
1467,TSLA  ,2023-02-14,2023-12-15,350.0,844,183,1027
1468,TSLA  ,2023-02-14,2023-12-15,360.0,532,117,649
1469,TSLA  ,2023-02-14,2023-12-15,370.0,54,243,297
1470,TSLA  ,2023-02-14,2023-12-15,380.0,207,321,528
1471,TSLA  ,2023-02-14,2023-12-15,390.0,377,146,523
1472,TSLA  ,2023-02-14,2024-01-19,1.67,2495,29585,32080
1473,TSLA  ,2023-02-14,2024-01-19,3.33,966,5937,6903
1474,TSLA  ,2023-02-14,2024-01-19,5.0,256,10181,10437
1475,TSLA  ,2023-02-14,2024-01-19,6.67,76,3219,3295
1476,TSLA  ,2023-02-14,2024-01-19,8.33,3902,2805,6707
1477,TSLA  ,2023-02-14,2024-01-19,10.0,294,4647,4941
1478,TSLA  ,2023-02-14,2024-01-19,11.67,253,3215,3468
1479,TSLA  ,2023-02-14,2024-01-19,13.33,819,507,1326
1480,TSLA  ,2023-02-14,2024-01-19,15.0,279,2066,2345
1481,TSLA  ,2023-02-14,2024-01-19,16.67,486,4566,5052
1482,TSLA  ,2023-02-14,2024-01-19,18.33,393,6127,6520
1483,TSLA  ,2023-02-14,2024-01-19,20.0,258,7593,7851
1484,TSLA  ,2023-02-14,2024-01-19,21.67,118,843,961
1485,TSLA  ,2023-02-14,2024-01-19,23.33,382,3840,4222
1486,TSLA  ,2023-02-14,2024-01-19,25.0,369,2811,3180
1487,TSLA  ,2023-02-14,2024-01-19,26.67,833,1194,2027
1488,TSLA  ,2023-02-14,2024-01-19,28.33,341,846,1187
1489,TSLA  ,2023-02-14,2024-01-19,30.0,228,8927,9155
1490,TSLA  ,2023-02-14,2024-01-19,31.67,1327,1353,2680
1491,TSLA  ,2023-02-14,2024-01-19,33.33,4315,32828,37143
1492,TSLA  ,2023-02-14,2024-01-19,50.0,2164,30825,32989
1493,TSLA  ,2023-02-14,2024-01-19,55.0,80,1313,1393
1494,TSLA  ,2023-02-14,2024-01-19,60.0,249,2609,2858
1495,TSLA  ,2023-02-14,2024-01-19,65.0,266,771,1037
1496,TSLA  ,2023-02-14,2024-01-19,66.67,4704,14821,19525
1497,TSLA  ,2023-02-14,2024-01-19,70.0,143,851,994
1498,TSLA  ,2023-02-14,2024-01-19,75.0,92,1177,1269
1499,TSLA  ,2023-02-14,2024-01-19,80.0,413,1935,2348
1500,TSLA  ,2023-02-14,2024-01-19,83.33,1066,8012,9078
1501,TSLA  ,2023-02-14,2024-01-19,85.0,511,409,920
1502,TSLA  ,2023-02-14,2024-01-19,90.0,3539,1316,4855
1503,TSLA  ,2023-02-14,2024-01-19,95.0,2924,1441,4365
1504,TSLA  ,2023-02-14,2024-01-19,100.0,13914,39959,53873
1505,TSLA  ,2023-02-14,2024-01-19,105.0,1290,2090,3380
1506,TSLA  ,2023-02-14,2024-01-19,110.0,4973,7052,12025
1507,TSLA  ,2023-02-14,2024-01-19,115.0,4695,5606,10301
1508,TSLA  ,2023-02-14,2024-01-19,116.67,1933,8369,10302
1509,TSLA  ,2023-02-14,2024-01-19,120.0,3438,6184,9622
1510,TSLA  ,2023-02-14,2024-01-19,123.33,1962,2313,4275
1511,TSLA  ,2023-02-14,2024-01-19,125.0,2444,13243,15687
1512,TSLA  ,2023-02-14,2024-01-19,126.67,1744,6599,8343
1513,TSLA  ,2023-02-14,2024-01-19,130.0,5083,11794,16877
1514,TSLA  ,2023-02-14,2024-01-19,133.33,2430,11059,13489
1515,TSLA  ,2023-02-14,2024-01-19,135.0,1329,1290,2619
1516,TSLA  ,2023-02-14,2024-01-19,136.67,2432,2311,4743
1517,TSLA  ,2023-02-14,2024-01-19,140.0,5114,4330,9444
1518,TSLA  ,2023-02-14,2024-01-19,143.33,1673,2274,3947
1519,TSLA  ,2023-02-14,2024-01-19,145.0,788,834,1622
1520,TSLA  ,2023-02-14,2024-01-19,146.67,1043,970,2013
1521,TSLA  ,2023-02-14,2024-01-19,150.0,17753,22385,40138
1522,TSLA  ,2023-02-14,2024-01-19,153.33,10511,1066,11577
1523,TSLA  ,2023-02-14,2024-01-19,155.0,534,1420,1954
1524,TSLA  ,2023-02-14,2024-01-19,156.67,1696,851,2547
1525,TSLA  ,2023-02-14,2024-01-19,160.0,3555,12302,15857
1526,TSLA  ,2023-02-14,2024-01-19,163.33,475,7408,7883
1527,TSLA  ,2023-02-14,2024-01-19,165.0,695,555,1250
1528,TSLA  ,2023-02-14,2024-01-19,166.67,6755,6918,13673
1529,TSLA  ,2023-02-14,2024-01-19,170.0,2798,6265,9063
1530,TSLA  ,2023-02-14,2024-01-19,173.33,855,2568,3423
1531,TSLA  ,2023-02-14,2024-01-19,175.0,1719,2680,4399
1532,TSLA  ,2023-02-14,2024-01-19,176.67,1020,1268,2288
1533,TSLA  ,2023-02-14,2024-01-19,180.0,39067,11096,50163
1534,TSLA  ,2023-02-14,2024-01-19,183.33,34454,7428,41882
1535,TSLA  ,2023-02-14,2024-01-19,185.0,1336,752,2088
1536,TSLA  ,2023-02-14,2024-01-19,186.67,1267,2282,3549
1537,TSLA  ,2023-02-14,2024-01-19,190.0,1686,701,2387
1538,TSLA  ,2023-02-14,2024-01-19,193.33,2288,9826,12114
1539,TSLA  ,2023-02-14,2024-01-19,195.0,432,1731,2163
1540,TSLA  ,2023-02-14,2024-01-19,200.0,33106,24211,57317
1541,TSLA  ,2023-02-14,2024-01-19,203.33,6287,2359,8646
1542,TSLA  ,2023-02-14,2024-01-19,206.67,1652,1255,2907
1543,TSLA  ,2023-02-14,2024-01-19,210.0,10865,6477,17342
1544,TSLA  ,2023-02-14,2024-01-19,213.33,1562,2692,4254
1545,TSLA  ,2023-02-14,2024-01-19,216.67,8869,6556,15425
1546,TSLA  ,2023-02-14,2024-01-19,220.0,6350,7090,13440
1547,TSLA  ,2023-02-14,2024-01-19,223.33,5831,1429,7260
1548,TSLA  ,2023-02-14,2024-01-19,226.67,19998,2944,22942
1549,TSLA  ,2023-02-14,2024-01-19,230.0,14463,19022,33485
1550,TSLA  ,2023-02-14,2024-01-19,233.33,37140,13972,51112
1551,TSLA  ,2023-02-14,2024-01-19,236.67,2002,1676,3678
1552,TSLA  ,2023-02-14,2024-01-19,240.0,4510,3864,8374
1553,TSLA  ,2023-02-14,2024-01-19,243.33,1265,2000,3265
1554,TSLA  ,2023-02-14,2024-01-19,246.67,1161,2111,3272
1555,TSLA  ,2023-02-14,2024-01-19,250.0,23178,5315,28493
1556,TSLA  ,2023-02-14,2024-01-19,253.33,2853,2096,4949
1557,TSLA  ,2023-02-14,2024-01-19,256.67,2825,1640,4465
1558,TSLA  ,2023-02-14,2024-01-19,260.0,7528,3157,10685
1559,TSLA  ,2023-02-14,2024-01-19,263.33,7757,2146,9903
1560,TSLA  ,2023-02-14,2024-01-19,266.67,10282,8817,19099
1561,TSLA  ,2023-02-14,2024-01-19,270.0,4547,5198,9745
1562,TSLA  ,2023-02-14,2024-01-19,273.33,3244,3091,6335
1563,TSLA  ,2023-02-14,2024-01-19,276.67,1896,1762,3658
1564,TSLA  ,2023-02-14,2024-01-19,280.0,9292,6499,15791
1565,TSLA  ,2023-02-14,2024-01-19,283.33,3132,3089,6221
1566,TSLA  ,2023-02-14,2024-01-19,286.67,2484,1507,3991
1567,TSLA  ,2023-02-14,2024-01-19,290.0,9305,557,9862
1568,TSLA  ,2023-02-14,2024-01-19,293.33,2893,1990,4883
1569,TSLA  ,2023-02-14,2024-01-19,296.67,2129,1688,3817
1570,TSLA  ,2023-02-14,2024-01-19,300.0,26289,6302,32591
1571,TSLA  ,2023-02-14,2024-01-19,303.33,3422,277,3699
1572,TSLA  ,2023-02-14,2024-01-19,306.67,6579,132,6711
1573,TSLA  ,2023-02-14,2024-01-19,310.0,3728,1012,4740
1574,TSLA  ,2023-02-14,2024-01-19,313.33,1209,22,1231
1575,TSLA  ,2023-02-14,2024-01-19,316.67,4124,306,4430
1576,TSLA  ,2023-02-14,2024-01-19,320.0,6208,318,6526
1577,TSLA  ,2023-02-14,2024-01-19,323.33,454,267,721
1578,TSLA  ,2023-02-14,2024-01-19,325.0,10256,129,10385
1579,TSLA  ,2023-02-14,2024-01-19,326.67,1371,633,2004
1580,TSLA  ,2023-02-14,2024-01-19,330.0,7028,11,7039
1581,TSLA  ,2023-02-14,2024-01-19,333.33,30262,2055,32317
1582,TSLA  ,2023-02-14,2024-01-19,336.67,1463,7,1470
1583,TSLA  ,2023-02-14,2024-01-19,340.0,3829,5,3834
1584,TSLA  ,2023-02-14,2024-01-19,341.67,906,10,916
1585,TSLA  ,2023-02-14,2024-01-19,343.33,532,0,532
1586,TSLA  ,2023-02-14,2024-01-19,346.67,2383,3,2386
1587,TSLA  ,2023-02-14,2024-01-19,350.0,15578,668,16246
1588,TSLA  ,2023-02-14,2024-01-19,353.33,1160,0,1160
1589,TSLA  ,2023-02-14,2024-01-19,356.67,889,0,889
1590,TSLA  ,2023-02-14,2024-01-19,358.33,1243,3,1246
1591,TSLA  ,2023-02-14,2024-01-19,360.0,9288,600,9888
1592,TSLA  ,2023-02-14,2024-01-19,363.33,491,7,498
1593,TSLA  ,2023-02-14,2024-01-19,366.67,38791,2787,41578
1594,TSLA  ,2023-02-14,2024-01-19,370.0,6188,4,6192
1595,TSLA  ,2023-02-14,2024-01-19,373.33,1053,12,1065
1596,TSLA  ,2023-02-14,2024-01-19,375.0,11430,8,11438
1597,TSLA  ,2023-02-14,2024-01-19,376.67,579,106,685
1598,TSLA  ,2023-02-14,2024-01-19,380.0,1023,2,1025
1599,TSLA  ,2023-02-14,2024-01-19,383.33,3100,2,3102
1600,TSLA  ,2023-02-14,2024-01-19,386.67,408,203,611
1601,TSLA  ,2023-02-14,2024-01-19,390.0,918,1,919
1602,TSLA  ,2023-02-14,2024-01-19,391.67,2318,1,2319
1603,TSLA  ,2023-02-14,2024-01-19,393.33,518,4,522
1604,TSLA  ,2023-02-14,2024-01-19,396.67,2713,0,2713
1605,TSLA  ,2023-02-14,2024-01-19,400.0,38397,980,39377
1606,TSLA  ,2023-02-14,2024-01-19,408.33,5104,1,5105
1607,TSLA  ,2023-02-14,2024-01-19,416.67,4032,2142,6174
1608,TSLA  ,2023-02-14,2024-01-19,425.0,4474,18,4492
1609,TSLA  ,2023-02-14,2024-01-19,433.33,5738,3,5741
1610,TSLA  ,2023-02-14,2024-01-19,441.67,1196,0,1196
1611,TSLA  ,2023-02-14,2024-01-19,450.0,8488,2427,10915
1612,TSLA  ,2023-02-14,2024-01-19,458.33,1993,0,1993
1613,TSLA  ,2023-02-14,2024-01-19,466.67,28827,0,28827
1614,TSLA  ,2023-02-14,2024-01-19,475.0,4826,190,5016
1615,TSLA  ,2023-02-14,2024-01-19,483.33,1574,20,1594
1616,TSLA  ,2023-02-14,2024-01-19,491.67,2143,0,2143
1617,TSLA  ,2023-02-14,2024-01-19,500.0,36885,0,36885
1618,TSLA  ,2023-02-14,2024-01-19,516.67,4806,0,4806
1619,TSLA  ,2023-02-14,2024-01-19,533.33,20788,0,20788
1620,TSLA  ,2023-02-14,2024-01-19,550.0,16398,0,16398
1621,TSLA  ,2023-02-14,2024-01-19,558.33,1181,0,1181
1622,TSLA  ,2023-02-14,2024-01-19,566.67,11404,0,11404
1623,TSLA  ,2023-02-14,2024-01-19,575.0,13906,0,13906
1624,TSLA  ,2023-02-14,2024-01-19,583.33,13812,0,13812
1625,TSLA  ,2023-02-14,2024-01-19,591.67,2277,0,2277
1626,TSLA  ,2023-02-14,2024-01-19,600.0,18691,0,18691
1627,TSLA  ,2023-02-14,2024-01-19,608.33,2279,0,2279
1628,TSLA  ,2023-02-14,2024-01-19,616.67,11853,0,11853
1629,TSLA  ,2023-02-14,2024-01-19,625.0,2423,0,2423
1630,TSLA  ,2023-02-14,2024-01-19,633.33,5751,0,5751
1631,TSLA  ,2023-02-14,2024-01-19,641.67,930,0,930
1632,TSLA  ,2023-02-14,2024-01-19,650.0,3197,0,3197
1633,TSLA  ,2023-02-14,2024-01-19,666.67,40764,0,40764
1634,TSLA  ,2023-02-14,2024-01-19,675.0,4357,0,4357
1635,TSLA  ,2023-02-14,2024-01-19,683.33,7132,0,7132
1636,TSLA  ,2023-02-14,2024-01-19,691.67,1564,0,1564
1637,TSLA  ,2023-02-14,2024-01-19,700.0,5363,0,5363
1638,TSLA  ,2023-02-14,2024-01-19,708.33,761,0,761
1639,TSLA  ,2023-02-14,2024-01-19,716.67,6059,0,6059
1640,TSLA  ,2023-02-14,2024-01-19,725.0,2693,3,2696
1641,TSLA  ,2023-02-14,2024-01-19,733.33,3399,0,3399
1642,TSLA  ,2023-02-14,2024-01-19,741.67,806,0,806
1643,TSLA  ,2023-02-14,2024-01-19,750.0,2348,0,2348
1644,TSLA  ,2023-02-14,2024-01-19,758.33,939,0,939
1645,TSLA  ,2023-02-14,2024-01-19,766.67,2124,0,2124
1646,TSLA  ,2023-02-14,2024-01-19,775.0,2797,0,2797
1647,TSLA  ,2023-02-14,2024-01-19,783.33,692,0,692
1648,TSLA  ,2023-02-14,2024-01-19,791.67,3182,0,3182
1649,TSLA  ,2023-02-14,2024-01-19,800.0,13724,0,13724
1650,TSLA  ,2023-02-14,2024-01-19,808.33,3928,0,3928
1651,TSLA  ,2023-02-14,2024-01-19,816.67,5805,0,5805
1652,TSLA  ,2023-02-14,2024-01-19,825.0,73933,0,73933
1653,TSLA  ,2023-02-14,2024-03-15,1.67,108,1894,2002
1654,TSLA  ,2023-02-14,2024-03-15,3.33,22,769,791
1655,TSLA  ,2023-02-14,2024-03-15,5.0,64,894,958
1656,TSLA  ,2023-02-14,2024-03-15,6.67,6,93,99
1657,TSLA  ,2023-02-14,2024-03-15,8.33,16,42,58
1658,TSLA  ,2023-02-14,2024-03-15,10.0,6,310,316
1659,TSLA  ,2023-02-14,2024-03-15,11.67,11,409,420
1660,TSLA  ,2023-02-14,2024-03-15,13.33,18,45,63
1661,TSLA  ,2023-02-14,2024-03-15,15.0,24,152,176
1662,TSLA  ,2023-02-14,2024-03-15,16.67,124,230,354
1663,TSLA  ,2023-02-14,2024-03-15,33.33,809,1999,2808
1664,TSLA  ,2023-02-14,2024-03-15,50.0,449,5612,6061
1665,TSLA  ,2023-02-14,2024-03-15,55.0,30,300,330
1666,TSLA  ,2023-02-14,2024-03-15,60.0,45,850,895
1667,TSLA  ,2023-02-14,2024-03-15,65.0,31,828,859
1668,TSLA  ,2023-02-14,2024-03-15,66.67,2035,1007,3042
1669,TSLA  ,2023-02-14,2024-03-15,70.0,50,238,288
1670,TSLA  ,2023-02-14,2024-03-15,75.0,20,399,419
1671,TSLA  ,2023-02-14,2024-03-15,80.0,191,556,747
1672,TSLA  ,2023-02-14,2024-03-15,83.33,999,4508,5507
1673,TSLA  ,2023-02-14,2024-03-15,85.0,291,213,504
1674,TSLA  ,2023-02-14,2024-03-15,90.0,742,763,1505
1675,TSLA  ,2023-02-14,2024-03-15,95.0,1558,395,1953
1676,TSLA  ,2023-02-14,2024-03-15,100.0,3353,3075,6428
1677,TSLA  ,2023-02-14,2024-03-15,105.0,818,722,1540
1678,TSLA  ,2023-02-14,2024-03-15,110.0,912,2513,3425
1679,TSLA  ,2023-02-14,2024-03-15,115.0,2044,196,2240
1680,TSLA  ,2023-02-14,2024-03-15,116.67,609,953,1562
1681,TSLA  ,2023-02-14,2024-03-15,120.0,327,602,929
1682,TSLA  ,2023-02-14,2024-03-15,125.0,792,737,1529
1683,TSLA  ,2023-02-14,2024-03-15,130.0,1546,497,2043
1684,TSLA  ,2023-02-14,2024-03-15,133.33,590,5692,6282
1685,TSLA  ,2023-02-14,2024-03-15,135.0,212,231,443
1686,TSLA  ,2023-02-14,2024-03-15,140.0,208,270,478
1687,TSLA  ,2023-02-14,2024-03-15,141.67,560,325,885
1688,TSLA  ,2023-02-14,2024-03-15,145.0,296,383,679
1689,TSLA  ,2023-02-14,2024-03-15,150.0,1304,4411,5715
1690,TSLA  ,2023-02-14,2024-03-15,155.0,83,206,289
1691,TSLA  ,2023-02-14,2024-03-15,158.33,172,583,755
1692,TSLA  ,2023-02-14,2024-03-15,160.0,236,4380,4616
1693,TSLA  ,2023-02-14,2024-03-15,165.0,151,3903,4054
1694,TSLA  ,2023-02-14,2024-03-15,166.67,581,1181,1762
1695,TSLA  ,2023-02-14,2024-03-15,170.0,284,8894,9178
1696,TSLA  ,2023-02-14,2024-03-15,175.0,720,1942,2662
1697,TSLA  ,2023-02-14,2024-03-15,180.0,299,642,941
1698,TSLA  ,2023-02-14,2024-03-15,183.33,519,1146,1665
1699,TSLA  ,2023-02-14,2024-03-15,185.0,251,151,402
1700,TSLA  ,2023-02-14,2024-03-15,190.0,222,272,494
1701,TSLA  ,2023-02-14,2024-03-15,191.67,709,1383,2092
1702,TSLA  ,2023-02-14,2024-03-15,195.0,576,139,715
1703,TSLA  ,2023-02-14,2024-03-15,200.0,5167,4686,9853
1704,TSLA  ,2023-02-14,2024-03-15,208.33,1168,728,1896
1705,TSLA  ,2023-02-14,2024-03-15,210.0,420,160,580
1706,TSLA  ,2023-02-14,2024-03-15,216.67,1495,838,2333
1707,TSLA  ,2023-02-14,2024-03-15,220.0,553,54,607
1708,TSLA  ,2023-02-14,2024-03-15,225.0,1440,2419,3859
1709,TSLA  ,2023-02-14,2024-03-15,230.0,235,54,289
1710,TSLA  ,2023-02-14,2024-03-15,233.33,1619,996,2615
1711,TSLA  ,2023-02-14,2024-03-15,240.0,156,50,206
1712,TSLA  ,2023-02-14,2024-03-15,241.67,1125,955,2080
1713,TSLA  ,2023-02-14,2024-03-15,250.0,2181,1447,3628
1714,TSLA  ,2023-02-14,2024-03-15,258.33,4133,1036,5169
1715,TSLA  ,2023-02-14,2024-03-15,260.0,849,96,945
1716,TSLA  ,2023-02-14,2024-03-15,266.67,4461,810,5271
1717,TSLA  ,2023-02-14,2024-03-15,270.0,305,3,308
1718,TSLA  ,2023-02-14,2024-03-15,275.0,8961,1011,9972
1719,TSLA  ,2023-02-14,2024-03-15,280.0,112,56,168
1720,TSLA  ,2023-02-14,2024-03-15,283.33,1166,710,1876
1721,TSLA  ,2023-02-14,2024-03-15,290.0,13,2,15
1722,TSLA  ,2023-02-14,2024-03-15,291.67,1289,129,1418
1723,TSLA  ,2023-02-14,2024-03-15,300.0,4870,655,5525
1724,TSLA  ,2023-02-14,2024-03-15,308.33,405,41,446
1725,TSLA  ,2023-02-14,2024-03-15,310.0,4,0,4
1726,TSLA  ,2023-02-14,2024-03-15,316.67,936,389,1325
1727,TSLA  ,2023-02-14,2024-03-15,325.0,1508,16,1524
1728,TSLA  ,2023-02-14,2024-03-15,333.33,1019,24,1043
1729,TSLA  ,2023-02-14,2024-03-15,341.67,286,24,310
1730,TSLA  ,2023-02-14,2024-03-15,350.0,889,82,971
1731,TSLA  ,2023-02-14,2024-03-15,358.33,444,68,512
1732,TSLA  ,2023-02-14,2024-03-15,366.67,536,250,786
1733,TSLA  ,2023-02-14,2024-03-15,375.0,659,2,661
1734,TSLA  ,2023-02-14,2024-03-15,383.33,194,1337,1531
1735,TSLA  ,2023-02-14,2024-03-15,391.67,319,8,327
1736,TSLA  ,2023-02-14,2024-03-15,400.0,1189,221,1410
1737,TSLA  ,2023-02-14,2024-03-15,408.33,609,53,662
1738,TSLA  ,2023-02-14,2024-03-15,416.67,368,366,734
1739,TSLA  ,2023-02-14,2024-03-15,425.0,890,8,898
1740,TSLA  ,2023-02-14,2024-03-15,433.33,574,0,574
1741,TSLA  ,2023-02-14,2024-03-15,441.67,170,0,170
1742,TSLA  ,2023-02-14,2024-03-15,450.0,1468,0,1468
1743,TSLA  ,2023-02-14,2024-03-15,458.33,243,0,243
1744,TSLA  ,2023-02-14,2024-03-15,466.67,822,0,822
1745,TSLA  ,2023-02-14,2024-03-15,475.0,431,0,431
1746,TSLA  ,2023-02-14,2024-03-15,483.33,488,0,488
1747,TSLA  ,2023-02-14,2024-03-15,491.67,319,0,319
1748,TSLA  ,2023-02-14,2024-03-15,500.0,2884,0,2884
1749,TSLA  ,2023-02-14,2024-03-15,508.33,227,0,227
1750,TSLA  ,2023-02-14,2024-03-15,516.67,692,0,692
1751,TSLA  ,2023-02-14,2024-03-15,525.0,119,0,119
1752,TSLA  ,2023-02-14,2024-03-15,533.33,221,0,221
1753,TSLA  ,2023-02-14,2024-03-15,541.67,165,0,165
1754,TSLA  ,2023-02-14,2024-03-15,550.0,508,0,508
1755,TSLA  ,2023-02-14,2024-03-15,558.33,264,0,264
1756,TSLA  ,2023-02-14,2024-03-15,566.67,386,0,386
1757,TSLA  ,2023-02-14,2024-03-15,575.0,666,0,666
1758,TSLA  ,2023-02-14,2024-03-15,583.33,476,0,476
1759,TSLA  ,2023-02-14,2024-03-15,600.0,3821,1,3822
1760,TSLA  ,2023-02-14,2024-06-21,1.67,630,16473,17103
1761,TSLA  ,2023-02-14,2024-06-21,3.33,149,3277,3426
1762,TSLA  ,2023-02-14,2024-06-21,5.0,20,1509,1529
1763,TSLA  ,2023-02-14,2024-06-21,6.67,219,1218,1437
1764,TSLA  ,2023-02-14,2024-06-21,8.33,121,368,489
1765,TSLA  ,2023-02-14,2024-06-21,10.0,275,1827,2102
1766,TSLA  ,2023-02-14,2024-06-21,11.67,540,334,874
1767,TSLA  ,2023-02-14,2024-06-21,13.33,39,219,258
1768,TSLA  ,2023-02-14,2024-06-21,16.67,1407,3528,4935
1769,TSLA  ,2023-02-14,2024-06-21,33.33,7802,5379,13181
1770,TSLA  ,2023-02-14,2024-06-21,50.0,1916,3788,5704
1771,TSLA  ,2023-02-14,2024-06-21,55.0,6,383,389
1772,TSLA  ,2023-02-14,2024-06-21,60.0,57,491,548
1773,TSLA  ,2023-02-14,2024-06-21,65.0,111,2103,2214
1774,TSLA  ,2023-02-14,2024-06-21,66.67,1877,4359,6236
1775,TSLA  ,2023-02-14,2024-06-21,70.0,49,250,299
1776,TSLA  ,2023-02-14,2024-06-21,75.0,74,194,268
1777,TSLA  ,2023-02-14,2024-06-21,80.0,111,1423,1534
1778,TSLA  ,2023-02-14,2024-06-21,83.33,30601,4209,34810
1779,TSLA  ,2023-02-14,2024-06-21,85.0,60,861,921
1780,TSLA  ,2023-02-14,2024-06-21,90.0,532,1154,1686
1781,TSLA  ,2023-02-14,2024-06-21,95.0,363,423,786
1782,TSLA  ,2023-02-14,2024-06-21,100.0,5354,9724,15078
1783,TSLA  ,2023-02-14,2024-06-21,105.0,798,804,1602
1784,TSLA  ,2023-02-14,2024-06-21,110.0,497,2210,2707
1785,TSLA  ,2023-02-14,2024-06-21,115.0,414,252,666
1786,TSLA  ,2023-02-14,2024-06-21,116.67,2476,1020,3496
1787,TSLA  ,2023-02-14,2024-06-21,120.0,560,1193,1753
1788,TSLA  ,2023-02-14,2024-06-21,123.33,643,3526,4169
1789,TSLA  ,2023-02-14,2024-06-21,125.0,162,2239,2401
1790,TSLA  ,2023-02-14,2024-06-21,126.67,668,1272,1940
1791,TSLA  ,2023-02-14,2024-06-21,130.0,837,1780,2617
1792,TSLA  ,2023-02-14,2024-06-21,133.33,1923,2859,4782
1793,TSLA  ,2023-02-14,2024-06-21,135.0,64,363,427
1794,TSLA  ,2023-02-14,2024-06-21,136.67,426,1886,2312
1795,TSLA  ,2023-02-14,2024-06-21,140.0,1491,2590,4081
1796,TSLA  ,2023-02-14,2024-06-21,143.33,1404,1686,3090
1797,TSLA  ,2023-02-14,2024-06-21,145.0,598,212,810
1798,TSLA  ,2023-02-14,2024-06-21,146.67,1642,564,2206
1799,TSLA  ,2023-02-14,2024-06-21,150.0,4374,9863,14237
1800,TSLA  ,2023-02-14,2024-06-21,153.33,289,816,1105
1801,TSLA  ,2023-02-14,2024-06-21,155.0,86,437,523
1802,TSLA  ,2023-02-14,2024-06-21,156.67,383,227,610
1803,TSLA  ,2023-02-14,2024-06-21,160.0,880,2716,3596
1804,TSLA  ,2023-02-14,2024-06-21,163.33,185,1416,1601
1805,TSLA  ,2023-02-14,2024-06-21,165.0,345,893,1238
1806,TSLA  ,2023-02-14,2024-06-21,166.67,1732,5509,7241
1807,TSLA  ,2023-02-14,2024-06-21,170.0,314,840,1154
1808,TSLA  ,2023-02-14,2024-06-21,173.33,596,5872,6468
1809,TSLA  ,2023-02-14,2024-06-21,175.0,937,392,1329
1810,TSLA  ,2023-02-14,2024-06-21,180.0,1376,6668,8044
1811,TSLA  ,2023-02-14,2024-06-21,183.33,931,3704,4635
1812,TSLA  ,2023-02-14,2024-06-21,185.0,290,237,527
1813,TSLA  ,2023-02-14,2024-06-21,186.67,1322,1656,2978
1814,TSLA  ,2023-02-14,2024-06-21,190.0,343,117,460
1815,TSLA  ,2023-02-14,2024-06-21,193.33,1020,4299,5319
1816,TSLA  ,2023-02-14,2024-06-21,195.0,273,864,1137
1817,TSLA  ,2023-02-14,2024-06-21,200.0,4743,9877,14620
1818,TSLA  ,2023-02-14,2024-06-21,206.67,977,2901,3878
1819,TSLA  ,2023-02-14,2024-06-21,210.0,423,124,547
1820,TSLA  ,2023-02-14,2024-06-21,213.33,813,1202,2015
1821,TSLA  ,2023-02-14,2024-06-21,216.67,1546,5371,6917
1822,TSLA  ,2023-02-14,2024-06-21,220.0,2247,2386,4633
1823,TSLA  ,2023-02-14,2024-06-21,226.67,2594,3464,6058
1824,TSLA  ,2023-02-14,2024-06-21,230.0,493,103,596
1825,TSLA  ,2023-02-14,2024-06-21,233.33,6664,7192,13856
1826,TSLA  ,2023-02-14,2024-06-21,240.0,2114,4866,6980
1827,TSLA  ,2023-02-14,2024-06-21,246.67,2259,1235,3494
1828,TSLA  ,2023-02-14,2024-06-21,250.0,5441,3586,9027
1829,TSLA  ,2023-02-14,2024-06-21,253.33,1308,851,2159
1830,TSLA  ,2023-02-14,2024-06-21,260.0,2076,953,3029
1831,TSLA  ,2023-02-14,2024-06-21,266.67,10098,3339,13437
1832,TSLA  ,2023-02-14,2024-06-21,270.0,1448,1816,3264
1833,TSLA  ,2023-02-14,2024-06-21,273.33,1225,793,2018
1834,TSLA  ,2023-02-14,2024-06-21,276.67,1015,809,1824
1835,TSLA  ,2023-02-14,2024-06-21,280.0,1233,1601,2834
1836,TSLA  ,2023-02-14,2024-06-21,283.33,3608,1362,4970
1837,TSLA  ,2023-02-14,2024-06-21,286.67,978,768,1746
1838,TSLA  ,2023-02-14,2024-06-21,290.0,2299,1161,3460
1839,TSLA  ,2023-02-14,2024-06-21,293.33,1111,968,2079
1840,TSLA  ,2023-02-14,2024-06-21,296.67,1001,360,1361
1841,TSLA  ,2023-02-14,2024-06-21,300.0,9363,887,10250
1842,TSLA  ,2023-02-14,2024-06-21,303.33,1403,645,2048
1843,TSLA  ,2023-02-14,2024-06-21,306.67,1489,237,1726
1844,TSLA  ,2023-02-14,2024-06-21,310.0,1789,518,2307
1845,TSLA  ,2023-02-14,2024-06-21,313.33,1161,719,1880
1846,TSLA  ,2023-02-14,2024-06-21,316.67,2341,27,2368
1847,TSLA  ,2023-02-14,2024-06-21,320.0,691,691,1382
1848,TSLA  ,2023-02-14,2024-06-21,323.33,432,308,740
1849,TSLA  ,2023-02-14,2024-06-21,326.67,582,274,856
1850,TSLA  ,2023-02-14,2024-06-21,330.0,2700,123,2823
1851,TSLA  ,2023-02-14,2024-06-21,333.33,7547,1092,8639
1852,TSLA  ,2023-02-14,2024-06-21,336.67,2288,238,2526
1853,TSLA  ,2023-02-14,2024-06-21,340.0,774,30,804
1854,TSLA  ,2023-02-14,2024-06-21,343.33,1201,89,1290
1855,TSLA  ,2023-02-14,2024-06-21,346.67,400,45,445
1856,TSLA  ,2023-02-14,2024-06-21,350.0,3445,6,3451
1857,TSLA  ,2023-02-14,2024-06-21,353.33,199,69,268
1858,TSLA  ,2023-02-14,2024-06-21,356.67,493,0,493
1859,TSLA  ,2023-02-14,2024-06-21,360.0,2617,12,2629
1860,TSLA  ,2023-02-14,2024-06-21,363.33,357,0,357
1861,TSLA  ,2023-02-14,2024-06-21,366.67,4710,0,4710
1862,TSLA  ,2023-02-14,2024-06-21,370.0,3055,9,3064
1863,TSLA  ,2023-02-14,2024-06-21,373.33,540,0,540
1864,TSLA  ,2023-02-14,2024-06-21,376.67,816,0,816
1865,TSLA  ,2023-02-14,2024-06-21,380.0,1043,1,1044
1866,TSLA  ,2023-02-14,2024-06-21,383.33,1030,11,1041
1867,TSLA  ,2023-02-14,2024-06-21,386.67,299,5,304
1868,TSLA  ,2023-02-14,2024-06-21,390.0,444,2,446
1869,TSLA  ,2023-02-14,2024-06-21,393.33,889,2,891
1870,TSLA  ,2023-02-14,2024-06-21,396.67,720,1,721
1871,TSLA  ,2023-02-14,2024-06-21,400.0,38854,35,38889
1872,TSLA  ,2023-02-14,2024-06-21,416.67,3260,1,3261
1873,TSLA  ,2023-02-14,2024-06-21,433.33,3270,0,3270
1874,TSLA  ,2023-02-14,2024-06-21,450.0,3082,0,3082
1875,TSLA  ,2023-02-14,2024-06-21,466.67,5387,0,5387
1876,TSLA  ,2023-02-14,2024-06-21,483.33,1101,0,1101
1877,TSLA  ,2023-02-14,2024-06-21,500.0,10903,0,10903
1878,TSLA  ,2023-02-14,2024-06-21,516.67,2089,0,2089
1879,TSLA  ,2023-02-14,2024-06-21,533.33,3105,0,3105
1880,TSLA  ,2023-02-14,2024-06-21,550.0,2605,0,2605
1881,TSLA  ,2023-02-14,2024-06-21,566.67,1007,0,1007
1882,TSLA  ,2023-02-14,2024-06-21,583.33,1038,0,1038
1883,TSLA  ,2023-02-14,2024-06-21,600.0,17163,0,17163
1884,TSLA  ,2023-02-14,2024-06-21,616.67,14011,0,14011
1885,TSLA  ,2023-02-14,2024-06-21,633.33,4540,0,4540
1886,TSLA  ,2023-02-14,2024-06-21,650.0,612,0,612
1887,TSLA  ,2023-02-14,2024-06-21,666.67,6559,0,6559
1888,TSLA  ,2023-02-14,2024-06-21,683.33,1687,0,1687
1889,TSLA  ,2023-02-14,2024-06-21,700.0,3774,0,3774
1890,TSLA  ,2023-02-14,2024-06-21,716.67,888,0,888
1891,TSLA  ,2023-02-14,2024-06-21,733.33,2084,0,2084
1892,TSLA  ,2023-02-14,2024-06-21,750.0,6138,1,6139
1893,TSLA  ,2023-02-14,2024-06-21,758.33,14649,0,14649
1894,TSLA  ,2023-02-14,2024-09-20,50.0,44,919,963
1895,TSLA  ,2023-02-14,2024-09-20,55.0,29,54,83
1896,TSLA  ,2023-02-14,2024-09-20,60.0,10,155,165
1897,TSLA  ,2023-02-14,2024-09-20,65.0,32,69,101
1898,TSLA  ,2023-02-14,2024-09-20,70.0,11,136,147
1899,TSLA  ,2023-02-14,2024-09-20,75.0,10,2322,2332
1900,TSLA  ,2023-02-14,2024-09-20,80.0,63,140,203
1901,TSLA  ,2023-02-14,2024-09-20,85.0,987,454,1441
1902,TSLA  ,2023-02-14,2024-09-20,90.0,47,194,241
1903,TSLA  ,2023-02-14,2024-09-20,95.0,22,441,463
1904,TSLA  ,2023-02-14,2024-09-20,100.0,378,2217,2595
1905,TSLA  ,2023-02-14,2024-09-20,105.0,188,718,906
1906,TSLA  ,2023-02-14,2024-09-20,110.0,163,1095,1258
1907,TSLA  ,2023-02-14,2024-09-20,115.0,563,603,1166
1908,TSLA  ,2023-02-14,2024-09-20,120.0,719,550,1269
1909,TSLA  ,2023-02-14,2024-09-20,125.0,319,1200,1519
1910,TSLA  ,2023-02-14,2024-09-20,130.0,625,848,1473
1911,TSLA  ,2023-02-14,2024-09-20,135.0,598,271,869
1912,TSLA  ,2023-02-14,2024-09-20,140.0,1093,361,1454
1913,TSLA  ,2023-02-14,2024-09-20,145.0,1286,346,1632
1914,TSLA  ,2023-02-14,2024-09-20,150.0,1425,2727,4152
1915,TSLA  ,2023-02-14,2024-09-20,155.0,526,299,825
1916,TSLA  ,2023-02-14,2024-09-20,160.0,406,822,1228
1917,TSLA  ,2023-02-14,2024-09-20,165.0,258,109,367
1918,TSLA  ,2023-02-14,2024-09-20,170.0,187,280,467
1919,TSLA  ,2023-02-14,2024-09-20,175.0,210,126,336
1920,TSLA  ,2023-02-14,2024-09-20,180.0,741,84,825
1921,TSLA  ,2023-02-14,2024-09-20,185.0,832,916,1748
1922,TSLA  ,2023-02-14,2024-09-20,190.0,1491,94,1585
1923,TSLA  ,2023-02-14,2024-09-20,195.0,1412,118,1530
1924,TSLA  ,2023-02-14,2024-09-20,200.0,1774,1514,3288
1925,TSLA  ,2023-02-14,2024-09-20,210.0,771,267,1038
1926,TSLA  ,2023-02-14,2024-09-20,220.0,1457,426,1883
1927,TSLA  ,2023-02-14,2024-09-20,230.0,600,116,716
1928,TSLA  ,2023-02-14,2024-09-20,240.0,377,301,678
1929,TSLA  ,2023-02-14,2024-09-20,250.0,800,366,1166
1930,TSLA  ,2023-02-14,2024-09-20,260.0,900,70,970
1931,TSLA  ,2023-02-14,2024-09-20,270.0,522,534,1056
1932,TSLA  ,2023-02-14,2024-09-20,280.0,326,577,903
1933,TSLA  ,2023-02-14,2024-09-20,290.0,467,2810,3277
1934,TSLA  ,2023-02-14,2024-09-20,300.0,1027,1157,2184
1935,TSLA  ,2023-02-14,2024-09-20,310.0,177,786,963
1936,TSLA  ,2023-02-14,2024-09-20,320.0,111,257,368
1937,TSLA  ,2023-02-14,2024-09-20,330.0,101,117,218
1938,TSLA  ,2023-02-14,2024-09-20,340.0,706,110,816
1939,TSLA  ,2023-02-14,2024-09-20,350.0,1433,109,1542
1940,TSLA  ,2023-02-14,2024-09-20,360.0,52,63,115
1941,TSLA  ,2023-02-14,2024-09-20,370.0,75,3,78
1942,TSLA  ,2023-02-14,2024-09-20,380.0,70,2,72
1943,TSLA  ,2023-02-14,2024-09-20,390.0,200,16,216
1944,TSLA  ,2023-02-14,2025-01-17,5.0,660,11256,11916
1945,TSLA  ,2023-02-14,2025-01-17,10.0,139,841,980
1946,TSLA  ,2023-02-14,2025-01-17,15.0,29,861,890
1947,TSLA  ,2023-02-14,2025-01-17,20.0,385,5775,6160
1948,TSLA  ,2023-02-14,2025-01-17,25.0,103,2455,2558
1949,TSLA  ,2023-02-14,2025-01-17,30.0,13823,16562,30385
1950,TSLA  ,2023-02-14,2025-01-17,35.0,264,1107,1371
1951,TSLA  ,2023-02-14,2025-01-17,40.0,14712,15783,30495
1952,TSLA  ,2023-02-14,2025-01-17,45.0,2979,3196,6175
1953,TSLA  ,2023-02-14,2025-01-17,50.0,2740,8551,11291
1954,TSLA  ,2023-02-14,2025-01-17,55.0,2004,4217,6221
1955,TSLA  ,2023-02-14,2025-01-17,60.0,592,1947,2539
1956,TSLA  ,2023-02-14,2025-01-17,65.0,1652,1571,3223
1957,TSLA  ,2023-02-14,2025-01-17,70.0,2495,2198,4693
1958,TSLA  ,2023-02-14,2025-01-17,75.0,184,4372,4556
1959,TSLA  ,2023-02-14,2025-01-17,80.0,1308,1853,3161
1960,TSLA  ,2023-02-14,2025-01-17,85.0,1827,1609,3436
1961,TSLA  ,2023-02-14,2025-01-17,90.0,1121,5537,6658
1962,TSLA  ,2023-02-14,2025-01-17,95.0,137,495,632
1963,TSLA  ,2023-02-14,2025-01-17,100.0,5405,17612,23017
1964,TSLA  ,2023-02-14,2025-01-17,105.0,316,1674,1990
1965,TSLA  ,2023-02-14,2025-01-17,110.0,5443,7140,12583
1966,TSLA  ,2023-02-14,2025-01-17,115.0,3616,3632,7248
1967,TSLA  ,2023-02-14,2025-01-17,120.0,8376,6142,14518
1968,TSLA  ,2023-02-14,2025-01-17,125.0,2154,1164,3318
1969,TSLA  ,2023-02-14,2025-01-17,130.0,5640,7183,12823
1970,TSLA  ,2023-02-14,2025-01-17,135.0,5698,693,6391
1971,TSLA  ,2023-02-14,2025-01-17,140.0,8583,4612,13195
1972,TSLA  ,2023-02-14,2025-01-17,145.0,767,689,1456
1973,TSLA  ,2023-02-14,2025-01-17,150.0,11958,11842,23800
1974,TSLA  ,2023-02-14,2025-01-17,155.0,229,470,699
1975,TSLA  ,2023-02-14,2025-01-17,160.0,4596,5546,10142
1976,TSLA  ,2023-02-14,2025-01-17,165.0,250,859,1109
1977,TSLA  ,2023-02-14,2025-01-17,170.0,35404,9695,45099
1978,TSLA  ,2023-02-14,2025-01-17,175.0,33490,4517,38007
1979,TSLA  ,2023-02-14,2025-01-17,180.0,3985,8208,12193
1980,TSLA  ,2023-02-14,2025-01-17,185.0,7165,4500,11665
1981,TSLA  ,2023-02-14,2025-01-17,190.0,5689,4806,10495
1982,TSLA  ,2023-02-14,2025-01-17,195.0,3233,1730,4963
1983,TSLA  ,2023-02-14,2025-01-17,200.0,28902,12627,41529
1984,TSLA  ,2023-02-14,2025-01-17,210.0,5207,2613,7820
1985,TSLA  ,2023-02-14,2025-01-17,220.0,3124,4077,7201
1986,TSLA  ,2023-02-14,2025-01-17,230.0,4122,3263,7385
1987,TSLA  ,2023-02-14,2025-01-17,240.0,4661,4445,9106
1988,TSLA  ,2023-02-14,2025-01-17,250.0,12235,5041,17276
1989,TSLA  ,2023-02-14,2025-01-17,260.0,5638,1805,7443
1990,TSLA  ,2023-02-14,2025-01-17,270.0,3033,1293,4326
1991,TSLA  ,2023-02-14,2025-01-17,280.0,2247,3339,5586
1992,TSLA  ,2023-02-14,2025-01-17,290.0,3429,2807,6236
1993,TSLA  ,2023-02-14,2025-01-17,300.0,30484,3075,33559
1994,TSLA  ,2023-02-14,2025-01-17,310.0,4381,695,5076
1995,TSLA  ,2023-02-14,2025-01-17,320.0,2106,791,2897
1996,TSLA  ,2023-02-14,2025-01-17,330.0,2359,949,3308
1997,TSLA  ,2023-02-14,2025-01-17,340.0,1335,412,1747
1998,TSLA  ,2023-02-14,2025-01-17,350.0,7121,769,7890
1999,TSLA  ,2023-02-14,2025-01-17,360.0,1973,178,2151
2000,TSLA  ,2023-02-14,2025-01-17,370.0,1892,289,2181
2001,TSLA  ,2023-02-14,2025-01-17,380.0,1446,46,1492
2002,TSLA  ,2023-02-14,2025-01-17,390.0,1725,64,1789
2003,TSLA  ,2023-02-14,2025-01-17,400.0,19418,117,19535
2004,TSLA  ,2023-02-14,2025-01-17,410.0,4203,70,4273
2005,TSLA  ,2023-02-14,2025-01-17,420.0,2955,9,2964
2006,TSLA  ,2023-02-14,2025-01-17,430.0,576,2,578
2007,TSLA  ,2023-02-14,2025-01-17,440.0,647,9,656
2008,TSLA  ,2023-02-14,2025-01-17,450.0,3643,4,3647
2009,TSLA  ,2023-02-14,2025-01-17,460.0,1010,14,1024
2010,TSLA  ,2023-02-14,2025-01-17,470.0,1552,67,1619
2011,TSLA  ,2023-02-14,2025-01-17,480.0,1243,1,1244
2012,TSLA  ,2023-02-14,2025-01-17,490.0,705,0,705
2013,TSLA  ,2023-02-14,2025-01-17,500.0,10444,8,10452
2014,TSLA  ,2023-02-14,2025-01-17,510.0,952,1,953
2015,TSLA  ,2023-02-14,2025-01-17,520.0,8343,1,8344
2016,TSLA  ,2023-02-14,2025-01-17,530.0,643,0,643
2017,TSLA  ,2023-02-14,2025-01-17,540.0,614,0,614
2018,TSLA  ,2023-02-14,2025-01-17,550.0,3073,0,3073
2019,TSLA  ,2023-02-14,2025-01-17,560.0,620,0,620
2020,TSLA  ,2023-02-14,2025-01-17,570.0,670,0,670
2021,TSLA  ,2023-02-14,2025-01-17,580.0,877,0,877
2022,TSLA  ,2023-02-14,2025-01-17,590.0,756,0,756
2023,TSLA  ,2023-02-14,2025-01-17,600.0,15289,4,15293
2024,TSLA  ,2023-02-14,2025-01-17,610.0,17703,0,17703
2025,TSLA  ,2023-02-14,2025-06-20,5.0,227,935,1162
2026,TSLA  ,2023-02-14,2025-06-20,10.0,3,85,88
2027,TSLA  ,2023-02-14,2025-06-20,15.0,7,5847,5854
2028,TSLA  ,2023-02-14,2025-06-20,20.0,50,417,467
2029,TSLA  ,2023-02-14,2025-06-20,25.0,9,134,143
2030,TSLA  ,2023-02-14,2025-06-20,30.0,83,240,323
2031,TSLA  ,2023-02-14,2025-06-20,35.0,11,178,189
2032,TSLA  ,2023-02-14,2025-06-20,40.0,9,280,289
2033,TSLA  ,2023-02-14,2025-06-20,45.0,17,52,69
2034,TSLA  ,2023-02-14,2025-06-20,50.0,157,745,902
2035,TSLA  ,2023-02-14,2025-06-20,55.0,13,54,67
2036,TSLA  ,2023-02-14,2025-06-20,60.0,14,618,632
2037,TSLA  ,2023-02-14,2025-06-20,65.0,19,575,594
2038,TSLA  ,2023-02-14,2025-06-20,70.0,164,128,292
2039,TSLA  ,2023-02-14,2025-06-20,75.0,121,1285,1406
2040,TSLA  ,2023-02-14,2025-06-20,80.0,802,437,1239
2041,TSLA  ,2023-02-14,2025-06-20,85.0,351,243,594
2042,TSLA  ,2023-02-14,2025-06-20,90.0,10311,440,10751
2043,TSLA  ,2023-02-14,2025-06-20,95.0,46427,541,46968
2044,TSLA  ,2023-02-14,2025-06-20,100.0,961,5399,6360
2045,TSLA  ,2023-02-14,2025-06-20,105.0,157,438,595
2046,TSLA  ,2023-02-14,2025-06-20,110.0,353,1610,1963
2047,TSLA  ,2023-02-14,2025-06-20,115.0,433,278,711
2048,TSLA  ,2023-02-14,2025-06-20,120.0,492,975,1467
2049,TSLA  ,2023-02-14,2025-06-20,125.0,507,362,869
2050,TSLA  ,2023-02-14,2025-06-20,130.0,2601,1293,3894
2051,TSLA  ,2023-02-14,2025-06-20,135.0,4714,166,4880
2052,TSLA  ,2023-02-14,2025-06-20,140.0,985,2290,3275
2053,TSLA  ,2023-02-14,2025-06-20,145.0,396,482,878
2054,TSLA  ,2023-02-14,2025-06-20,150.0,1378,1307,2685
2055,TSLA  ,2023-02-14,2025-06-20,155.0,401,120,521
2056,TSLA  ,2023-02-14,2025-06-20,160.0,2167,1160,3327
2057,TSLA  ,2023-02-14,2025-06-20,165.0,934,330,1264
2058,TSLA  ,2023-02-14,2025-06-20,170.0,2830,1435,4265
2059,TSLA  ,2023-02-14,2025-06-20,175.0,734,1190,1924
2060,TSLA  ,2023-02-14,2025-06-20,180.0,624,1108,1732
2061,TSLA  ,2023-02-14,2025-06-20,185.0,2461,193,2654
2062,TSLA  ,2023-02-14,2025-06-20,190.0,530,239,769
2063,TSLA  ,2023-02-14,2025-06-20,195.0,324,369,693
2064,TSLA  ,2023-02-14,2025-06-20,200.0,4079,3237,7316
2065,TSLA  ,2023-02-14,2025-06-20,205.0,225,218,443
2066,TSLA  ,2023-02-14,2025-06-20,210.0,399,116,515
2067,TSLA  ,2023-02-14,2025-06-20,215.0,134,37,171
2068,TSLA  ,2023-02-14,2025-06-20,220.0,667,88,755
2069,TSLA  ,2023-02-14,2025-06-20,225.0,484,192,676
2070,TSLA  ,2023-02-14,2025-06-20,230.0,526,80,606
2071,TSLA  ,2023-02-14,2025-06-20,235.0,327,253,580
2072,TSLA  ,2023-02-14,2025-06-20,240.0,4146,327,4473
2073,TSLA  ,2023-02-14,2025-06-20,250.0,1367,511,1878
2074,TSLA  ,2023-02-14,2025-06-20,260.0,437,993,1430
2075,TSLA  ,2023-02-14,2025-06-20,270.0,510,100,610
2076,TSLA  ,2023-02-14,2025-06-20,280.0,226,234,460
2077,TSLA  ,2023-02-14,2025-06-20,290.0,229,388,617
2078,TSLA  ,2023-02-14,2025-06-20,300.0,2646,612,3258
2079,TSLA  ,2023-02-14,2025-06-20,310.0,219,179,398
2080,TSLA  ,2023-02-14,2025-06-20,320.0,822,298,1120
2081,TSLA  ,2023-02-14,2025-06-20,330.0,200,186,386
2082,TSLA  ,2023-02-14,2025-06-20,340.0,451,346,797
2083,TSLA  ,2023-02-14,2025-06-20,350.0,2414,211,2625
2084,TSLA  ,2023-02-14,2025-06-20,360.0,644,197,841
2085,TSLA  ,2023-02-14,2025-06-20,370.0,70,153,223
2086,TSLA  ,2023-02-14,2025-06-20,380.0,76,12,88
2087,TSLA  ,2023-02-14,2025-06-20,390.0,1888,66,1954
