index,ProductSymbol,DateGen,ExpDate,Strike,Call,Put,TotalOI
0,TSLA  ,2023-02-10,2023-02-10,15.0,168,187,355
1,TSLA  ,2023-02-10,2023-02-10,20.0,19,1,20
2,TSLA  ,2023-02-10,2023-02-10,25.0,27,250,277
3,TSLA  ,2023-02-10,2023-02-10,30.0,6,1498,1504
4,TSLA  ,2023-02-10,2023-02-10,35.0,2,1462,1464
5,TSLA  ,2023-02-10,2023-02-10,40.0,2,934,936
6,TSLA  ,2023-02-10,2023-02-10,45.0,1,1869,1870
7,TSLA  ,2023-02-10,2023-02-10,50.0,7,2204,2211
8,TSLA  ,2023-02-10,2023-02-10,55.0,3,1158,1161
9,TSLA  ,2023-02-10,2023-02-10,60.0,10,2416,2426
10,TSLA  ,2023-02-10,2023-02-10,65.0,5,1705,1710
11,TSLA  ,2023-02-10,2023-02-10,70.0,14,1611,1625
12,TSLA  ,2023-02-10,2023-02-10,75.0,6,647,653
13,TSLA  ,2023-02-10,2023-02-10,80.0,69,1921,1990
14,TSLA  ,2023-02-10,2023-02-10,85.0,24,1021,1045
15,TSLA  ,2023-02-10,2023-02-10,90.0,59,1792,1851
16,TSLA  ,2023-02-10,2023-02-10,95.0,37,1370,1407
17,TSLA  ,2023-02-10,2023-02-10,98.0,42,695,737
18,TSLA  ,2023-02-10,2023-02-10,99.0,36,1226,1262
19,TSLA  ,2023-02-10,2023-02-10,100.0,162,3114,3276
20,TSLA  ,2023-02-10,2023-02-10,101.0,101,1892,1993
21,TSLA  ,2023-02-10,2023-02-10,102.0,59,513,572
22,TSLA  ,2023-02-10,2023-02-10,103.0,72,997,1069
23,TSLA  ,2023-02-10,2023-02-10,104.0,70,864,934
24,TSLA  ,2023-02-10,2023-02-10,105.0,125,3320,3445
25,TSLA  ,2023-02-10,2023-02-10,106.0,29,1778,1807
26,TSLA  ,2023-02-10,2023-02-10,107.0,52,1827,1879
27,TSLA  ,2023-02-10,2023-02-10,108.0,66,1530,1596
28,TSLA  ,2023-02-10,2023-02-10,109.0,102,1117,1219
29,TSLA  ,2023-02-10,2023-02-10,110.0,547,2352,2899
30,TSLA  ,2023-02-10,2023-02-10,111.0,101,383,484
31,TSLA  ,2023-02-10,2023-02-10,112.0,54,2474,2528
32,TSLA  ,2023-02-10,2023-02-10,113.0,167,1096,1263
33,TSLA  ,2023-02-10,2023-02-10,114.0,140,6026,6166
34,TSLA  ,2023-02-10,2023-02-10,115.0,233,2597,2830
35,TSLA  ,2023-02-10,2023-02-10,116.0,96,1084,1180
36,TSLA  ,2023-02-10,2023-02-10,117.0,124,1608,1732
37,TSLA  ,2023-02-10,2023-02-10,118.0,155,2835,2990
38,TSLA  ,2023-02-10,2023-02-10,119.0,142,814,956
39,TSLA  ,2023-02-10,2023-02-10,120.0,684,4172,4856
40,TSLA  ,2023-02-10,2023-02-10,121.0,239,1777,2016
41,TSLA  ,2023-02-10,2023-02-10,122.0,575,1208,1783
42,TSLA  ,2023-02-10,2023-02-10,123.0,262,1629,1891
43,TSLA  ,2023-02-10,2023-02-10,124.0,312,1551,1863
44,TSLA  ,2023-02-10,2023-02-10,125.0,819,4559,5378
45,TSLA  ,2023-02-10,2023-02-10,126.0,231,1102,1333
46,TSLA  ,2023-02-10,2023-02-10,127.0,352,1856,2208
47,TSLA  ,2023-02-10,2023-02-10,128.0,1141,1349,2490
48,TSLA  ,2023-02-10,2023-02-10,129.0,583,3347,3930
49,TSLA  ,2023-02-10,2023-02-10,130.0,1384,6613,7997
50,TSLA  ,2023-02-10,2023-02-10,131.0,519,2336,2855
51,TSLA  ,2023-02-10,2023-02-10,132.0,643,1792,2435
52,TSLA  ,2023-02-10,2023-02-10,133.0,750,2160,2910
53,TSLA  ,2023-02-10,2023-02-10,134.0,315,4824,5139
54,TSLA  ,2023-02-10,2023-02-10,135.0,1475,6487,7962
55,TSLA  ,2023-02-10,2023-02-10,136.0,394,3035,3429
56,TSLA  ,2023-02-10,2023-02-10,137.0,496,2778,3274
57,TSLA  ,2023-02-10,2023-02-10,138.0,772,5638,6410
58,TSLA  ,2023-02-10,2023-02-10,139.0,901,6545,7446
59,TSLA  ,2023-02-10,2023-02-10,140.0,2549,17488,20037
60,TSLA  ,2023-02-10,2023-02-10,141.0,737,1676,2413
61,TSLA  ,2023-02-10,2023-02-10,142.0,1201,3916,5117
62,TSLA  ,2023-02-10,2023-02-10,143.0,561,573,1134
63,TSLA  ,2023-02-10,2023-02-10,144.0,293,1382,1675
64,TSLA  ,2023-02-10,2023-02-10,145.0,2023,12460,14483
65,TSLA  ,2023-02-10,2023-02-10,146.0,895,1843,2738
66,TSLA  ,2023-02-10,2023-02-10,147.0,965,2062,3027
67,TSLA  ,2023-02-10,2023-02-10,148.0,412,2609,3021
68,TSLA  ,2023-02-10,2023-02-10,149.0,321,1922,2243
69,TSLA  ,2023-02-10,2023-02-10,150.0,3511,11717,15228
70,TSLA  ,2023-02-10,2023-02-10,152.5,510,3594,4104
71,TSLA  ,2023-02-10,2023-02-10,155.0,5492,6244,11736
72,TSLA  ,2023-02-10,2023-02-10,157.5,1139,4313,5452
73,TSLA  ,2023-02-10,2023-02-10,160.0,3395,13434,16829
74,TSLA  ,2023-02-10,2023-02-10,162.5,990,4753,5743
75,TSLA  ,2023-02-10,2023-02-10,165.0,4559,13020,17579
76,TSLA  ,2023-02-10,2023-02-10,167.5,1225,4680,5905
77,TSLA  ,2023-02-10,2023-02-10,170.0,5494,12958,18452
78,TSLA  ,2023-02-10,2023-02-10,172.5,2311,5819,8130
79,TSLA  ,2023-02-10,2023-02-10,175.0,4863,11603,16466
80,TSLA  ,2023-02-10,2023-02-10,177.5,2218,4817,7035
81,TSLA  ,2023-02-10,2023-02-10,180.0,6542,16481,23023
82,TSLA  ,2023-02-10,2023-02-10,182.5,2226,7225,9451
83,TSLA  ,2023-02-10,2023-02-10,185.0,7049,16562,23611
84,TSLA  ,2023-02-10,2023-02-10,187.5,1980,7052,9032
85,TSLA  ,2023-02-10,2023-02-10,190.0,9722,23021,32743
86,TSLA  ,2023-02-10,2023-02-10,192.5,3191,8813,12004
87,TSLA  ,2023-02-10,2023-02-10,195.0,12298,36675,48973
88,TSLA  ,2023-02-10,2023-02-10,197.5,4759,8447,13206
89,TSLA  ,2023-02-10,2023-02-10,200.0,26855,56205,83060
90,TSLA  ,2023-02-10,2023-02-10,202.5,7619,7825,15444
91,TSLA  ,2023-02-10,2023-02-10,205.0,9976,12465,22441
92,TSLA  ,2023-02-10,2023-02-10,207.5,5297,5630,10927
93,TSLA  ,2023-02-10,2023-02-10,210.0,31515,10954,42469
94,TSLA  ,2023-02-10,2023-02-10,212.5,12876,3312,16188
95,TSLA  ,2023-02-10,2023-02-10,215.0,27101,2096,29197
96,TSLA  ,2023-02-10,2023-02-10,217.5,10845,1365,12210
97,TSLA  ,2023-02-10,2023-02-10,220.0,28166,2336,30502
98,TSLA  ,2023-02-10,2023-02-10,222.5,8598,326,8924
99,TSLA  ,2023-02-10,2023-02-10,225.0,13881,882,14763
100,TSLA  ,2023-02-10,2023-02-10,227.5,8011,206,8217
101,TSLA  ,2023-02-10,2023-02-10,230.0,22576,514,23090
102,TSLA  ,2023-02-10,2023-02-10,232.5,6770,112,6882
103,TSLA  ,2023-02-10,2023-02-10,235.0,12073,219,12292
104,TSLA  ,2023-02-10,2023-02-10,237.5,3398,107,3505
105,TSLA  ,2023-02-10,2023-02-10,240.0,11350,84,11434
106,TSLA  ,2023-02-10,2023-02-10,242.5,3396,1,3397
107,TSLA  ,2023-02-10,2023-02-10,245.0,7234,6,7240
108,TSLA  ,2023-02-10,2023-02-10,247.5,5763,0,5763
109,TSLA  ,2023-02-10,2023-02-10,250.0,12497,54,12551
110,TSLA  ,2023-02-10,2023-02-10,252.5,1889,6,1895
111,TSLA  ,2023-02-10,2023-02-10,255.0,6013,13,6026
112,TSLA  ,2023-02-10,2023-02-10,257.5,2420,1,2421
113,TSLA  ,2023-02-10,2023-02-10,260.0,8559,0,8559
114,TSLA  ,2023-02-10,2023-02-10,265.0,8172,11,8183
115,TSLA  ,2023-02-10,2023-02-10,270.0,10369,0,10369
116,TSLA  ,2023-02-10,2023-02-10,275.0,7327,0,7327
117,TSLA  ,2023-02-10,2023-02-10,280.0,7515,0,7515
118,TSLA  ,2023-02-10,2023-02-10,285.0,12157,0,12157
119,TSLA  ,2023-02-10,2023-02-10,290.0,9185,0,9185
120,TSLA  ,2023-02-10,2023-02-10,295.0,6167,0,6167
121,TSLA  ,2023-02-10,2023-02-10,300.0,4465,1,4466
122,TSLA  ,2023-02-10,2023-02-10,310.0,1716,0,1716
123,TSLA  ,2023-02-10,2023-02-10,320.0,1082,0,1082
124,TSLA  ,2023-02-10,2023-02-10,330.0,1251,0,1251
125,TSLA  ,2023-02-10,2023-02-10,340.0,1341,0,1341
126,TSLA  ,2023-02-10,2023-02-10,350.0,2090,13,2103
127,TSLA  ,2023-02-10,2023-02-10,360.0,3230,13,3243
128,TSLA  ,2023-02-10,2023-02-17,15.0,172,304,476
129,TSLA  ,2023-02-10,2023-02-17,20.0,35,41,76
130,TSLA  ,2023-02-10,2023-02-17,25.0,4,99,103
131,TSLA  ,2023-02-10,2023-02-17,30.0,71,2723,2794
132,TSLA  ,2023-02-10,2023-02-17,35.0,0,5413,5413
133,TSLA  ,2023-02-10,2023-02-17,40.0,163,10382,10545
134,TSLA  ,2023-02-10,2023-02-17,45.0,0,1739,1739
135,TSLA  ,2023-02-10,2023-02-17,50.0,856,17129,17985
136,TSLA  ,2023-02-10,2023-02-17,55.0,41,5311,5352
137,TSLA  ,2023-02-10,2023-02-17,60.0,320,9043,9363
138,TSLA  ,2023-02-10,2023-02-17,65.0,28,6535,6563
139,TSLA  ,2023-02-10,2023-02-17,70.0,74,53618,53692
140,TSLA  ,2023-02-10,2023-02-17,75.0,124,7655,7779
141,TSLA  ,2023-02-10,2023-02-17,80.0,189,50100,50289
142,TSLA  ,2023-02-10,2023-02-17,85.0,259,14034,14293
143,TSLA  ,2023-02-10,2023-02-17,90.0,283,16889,17172
144,TSLA  ,2023-02-10,2023-02-17,95.0,822,20346,21168
145,TSLA  ,2023-02-10,2023-02-17,100.0,3234,38586,41820
146,TSLA  ,2023-02-10,2023-02-17,105.0,20721,29283,50004
147,TSLA  ,2023-02-10,2023-02-17,110.0,3396,25649,29045
148,TSLA  ,2023-02-10,2023-02-17,115.0,15308,23875,39183
149,TSLA  ,2023-02-10,2023-02-17,118.0,288,1697,1985
150,TSLA  ,2023-02-10,2023-02-17,119.0,24,1407,1431
151,TSLA  ,2023-02-10,2023-02-17,120.0,26337,48304,74641
152,TSLA  ,2023-02-10,2023-02-17,121.0,31,1016,1047
153,TSLA  ,2023-02-10,2023-02-17,122.0,185,1331,1516
154,TSLA  ,2023-02-10,2023-02-17,123.0,127,1697,1824
155,TSLA  ,2023-02-10,2023-02-17,124.0,49,1082,1131
156,TSLA  ,2023-02-10,2023-02-17,125.0,12171,15980,28151
157,TSLA  ,2023-02-10,2023-02-17,126.0,46,1125,1171
158,TSLA  ,2023-02-10,2023-02-17,127.0,76,1212,1288
159,TSLA  ,2023-02-10,2023-02-17,128.0,49,2377,2426
160,TSLA  ,2023-02-10,2023-02-17,129.0,95,1624,1719
161,TSLA  ,2023-02-10,2023-02-17,130.0,13493,14560,28053
162,TSLA  ,2023-02-10,2023-02-17,131.0,154,1352,1506
163,TSLA  ,2023-02-10,2023-02-17,132.0,237,1343,1580
164,TSLA  ,2023-02-10,2023-02-17,133.0,73,1426,1499
165,TSLA  ,2023-02-10,2023-02-17,134.0,369,1674,2043
166,TSLA  ,2023-02-10,2023-02-17,135.0,7733,10736,18469
167,TSLA  ,2023-02-10,2023-02-17,136.0,1436,3404,4840
168,TSLA  ,2023-02-10,2023-02-17,137.0,869,1658,2527
169,TSLA  ,2023-02-10,2023-02-17,138.0,1189,1376,2565
170,TSLA  ,2023-02-10,2023-02-17,139.0,998,1045,2043
171,TSLA  ,2023-02-10,2023-02-17,140.0,7985,15820,23805
172,TSLA  ,2023-02-10,2023-02-17,141.0,329,1612,1941
173,TSLA  ,2023-02-10,2023-02-17,142.0,917,2257,3174
174,TSLA  ,2023-02-10,2023-02-17,143.0,273,1317,1590
175,TSLA  ,2023-02-10,2023-02-17,144.0,319,1040,1359
176,TSLA  ,2023-02-10,2023-02-17,145.0,12256,21451,33707
177,TSLA  ,2023-02-10,2023-02-17,146.0,1802,1572,3374
178,TSLA  ,2023-02-10,2023-02-17,147.0,538,4560,5098
179,TSLA  ,2023-02-10,2023-02-17,148.0,245,2386,2631
180,TSLA  ,2023-02-10,2023-02-17,149.0,452,1887,2339
181,TSLA  ,2023-02-10,2023-02-17,150.0,15148,27209,42357
182,TSLA  ,2023-02-10,2023-02-17,152.5,1058,2265,3323
183,TSLA  ,2023-02-10,2023-02-17,155.0,10142,9019,19161
184,TSLA  ,2023-02-10,2023-02-17,157.5,1474,4650,6124
185,TSLA  ,2023-02-10,2023-02-17,160.0,29125,20173,49298
186,TSLA  ,2023-02-10,2023-02-17,162.5,1407,5307,6714
187,TSLA  ,2023-02-10,2023-02-17,165.0,12478,13683,26161
188,TSLA  ,2023-02-10,2023-02-17,167.5,1029,4269,5298
189,TSLA  ,2023-02-10,2023-02-17,170.0,19395,20062,39457
190,TSLA  ,2023-02-10,2023-02-17,172.5,2421,5362,7783
191,TSLA  ,2023-02-10,2023-02-17,175.0,10325,12317,22642
192,TSLA  ,2023-02-10,2023-02-17,177.5,2367,3527,5894
193,TSLA  ,2023-02-10,2023-02-17,180.0,12591,20250,32841
194,TSLA  ,2023-02-10,2023-02-17,182.5,4666,3215,7881
195,TSLA  ,2023-02-10,2023-02-17,185.0,14394,9163,23557
196,TSLA  ,2023-02-10,2023-02-17,187.5,1916,2862,4778
197,TSLA  ,2023-02-10,2023-02-17,190.0,10679,18401,29080
198,TSLA  ,2023-02-10,2023-02-17,192.5,3328,3368,6696
199,TSLA  ,2023-02-10,2023-02-17,195.0,8002,7980,15982
200,TSLA  ,2023-02-10,2023-02-17,197.5,4976,4378,9354
201,TSLA  ,2023-02-10,2023-02-17,200.0,38964,20641,59605
202,TSLA  ,2023-02-10,2023-02-17,202.5,6571,3503,10074
203,TSLA  ,2023-02-10,2023-02-17,205.0,8243,5102,13345
204,TSLA  ,2023-02-10,2023-02-17,207.5,2235,1681,3916
205,TSLA  ,2023-02-10,2023-02-17,210.0,15054,7373,22427
206,TSLA  ,2023-02-10,2023-02-17,212.5,6128,1637,7765
207,TSLA  ,2023-02-10,2023-02-17,215.0,17557,2727,20284
208,TSLA  ,2023-02-10,2023-02-17,217.5,2125,417,2542
209,TSLA  ,2023-02-10,2023-02-17,220.0,36295,2198,38493
210,TSLA  ,2023-02-10,2023-02-17,222.5,1891,169,2060
211,TSLA  ,2023-02-10,2023-02-17,225.0,10458,751,11209
212,TSLA  ,2023-02-10,2023-02-17,227.5,1262,69,1331
213,TSLA  ,2023-02-10,2023-02-17,230.0,13437,1304,14741
214,TSLA  ,2023-02-10,2023-02-17,232.5,1988,63,2051
215,TSLA  ,2023-02-10,2023-02-17,235.0,7021,198,7219
216,TSLA  ,2023-02-10,2023-02-17,237.5,1165,84,1249
217,TSLA  ,2023-02-10,2023-02-17,240.0,9841,1800,11641
218,TSLA  ,2023-02-10,2023-02-17,242.5,1538,25,1563
219,TSLA  ,2023-02-10,2023-02-17,245.0,4465,194,4659
220,TSLA  ,2023-02-10,2023-02-17,247.5,1543,46,1589
221,TSLA  ,2023-02-10,2023-02-17,250.0,21061,314,21375
222,TSLA  ,2023-02-10,2023-02-17,252.5,1486,19,1505
223,TSLA  ,2023-02-10,2023-02-17,255.0,9998,95,10093
224,TSLA  ,2023-02-10,2023-02-17,257.5,1472,3,1475
225,TSLA  ,2023-02-10,2023-02-17,260.0,9008,126,9134
226,TSLA  ,2023-02-10,2023-02-17,262.5,1202,1,1203
227,TSLA  ,2023-02-10,2023-02-17,265.0,6927,60,6987
228,TSLA  ,2023-02-10,2023-02-17,270.0,8711,67,8778
229,TSLA  ,2023-02-10,2023-02-17,275.0,7634,14,7648
230,TSLA  ,2023-02-10,2023-02-17,280.0,6786,19,6805
231,TSLA  ,2023-02-10,2023-02-17,285.0,10223,5,10228
232,TSLA  ,2023-02-10,2023-02-17,290.0,7477,10,7487
233,TSLA  ,2023-02-10,2023-02-17,295.0,2739,7,2746
234,TSLA  ,2023-02-10,2023-02-17,300.0,13172,6,13178
235,TSLA  ,2023-02-10,2023-02-17,305.0,5098,20,5118
236,TSLA  ,2023-02-10,2023-02-17,310.0,3784,0,3784
237,TSLA  ,2023-02-10,2023-02-17,315.0,3746,0,3746
238,TSLA  ,2023-02-10,2023-02-17,320.0,11655,1,11656
239,TSLA  ,2023-02-10,2023-02-17,325.0,2014,0,2014
240,TSLA  ,2023-02-10,2023-02-17,330.0,1921,0,1921
241,TSLA  ,2023-02-10,2023-02-17,335.0,3943,0,3943
242,TSLA  ,2023-02-10,2023-02-17,340.0,2113,0,2113
243,TSLA  ,2023-02-10,2023-02-17,345.0,2815,0,2815
244,TSLA  ,2023-02-10,2023-02-17,350.0,3856,0,3856
245,TSLA  ,2023-02-10,2023-02-17,355.0,1155,0,1155
246,TSLA  ,2023-02-10,2023-02-17,360.0,1904,0,1904
247,TSLA  ,2023-02-10,2023-02-17,365.0,2034,0,2034
248,TSLA  ,2023-02-10,2023-02-17,370.0,1527,0,1527
249,TSLA  ,2023-02-10,2023-02-17,375.0,4634,0,4634
250,TSLA  ,2023-02-10,2023-02-17,380.0,2162,0,2162
251,TSLA  ,2023-02-10,2023-02-17,385.0,963,0,963
252,TSLA  ,2023-02-10,2023-02-17,390.0,1495,0,1495
253,TSLA  ,2023-02-10,2023-02-17,395.0,2035,0,2035
254,TSLA  ,2023-02-10,2023-02-17,400.0,4187,0,4187
255,TSLA  ,2023-02-10,2023-02-17,405.0,560,0,560
256,TSLA  ,2023-02-10,2023-02-17,410.0,798,0,798
257,TSLA  ,2023-02-10,2023-02-17,415.0,755,0,755
258,TSLA  ,2023-02-10,2023-02-17,420.0,794,0,794
259,TSLA  ,2023-02-10,2023-02-17,425.0,673,0,673
260,TSLA  ,2023-02-10,2023-02-17,430.0,728,0,728
261,TSLA  ,2023-02-10,2023-02-17,435.0,358,0,358
262,TSLA  ,2023-02-10,2023-02-17,440.0,822,0,822
263,TSLA  ,2023-02-10,2023-02-17,445.0,235,0,235
264,TSLA  ,2023-02-10,2023-02-17,450.0,753,0,753
265,TSLA  ,2023-02-10,2023-02-17,455.0,1720,0,1720
266,TSLA  ,2023-02-10,2023-02-17,460.0,349,0,349
267,TSLA  ,2023-02-10,2023-02-17,465.0,1039,0,1039
268,TSLA  ,2023-02-10,2023-02-17,470.0,1347,0,1347
269,TSLA  ,2023-02-10,2023-02-17,475.0,593,0,593
270,TSLA  ,2023-02-10,2023-02-17,480.0,347,0,347
271,TSLA  ,2023-02-10,2023-02-17,485.0,689,0,689
272,TSLA  ,2023-02-10,2023-02-17,490.0,242,0,242
273,TSLA  ,2023-02-10,2023-02-17,495.0,400,0,400
274,TSLA  ,2023-02-10,2023-02-17,500.0,3739,0,3739
275,TSLA  ,2023-02-10,2023-02-17,505.0,357,0,357
276,TSLA  ,2023-02-10,2023-02-17,510.0,356,0,356
277,TSLA  ,2023-02-10,2023-02-17,515.0,58,0,58
278,TSLA  ,2023-02-10,2023-02-17,520.0,327,0,327
279,TSLA  ,2023-02-10,2023-02-17,525.0,150,0,150
280,TSLA  ,2023-02-10,2023-02-17,530.0,391,0,391
281,TSLA  ,2023-02-10,2023-02-17,535.0,171,0,171
282,TSLA  ,2023-02-10,2023-02-17,540.0,219,0,219
283,TSLA  ,2023-02-10,2023-02-17,545.0,110,0,110
284,TSLA  ,2023-02-10,2023-02-17,550.0,799,0,799
285,TSLA  ,2023-02-10,2023-02-17,555.0,837,0,837
286,TSLA  ,2023-02-10,2023-02-17,560.0,573,0,573
287,TSLA  ,2023-02-10,2023-02-17,565.0,661,0,661
288,TSLA  ,2023-02-10,2023-02-17,570.0,317,0,317
289,TSLA  ,2023-02-10,2023-02-17,575.0,278,0,278
290,TSLA  ,2023-02-10,2023-02-17,580.0,1203,0,1203
291,TSLA  ,2023-02-10,2023-02-17,585.0,955,0,955
292,TSLA  ,2023-02-10,2023-02-17,590.0,297,0,297
293,TSLA  ,2023-02-10,2023-02-17,595.0,2000,0,2000
294,TSLA  ,2023-02-10,2023-02-17,600.0,2933,0,2933
295,TSLA  ,2023-02-10,2023-02-24,15.0,3,8,11
296,TSLA  ,2023-02-10,2023-02-24,20.0,3,1,4
297,TSLA  ,2023-02-10,2023-02-24,25.0,3,3,6
298,TSLA  ,2023-02-10,2023-02-24,30.0,3,748,751
299,TSLA  ,2023-02-10,2023-02-24,35.0,0,20,20
300,TSLA  ,2023-02-10,2023-02-24,40.0,0,439,439
301,TSLA  ,2023-02-10,2023-02-24,45.0,0,2031,2031
302,TSLA  ,2023-02-10,2023-02-24,50.0,0,1898,1898
303,TSLA  ,2023-02-10,2023-02-24,55.0,3,806,809
304,TSLA  ,2023-02-10,2023-02-24,60.0,11,1451,1462
305,TSLA  ,2023-02-10,2023-02-24,65.0,6,698,704
306,TSLA  ,2023-02-10,2023-02-24,70.0,6,550,556
307,TSLA  ,2023-02-10,2023-02-24,75.0,1,851,852
308,TSLA  ,2023-02-10,2023-02-24,80.0,7,1095,1102
309,TSLA  ,2023-02-10,2023-02-24,85.0,1,630,631
310,TSLA  ,2023-02-10,2023-02-24,90.0,44,1414,1458
311,TSLA  ,2023-02-10,2023-02-24,95.0,19,1827,1846
312,TSLA  ,2023-02-10,2023-02-24,98.0,14,425,439
313,TSLA  ,2023-02-10,2023-02-24,99.0,10,611,621
314,TSLA  ,2023-02-10,2023-02-24,100.0,67,2357,2424
315,TSLA  ,2023-02-10,2023-02-24,101.0,14,336,350
316,TSLA  ,2023-02-10,2023-02-24,102.0,4,242,246
317,TSLA  ,2023-02-10,2023-02-24,103.0,6,189,195
318,TSLA  ,2023-02-10,2023-02-24,104.0,17,335,352
319,TSLA  ,2023-02-10,2023-02-24,105.0,44,1936,1980
320,TSLA  ,2023-02-10,2023-02-24,106.0,15,516,531
321,TSLA  ,2023-02-10,2023-02-24,107.0,8,658,666
322,TSLA  ,2023-02-10,2023-02-24,108.0,9,410,419
323,TSLA  ,2023-02-10,2023-02-24,109.0,9,244,253
324,TSLA  ,2023-02-10,2023-02-24,110.0,336,1621,1957
325,TSLA  ,2023-02-10,2023-02-24,111.0,42,482,524
326,TSLA  ,2023-02-10,2023-02-24,112.0,52,438,490
327,TSLA  ,2023-02-10,2023-02-24,113.0,46,571,617
328,TSLA  ,2023-02-10,2023-02-24,114.0,380,796,1176
329,TSLA  ,2023-02-10,2023-02-24,115.0,366,1112,1478
330,TSLA  ,2023-02-10,2023-02-24,116.0,303,593,896
331,TSLA  ,2023-02-10,2023-02-24,117.0,277,361,638
332,TSLA  ,2023-02-10,2023-02-24,118.0,187,487,674
333,TSLA  ,2023-02-10,2023-02-24,119.0,207,630,837
334,TSLA  ,2023-02-10,2023-02-24,120.0,446,2341,2787
335,TSLA  ,2023-02-10,2023-02-24,121.0,312,704,1016
336,TSLA  ,2023-02-10,2023-02-24,122.0,299,2486,2785
337,TSLA  ,2023-02-10,2023-02-24,123.0,442,585,1027
338,TSLA  ,2023-02-10,2023-02-24,124.0,157,295,452
339,TSLA  ,2023-02-10,2023-02-24,125.0,531,2449,2980
340,TSLA  ,2023-02-10,2023-02-24,126.0,162,470,632
341,TSLA  ,2023-02-10,2023-02-24,127.0,86,387,473
342,TSLA  ,2023-02-10,2023-02-24,128.0,210,665,875
343,TSLA  ,2023-02-10,2023-02-24,129.0,238,843,1081
344,TSLA  ,2023-02-10,2023-02-24,130.0,2614,2480,5094
345,TSLA  ,2023-02-10,2023-02-24,131.0,407,147,554
346,TSLA  ,2023-02-10,2023-02-24,132.0,241,727,968
347,TSLA  ,2023-02-10,2023-02-24,133.0,144,406,550
348,TSLA  ,2023-02-10,2023-02-24,134.0,275,686,961
349,TSLA  ,2023-02-10,2023-02-24,135.0,1931,1561,3492
350,TSLA  ,2023-02-10,2023-02-24,136.0,81,447,528
351,TSLA  ,2023-02-10,2023-02-24,137.0,64,398,462
352,TSLA  ,2023-02-10,2023-02-24,138.0,66,459,525
353,TSLA  ,2023-02-10,2023-02-24,139.0,471,234,705
354,TSLA  ,2023-02-10,2023-02-24,140.0,1754,1992,3746
355,TSLA  ,2023-02-10,2023-02-24,141.0,360,524,884
356,TSLA  ,2023-02-10,2023-02-24,142.0,411,643,1054
357,TSLA  ,2023-02-10,2023-02-24,143.0,86,261,347
358,TSLA  ,2023-02-10,2023-02-24,144.0,68,287,355
359,TSLA  ,2023-02-10,2023-02-24,145.0,1591,4735,6326
360,TSLA  ,2023-02-10,2023-02-24,146.0,52,613,665
361,TSLA  ,2023-02-10,2023-02-24,147.0,45,312,357
362,TSLA  ,2023-02-10,2023-02-24,148.0,134,389,523
363,TSLA  ,2023-02-10,2023-02-24,149.0,100,1033,1133
364,TSLA  ,2023-02-10,2023-02-24,150.0,3081,5105,8186
365,TSLA  ,2023-02-10,2023-02-24,152.5,96,1574,1670
366,TSLA  ,2023-02-10,2023-02-24,155.0,1730,5697,7427
367,TSLA  ,2023-02-10,2023-02-24,157.5,625,552,1177
368,TSLA  ,2023-02-10,2023-02-24,160.0,2791,3938,6729
369,TSLA  ,2023-02-10,2023-02-24,162.5,418,516,934
370,TSLA  ,2023-02-10,2023-02-24,165.0,2375,1398,3773
371,TSLA  ,2023-02-10,2023-02-24,167.5,980,2227,3207
372,TSLA  ,2023-02-10,2023-02-24,170.0,2795,2640,5435
373,TSLA  ,2023-02-10,2023-02-24,172.5,556,412,968
374,TSLA  ,2023-02-10,2023-02-24,175.0,2704,1922,4626
375,TSLA  ,2023-02-10,2023-02-24,177.5,373,2537,2910
376,TSLA  ,2023-02-10,2023-02-24,180.0,2605,4889,7494
377,TSLA  ,2023-02-10,2023-02-24,182.5,451,793,1244
378,TSLA  ,2023-02-10,2023-02-24,185.0,1395,2590,3985
379,TSLA  ,2023-02-10,2023-02-24,187.5,447,893,1340
380,TSLA  ,2023-02-10,2023-02-24,190.0,1701,3879,5580
381,TSLA  ,2023-02-10,2023-02-24,192.5,1263,1468,2731
382,TSLA  ,2023-02-10,2023-02-24,195.0,2090,1675,3765
383,TSLA  ,2023-02-10,2023-02-24,197.5,1325,1422,2747
384,TSLA  ,2023-02-10,2023-02-24,200.0,4349,3597,7946
385,TSLA  ,2023-02-10,2023-02-24,202.5,898,785,1683
386,TSLA  ,2023-02-10,2023-02-24,205.0,2768,820,3588
387,TSLA  ,2023-02-10,2023-02-24,207.5,888,563,1451
388,TSLA  ,2023-02-10,2023-02-24,210.0,3875,910,4785
389,TSLA  ,2023-02-10,2023-02-24,212.5,1527,585,2112
390,TSLA  ,2023-02-10,2023-02-24,215.0,2412,404,2816
391,TSLA  ,2023-02-10,2023-02-24,217.5,713,230,943
392,TSLA  ,2023-02-10,2023-02-24,220.0,5495,311,5806
393,TSLA  ,2023-02-10,2023-02-24,222.5,559,29,588
394,TSLA  ,2023-02-10,2023-02-24,225.0,3261,35,3296
395,TSLA  ,2023-02-10,2023-02-24,227.5,408,4,412
396,TSLA  ,2023-02-10,2023-02-24,230.0,2677,126,2803
397,TSLA  ,2023-02-10,2023-02-24,232.5,1204,9,1213
398,TSLA  ,2023-02-10,2023-02-24,235.0,1325,40,1365
399,TSLA  ,2023-02-10,2023-02-24,240.0,4392,634,5026
400,TSLA  ,2023-02-10,2023-02-24,245.0,1909,7,1916
401,TSLA  ,2023-02-10,2023-02-24,250.0,4487,178,4665
402,TSLA  ,2023-02-10,2023-02-24,255.0,782,2,784
403,TSLA  ,2023-02-10,2023-02-24,260.0,8868,5,8873
404,TSLA  ,2023-02-10,2023-02-24,265.0,1494,3,1497
405,TSLA  ,2023-02-10,2023-02-24,270.0,1732,4,1736
406,TSLA  ,2023-02-10,2023-02-24,275.0,1535,3,1538
407,TSLA  ,2023-02-10,2023-02-24,280.0,2083,4,2087
408,TSLA  ,2023-02-10,2023-02-24,285.0,3116,0,3116
409,TSLA  ,2023-02-10,2023-02-24,290.0,1023,0,1023
410,TSLA  ,2023-02-10,2023-02-24,295.0,390,18,408
411,TSLA  ,2023-02-10,2023-02-24,300.0,3024,20,3044
412,TSLA  ,2023-02-10,2023-02-24,310.0,1548,0,1548
413,TSLA  ,2023-02-10,2023-02-24,320.0,760,0,760
414,TSLA  ,2023-02-10,2023-02-24,330.0,650,0,650
415,TSLA  ,2023-02-10,2023-02-24,340.0,497,0,497
416,TSLA  ,2023-02-10,2023-02-24,350.0,1908,0,1908
417,TSLA  ,2023-02-10,2023-02-24,360.0,1979,0,1979
418,TSLA  ,2023-02-10,2023-03-03,15.0,8,256,264
419,TSLA  ,2023-02-10,2023-03-03,20.0,1,0,1
420,TSLA  ,2023-02-10,2023-03-03,25.0,4,47,51
421,TSLA  ,2023-02-10,2023-03-03,30.0,3,340,343
422,TSLA  ,2023-02-10,2023-03-03,35.0,3,1,4
423,TSLA  ,2023-02-10,2023-03-03,40.0,0,10,10
424,TSLA  ,2023-02-10,2023-03-03,45.0,0,2456,2456
425,TSLA  ,2023-02-10,2023-03-03,50.0,1,886,887
426,TSLA  ,2023-02-10,2023-03-03,55.0,0,156,156
427,TSLA  ,2023-02-10,2023-03-03,60.0,5,1114,1119
428,TSLA  ,2023-02-10,2023-03-03,65.0,1,80,81
429,TSLA  ,2023-02-10,2023-03-03,70.0,2,667,669
430,TSLA  ,2023-02-10,2023-03-03,75.0,0,258,258
431,TSLA  ,2023-02-10,2023-03-03,80.0,112,1066,1178
432,TSLA  ,2023-02-10,2023-03-03,85.0,4,547,551
433,TSLA  ,2023-02-10,2023-03-03,90.0,7,1000,1007
434,TSLA  ,2023-02-10,2023-03-03,95.0,7,1843,1850
435,TSLA  ,2023-02-10,2023-03-03,100.0,112,1938,2050
436,TSLA  ,2023-02-10,2023-03-03,105.0,18,619,637
437,TSLA  ,2023-02-10,2023-03-03,108.0,59,484,543
438,TSLA  ,2023-02-10,2023-03-03,109.0,34,300,334
439,TSLA  ,2023-02-10,2023-03-03,110.0,83,3012,3095
440,TSLA  ,2023-02-10,2023-03-03,111.0,7,555,562
441,TSLA  ,2023-02-10,2023-03-03,112.0,36,699,735
442,TSLA  ,2023-02-10,2023-03-03,113.0,29,559,588
443,TSLA  ,2023-02-10,2023-03-03,114.0,154,502,656
444,TSLA  ,2023-02-10,2023-03-03,115.0,185,880,1065
445,TSLA  ,2023-02-10,2023-03-03,116.0,158,404,562
446,TSLA  ,2023-02-10,2023-03-03,117.0,472,748,1220
447,TSLA  ,2023-02-10,2023-03-03,118.0,302,277,579
448,TSLA  ,2023-02-10,2023-03-03,119.0,318,508,826
449,TSLA  ,2023-02-10,2023-03-03,120.0,804,1671,2475
450,TSLA  ,2023-02-10,2023-03-03,121.0,92,503,595
451,TSLA  ,2023-02-10,2023-03-03,122.0,117,904,1021
452,TSLA  ,2023-02-10,2023-03-03,123.0,264,627,891
453,TSLA  ,2023-02-10,2023-03-03,124.0,446,441,887
454,TSLA  ,2023-02-10,2023-03-03,125.0,271,813,1084
455,TSLA  ,2023-02-10,2023-03-03,126.0,670,381,1051
456,TSLA  ,2023-02-10,2023-03-03,127.0,429,248,677
457,TSLA  ,2023-02-10,2023-03-03,128.0,454,789,1243
458,TSLA  ,2023-02-10,2023-03-03,129.0,647,546,1193
459,TSLA  ,2023-02-10,2023-03-03,130.0,693,1529,2222
460,TSLA  ,2023-02-10,2023-03-03,131.0,305,750,1055
461,TSLA  ,2023-02-10,2023-03-03,132.0,832,645,1477
462,TSLA  ,2023-02-10,2023-03-03,133.0,539,108,647
463,TSLA  ,2023-02-10,2023-03-03,134.0,569,1255,1824
464,TSLA  ,2023-02-10,2023-03-03,135.0,875,1070,1945
465,TSLA  ,2023-02-10,2023-03-03,136.0,92,67,159
466,TSLA  ,2023-02-10,2023-03-03,137.0,65,103,168
467,TSLA  ,2023-02-10,2023-03-03,138.0,151,319,470
468,TSLA  ,2023-02-10,2023-03-03,139.0,106,174,280
469,TSLA  ,2023-02-10,2023-03-03,140.0,660,1330,1990
470,TSLA  ,2023-02-10,2023-03-03,141.0,67,106,173
471,TSLA  ,2023-02-10,2023-03-03,142.0,295,184,479
472,TSLA  ,2023-02-10,2023-03-03,143.0,11,37,48
473,TSLA  ,2023-02-10,2023-03-03,144.0,21,2130,2151
474,TSLA  ,2023-02-10,2023-03-03,145.0,680,3737,4417
475,TSLA  ,2023-02-10,2023-03-03,146.0,27,566,593
476,TSLA  ,2023-02-10,2023-03-03,147.0,39,211,250
477,TSLA  ,2023-02-10,2023-03-03,148.0,38,459,497
478,TSLA  ,2023-02-10,2023-03-03,149.0,256,1687,1943
479,TSLA  ,2023-02-10,2023-03-03,150.0,1012,6316,7328
480,TSLA  ,2023-02-10,2023-03-03,152.5,154,829,983
481,TSLA  ,2023-02-10,2023-03-03,155.0,1172,866,2038
482,TSLA  ,2023-02-10,2023-03-03,157.5,123,410,533
483,TSLA  ,2023-02-10,2023-03-03,160.0,1085,4433,5518
484,TSLA  ,2023-02-10,2023-03-03,162.5,192,4417,4609
485,TSLA  ,2023-02-10,2023-03-03,165.0,1801,1531,3332
486,TSLA  ,2023-02-10,2023-03-03,167.5,284,500,784
487,TSLA  ,2023-02-10,2023-03-03,170.0,2461,4383,6844
488,TSLA  ,2023-02-10,2023-03-03,172.5,1192,728,1920
489,TSLA  ,2023-02-10,2023-03-03,175.0,1210,1856,3066
490,TSLA  ,2023-02-10,2023-03-03,177.5,438,346,784
491,TSLA  ,2023-02-10,2023-03-03,180.0,2078,2503,4581
492,TSLA  ,2023-02-10,2023-03-03,182.5,295,625,920
493,TSLA  ,2023-02-10,2023-03-03,185.0,1620,1042,2662
494,TSLA  ,2023-02-10,2023-03-03,187.5,1347,693,2040
495,TSLA  ,2023-02-10,2023-03-03,190.0,2045,1491,3536
496,TSLA  ,2023-02-10,2023-03-03,192.5,544,652,1196
497,TSLA  ,2023-02-10,2023-03-03,195.0,1723,1508,3231
498,TSLA  ,2023-02-10,2023-03-03,197.5,1734,559,2293
499,TSLA  ,2023-02-10,2023-03-03,200.0,5465,2214,7679
500,TSLA  ,2023-02-10,2023-03-03,202.5,1048,1063,2111
501,TSLA  ,2023-02-10,2023-03-03,205.0,2799,593,3392
502,TSLA  ,2023-02-10,2023-03-03,207.5,970,754,1724
503,TSLA  ,2023-02-10,2023-03-03,210.0,3328,738,4066
504,TSLA  ,2023-02-10,2023-03-03,212.5,945,329,1274
505,TSLA  ,2023-02-10,2023-03-03,215.0,4163,301,4464
506,TSLA  ,2023-02-10,2023-03-03,217.5,464,301,765
507,TSLA  ,2023-02-10,2023-03-03,220.0,3712,482,4194
508,TSLA  ,2023-02-10,2023-03-03,222.5,382,47,429
509,TSLA  ,2023-02-10,2023-03-03,225.0,2536,23,2559
510,TSLA  ,2023-02-10,2023-03-03,230.0,4406,193,4599
511,TSLA  ,2023-02-10,2023-03-03,235.0,1244,8,1252
512,TSLA  ,2023-02-10,2023-03-03,240.0,3310,35,3345
513,TSLA  ,2023-02-10,2023-03-03,245.0,3345,19,3364
514,TSLA  ,2023-02-10,2023-03-03,250.0,4168,70,4238
515,TSLA  ,2023-02-10,2023-03-03,255.0,1018,5,1023
516,TSLA  ,2023-02-10,2023-03-03,260.0,686,15,701
517,TSLA  ,2023-02-10,2023-03-03,265.0,833,0,833
518,TSLA  ,2023-02-10,2023-03-03,270.0,1089,2,1091
519,TSLA  ,2023-02-10,2023-03-03,275.0,1382,7,1389
520,TSLA  ,2023-02-10,2023-03-03,280.0,1028,24,1052
521,TSLA  ,2023-02-10,2023-03-03,285.0,383,24,407
522,TSLA  ,2023-02-10,2023-03-03,290.0,1245,2,1247
523,TSLA  ,2023-02-10,2023-03-03,295.0,291,22,313
524,TSLA  ,2023-02-10,2023-03-03,300.0,4356,50,4406
525,TSLA  ,2023-02-10,2023-03-03,310.0,369,0,369
526,TSLA  ,2023-02-10,2023-03-03,320.0,703,5,708
527,TSLA  ,2023-02-10,2023-03-03,330.0,354,0,354
528,TSLA  ,2023-02-10,2023-03-03,340.0,407,0,407
529,TSLA  ,2023-02-10,2023-03-03,350.0,403,1,404
530,TSLA  ,2023-02-10,2023-03-03,360.0,973,0,973
531,TSLA  ,2023-02-10,2023-03-10,15.0,3,36,39
532,TSLA  ,2023-02-10,2023-03-10,20.0,3,0,3
533,TSLA  ,2023-02-10,2023-03-10,25.0,0,0,0
534,TSLA  ,2023-02-10,2023-03-10,30.0,3,2,5
535,TSLA  ,2023-02-10,2023-03-10,35.0,0,0,0
536,TSLA  ,2023-02-10,2023-03-10,40.0,0,10,10
537,TSLA  ,2023-02-10,2023-03-10,45.0,0,0,0
538,TSLA  ,2023-02-10,2023-03-10,50.0,5,59,64
539,TSLA  ,2023-02-10,2023-03-10,55.0,0,1200,1200
540,TSLA  ,2023-02-10,2023-03-10,60.0,0,12,12
541,TSLA  ,2023-02-10,2023-03-10,65.0,0,10,10
542,TSLA  ,2023-02-10,2023-03-10,70.0,0,25,25
543,TSLA  ,2023-02-10,2023-03-10,75.0,0,418,418
544,TSLA  ,2023-02-10,2023-03-10,80.0,0,77,77
545,TSLA  ,2023-02-10,2023-03-10,85.0,0,45,45
546,TSLA  ,2023-02-10,2023-03-10,90.0,0,50,50
547,TSLA  ,2023-02-10,2023-03-10,95.0,1,215,216
548,TSLA  ,2023-02-10,2023-03-10,100.0,1,511,512
549,TSLA  ,2023-02-10,2023-03-10,105.0,4,1144,1148
550,TSLA  ,2023-02-10,2023-03-10,110.0,14,739,753
551,TSLA  ,2023-02-10,2023-03-10,115.0,5,293,298
552,TSLA  ,2023-02-10,2023-03-10,120.0,6,266,272
553,TSLA  ,2023-02-10,2023-03-10,125.0,15,570,585
554,TSLA  ,2023-02-10,2023-03-10,130.0,79,228,307
555,TSLA  ,2023-02-10,2023-03-10,134.0,8,127,135
556,TSLA  ,2023-02-10,2023-03-10,135.0,33,543,576
557,TSLA  ,2023-02-10,2023-03-10,136.0,24,109,133
558,TSLA  ,2023-02-10,2023-03-10,137.0,7,75,82
559,TSLA  ,2023-02-10,2023-03-10,138.0,4,105,109
560,TSLA  ,2023-02-10,2023-03-10,139.0,3,117,120
561,TSLA  ,2023-02-10,2023-03-10,140.0,63,948,1011
562,TSLA  ,2023-02-10,2023-03-10,141.0,142,14,156
563,TSLA  ,2023-02-10,2023-03-10,142.0,13,233,246
564,TSLA  ,2023-02-10,2023-03-10,143.0,4,306,310
565,TSLA  ,2023-02-10,2023-03-10,144.0,6,60,66
566,TSLA  ,2023-02-10,2023-03-10,145.0,106,343,449
567,TSLA  ,2023-02-10,2023-03-10,146.0,20,27,47
568,TSLA  ,2023-02-10,2023-03-10,147.0,79,125,204
569,TSLA  ,2023-02-10,2023-03-10,148.0,98,756,854
570,TSLA  ,2023-02-10,2023-03-10,149.0,3,197,200
571,TSLA  ,2023-02-10,2023-03-10,150.0,249,907,1156
572,TSLA  ,2023-02-10,2023-03-10,152.5,102,167,269
573,TSLA  ,2023-02-10,2023-03-10,155.0,284,649,933
574,TSLA  ,2023-02-10,2023-03-10,157.5,90,369,459
575,TSLA  ,2023-02-10,2023-03-10,160.0,231,704,935
576,TSLA  ,2023-02-10,2023-03-10,162.5,91,304,395
577,TSLA  ,2023-02-10,2023-03-10,165.0,282,882,1164
578,TSLA  ,2023-02-10,2023-03-10,167.5,201,434,635
579,TSLA  ,2023-02-10,2023-03-10,170.0,383,1314,1697
580,TSLA  ,2023-02-10,2023-03-10,172.5,183,356,539
581,TSLA  ,2023-02-10,2023-03-10,175.0,418,1750,2168
582,TSLA  ,2023-02-10,2023-03-10,177.5,1793,241,2034
583,TSLA  ,2023-02-10,2023-03-10,180.0,614,1376,1990
584,TSLA  ,2023-02-10,2023-03-10,182.5,156,123,279
585,TSLA  ,2023-02-10,2023-03-10,185.0,267,729,996
586,TSLA  ,2023-02-10,2023-03-10,187.5,1183,142,1325
587,TSLA  ,2023-02-10,2023-03-10,190.0,1060,920,1980
588,TSLA  ,2023-02-10,2023-03-10,192.5,588,247,835
589,TSLA  ,2023-02-10,2023-03-10,195.0,449,626,1075
590,TSLA  ,2023-02-10,2023-03-10,197.5,282,554,836
591,TSLA  ,2023-02-10,2023-03-10,200.0,1799,967,2766
592,TSLA  ,2023-02-10,2023-03-10,202.5,1099,824,1923
593,TSLA  ,2023-02-10,2023-03-10,205.0,806,414,1220
594,TSLA  ,2023-02-10,2023-03-10,207.5,217,244,461
595,TSLA  ,2023-02-10,2023-03-10,210.0,1530,448,1978
596,TSLA  ,2023-02-10,2023-03-10,212.5,384,348,732
597,TSLA  ,2023-02-10,2023-03-10,215.0,550,169,719
598,TSLA  ,2023-02-10,2023-03-10,217.5,229,108,337
599,TSLA  ,2023-02-10,2023-03-10,220.0,1457,39,1496
600,TSLA  ,2023-02-10,2023-03-10,222.5,151,40,191
601,TSLA  ,2023-02-10,2023-03-10,225.0,949,114,1063
602,TSLA  ,2023-02-10,2023-03-10,230.0,708,17,725
603,TSLA  ,2023-02-10,2023-03-10,235.0,408,4,412
604,TSLA  ,2023-02-10,2023-03-10,240.0,1132,13,1145
605,TSLA  ,2023-02-10,2023-03-10,245.0,543,44,587
606,TSLA  ,2023-02-10,2023-03-10,250.0,1630,38,1668
607,TSLA  ,2023-02-10,2023-03-10,255.0,315,2,317
608,TSLA  ,2023-02-10,2023-03-10,260.0,848,58,906
609,TSLA  ,2023-02-10,2023-03-10,265.0,3228,0,3228
610,TSLA  ,2023-02-10,2023-03-10,270.0,519,0,519
611,TSLA  ,2023-02-10,2023-03-10,275.0,218,0,218
612,TSLA  ,2023-02-10,2023-03-10,280.0,923,5,928
613,TSLA  ,2023-02-10,2023-03-10,285.0,379,0,379
614,TSLA  ,2023-02-10,2023-03-10,290.0,237,3,240
615,TSLA  ,2023-02-10,2023-03-10,295.0,221,0,221
616,TSLA  ,2023-02-10,2023-03-10,300.0,1293,0,1293
617,TSLA  ,2023-02-10,2023-03-10,310.0,2847,11,2858
618,TSLA  ,2023-02-10,2023-03-10,320.0,293,0,293
619,TSLA  ,2023-02-10,2023-03-10,330.0,313,0,313
620,TSLA  ,2023-02-10,2023-03-10,340.0,297,0,297
621,TSLA  ,2023-02-10,2023-03-10,350.0,270,2,272
622,TSLA  ,2023-02-10,2023-03-10,360.0,662,0,662
623,TSLA  ,2023-02-10,2023-03-17,1.67,50,24714,24764
624,TSLA  ,2023-02-10,2023-03-17,3.33,29,6941,6970
625,TSLA  ,2023-02-10,2023-03-17,5.0,2,8008,8010
626,TSLA  ,2023-02-10,2023-03-17,6.67,52,4669,4721
627,TSLA  ,2023-02-10,2023-03-17,8.33,15,1379,1394
628,TSLA  ,2023-02-10,2023-03-17,10.0,842,4105,4947
629,TSLA  ,2023-02-10,2023-03-17,11.67,1711,5414,7125
630,TSLA  ,2023-02-10,2023-03-17,13.33,1657,2125,3782
631,TSLA  ,2023-02-10,2023-03-17,15.0,987,5169,6156
632,TSLA  ,2023-02-10,2023-03-17,16.67,875,15329,16204
633,TSLA  ,2023-02-10,2023-03-17,18.33,467,12018,12485
634,TSLA  ,2023-02-10,2023-03-17,33.33,406,33564,33970
635,TSLA  ,2023-02-10,2023-03-17,50.0,497,22181,22678
636,TSLA  ,2023-02-10,2023-03-17,55.0,33,4647,4680
637,TSLA  ,2023-02-10,2023-03-17,60.0,201,6181,6382
638,TSLA  ,2023-02-10,2023-03-17,65.0,25,2891,2916
639,TSLA  ,2023-02-10,2023-03-17,66.67,899,17834,18733
640,TSLA  ,2023-02-10,2023-03-17,70.0,49,7616,7665
641,TSLA  ,2023-02-10,2023-03-17,75.0,54,5424,5478
642,TSLA  ,2023-02-10,2023-03-17,80.0,238,12036,12274
643,TSLA  ,2023-02-10,2023-03-17,83.33,886,5226,6112
644,TSLA  ,2023-02-10,2023-03-17,85.0,87,3495,3582
645,TSLA  ,2023-02-10,2023-03-17,90.0,664,15927,16591
646,TSLA  ,2023-02-10,2023-03-17,95.0,334,3566,3900
647,TSLA  ,2023-02-10,2023-03-17,100.0,1786,30899,32685
648,TSLA  ,2023-02-10,2023-03-17,105.0,1409,4445,5854
649,TSLA  ,2023-02-10,2023-03-17,110.0,2894,13167,16061
650,TSLA  ,2023-02-10,2023-03-17,115.0,3382,8702,12084
651,TSLA  ,2023-02-10,2023-03-17,116.67,1373,11172,12545
652,TSLA  ,2023-02-10,2023-03-17,120.0,12398,20331,32729
653,TSLA  ,2023-02-10,2023-03-17,123.33,2744,6375,9119
654,TSLA  ,2023-02-10,2023-03-17,125.0,3568,10807,14375
655,TSLA  ,2023-02-10,2023-03-17,126.67,1684,4695,6379
656,TSLA  ,2023-02-10,2023-03-17,130.0,7404,11034,18438
657,TSLA  ,2023-02-10,2023-03-17,133.33,3439,9499,12938
658,TSLA  ,2023-02-10,2023-03-17,135.0,27804,33819,61623
659,TSLA  ,2023-02-10,2023-03-17,136.67,2893,3484,6377
660,TSLA  ,2023-02-10,2023-03-17,140.0,7140,29119,36259
661,TSLA  ,2023-02-10,2023-03-17,143.33,2462,5049,7511
662,TSLA  ,2023-02-10,2023-03-17,145.0,2802,8850,11652
663,TSLA  ,2023-02-10,2023-03-17,146.67,1896,4399,6295
664,TSLA  ,2023-02-10,2023-03-17,150.0,13532,21837,35369
665,TSLA  ,2023-02-10,2023-03-17,153.33,1669,2942,4611
666,TSLA  ,2023-02-10,2023-03-17,155.0,3670,6118,9788
667,TSLA  ,2023-02-10,2023-03-17,156.67,2240,3421,5661
668,TSLA  ,2023-02-10,2023-03-17,160.0,7700,23149,30849
669,TSLA  ,2023-02-10,2023-03-17,163.33,3019,5126,8145
670,TSLA  ,2023-02-10,2023-03-17,165.0,6958,5169,12127
671,TSLA  ,2023-02-10,2023-03-17,166.67,6365,11451,17816
672,TSLA  ,2023-02-10,2023-03-17,170.0,11211,21130,32341
673,TSLA  ,2023-02-10,2023-03-17,173.33,3154,11114,14268
674,TSLA  ,2023-02-10,2023-03-17,175.0,4798,6172,10970
675,TSLA  ,2023-02-10,2023-03-17,176.67,5247,2805,8052
676,TSLA  ,2023-02-10,2023-03-17,180.0,20696,20315,41011
677,TSLA  ,2023-02-10,2023-03-17,183.33,3415,7939,11354
678,TSLA  ,2023-02-10,2023-03-17,185.0,3353,3990,7343
679,TSLA  ,2023-02-10,2023-03-17,186.67,2652,4063,6715
680,TSLA  ,2023-02-10,2023-03-17,190.0,12020,13195,25215
681,TSLA  ,2023-02-10,2023-03-17,193.33,2186,2609,4795
682,TSLA  ,2023-02-10,2023-03-17,195.0,4467,3643,8110
683,TSLA  ,2023-02-10,2023-03-17,196.67,2650,1785,4435
684,TSLA  ,2023-02-10,2023-03-17,198.33,3612,1968,5580
685,TSLA  ,2023-02-10,2023-03-17,200.0,41135,36171,77306
686,TSLA  ,2023-02-10,2023-03-17,201.67,1725,1507,3232
687,TSLA  ,2023-02-10,2023-03-17,203.33,2918,2131,5049
688,TSLA  ,2023-02-10,2023-03-17,205.0,3942,2724,6666
689,TSLA  ,2023-02-10,2023-03-17,206.67,1524,2196,3720
690,TSLA  ,2023-02-10,2023-03-17,208.33,2319,811,3130
691,TSLA  ,2023-02-10,2023-03-17,210.0,10068,5767,15835
692,TSLA  ,2023-02-10,2023-03-17,211.67,2049,647,2696
693,TSLA  ,2023-02-10,2023-03-17,213.33,1621,594,2215
694,TSLA  ,2023-02-10,2023-03-17,215.0,10016,795,10811
695,TSLA  ,2023-02-10,2023-03-17,216.67,4724,2921,7645
696,TSLA  ,2023-02-10,2023-03-17,218.33,1156,187,1343
697,TSLA  ,2023-02-10,2023-03-17,220.0,11270,1400,12670
698,TSLA  ,2023-02-10,2023-03-17,221.67,1409,220,1629
699,TSLA  ,2023-02-10,2023-03-17,223.33,890,185,1075
700,TSLA  ,2023-02-10,2023-03-17,225.0,4903,1232,6135
701,TSLA  ,2023-02-10,2023-03-17,226.67,2050,196,2246
702,TSLA  ,2023-02-10,2023-03-17,228.33,4919,56,4975
703,TSLA  ,2023-02-10,2023-03-17,230.0,6257,909,7166
704,TSLA  ,2023-02-10,2023-03-17,231.67,1452,66,1518
705,TSLA  ,2023-02-10,2023-03-17,233.33,7258,421,7679
706,TSLA  ,2023-02-10,2023-03-17,235.0,6813,127,6940
707,TSLA  ,2023-02-10,2023-03-17,236.67,1064,64,1128
708,TSLA  ,2023-02-10,2023-03-17,238.33,1009,81,1090
709,TSLA  ,2023-02-10,2023-03-17,240.0,6220,343,6563
710,TSLA  ,2023-02-10,2023-03-17,241.67,987,59,1046
711,TSLA  ,2023-02-10,2023-03-17,243.33,1232,412,1644
712,TSLA  ,2023-02-10,2023-03-17,245.0,2176,72,2248
713,TSLA  ,2023-02-10,2023-03-17,246.67,941,36,977
714,TSLA  ,2023-02-10,2023-03-17,248.33,1046,34,1080
715,TSLA  ,2023-02-10,2023-03-17,250.0,19331,781,20112
716,TSLA  ,2023-02-10,2023-03-17,251.67,1327,80,1407
717,TSLA  ,2023-02-10,2023-03-17,253.33,582,35,617
718,TSLA  ,2023-02-10,2023-03-17,255.0,3194,76,3270
719,TSLA  ,2023-02-10,2023-03-17,256.67,641,24,665
720,TSLA  ,2023-02-10,2023-03-17,258.33,873,30,903
721,TSLA  ,2023-02-10,2023-03-17,260.0,6394,49,6443
722,TSLA  ,2023-02-10,2023-03-17,261.67,1449,13,1462
723,TSLA  ,2023-02-10,2023-03-17,263.33,1008,57,1065
724,TSLA  ,2023-02-10,2023-03-17,265.0,1151,16,1167
725,TSLA  ,2023-02-10,2023-03-17,266.67,9934,376,10310
726,TSLA  ,2023-02-10,2023-03-17,270.0,4322,32,4354
727,TSLA  ,2023-02-10,2023-03-17,273.33,3761,80,3841
728,TSLA  ,2023-02-10,2023-03-17,275.0,445,12,457
729,TSLA  ,2023-02-10,2023-03-17,276.67,1385,38,1423
730,TSLA  ,2023-02-10,2023-03-17,280.0,2774,138,2912
731,TSLA  ,2023-02-10,2023-03-17,283.33,7040,54,7094
732,TSLA  ,2023-02-10,2023-03-17,285.0,206,1,207
733,TSLA  ,2023-02-10,2023-03-17,286.67,1914,17,1931
734,TSLA  ,2023-02-10,2023-03-17,290.0,3241,69,3310
735,TSLA  ,2023-02-10,2023-03-17,293.33,7272,342,7614
736,TSLA  ,2023-02-10,2023-03-17,295.0,1992,11,2003
737,TSLA  ,2023-02-10,2023-03-17,296.67,911,16,927
738,TSLA  ,2023-02-10,2023-03-17,298.33,1104,2,1106
739,TSLA  ,2023-02-10,2023-03-17,300.0,70534,450,70984
740,TSLA  ,2023-02-10,2023-03-17,301.67,1476,17,1493
741,TSLA  ,2023-02-10,2023-03-17,303.33,1308,3,1311
742,TSLA  ,2023-02-10,2023-03-17,305.0,2674,8,2682
743,TSLA  ,2023-02-10,2023-03-17,306.67,1912,3,1915
744,TSLA  ,2023-02-10,2023-03-17,308.33,3844,2,3846
745,TSLA  ,2023-02-10,2023-03-17,310.0,4853,36,4889
746,TSLA  ,2023-02-10,2023-03-17,311.67,2014,5,2019
747,TSLA  ,2023-02-10,2023-03-17,313.33,2471,1,2472
748,TSLA  ,2023-02-10,2023-03-17,316.67,29536,11,29547
749,TSLA  ,2023-02-10,2023-03-17,320.0,15463,202,15665
750,TSLA  ,2023-02-10,2023-03-17,323.33,459,0,459
751,TSLA  ,2023-02-10,2023-03-17,326.67,536,1,537
752,TSLA  ,2023-02-10,2023-03-17,330.0,3391,6,3397
753,TSLA  ,2023-02-10,2023-03-17,333.33,20418,27,20445
754,TSLA  ,2023-02-10,2023-03-17,336.67,645,0,645
755,TSLA  ,2023-02-10,2023-03-17,340.0,5459,0,5459
756,TSLA  ,2023-02-10,2023-03-17,343.33,1863,0,1863
757,TSLA  ,2023-02-10,2023-03-17,346.67,620,2,622
758,TSLA  ,2023-02-10,2023-03-17,350.0,10887,218,11105
759,TSLA  ,2023-02-10,2023-03-17,353.33,669,0,669
760,TSLA  ,2023-02-10,2023-03-17,356.67,501,0,501
761,TSLA  ,2023-02-10,2023-03-17,360.0,2076,0,2076
762,TSLA  ,2023-02-10,2023-03-17,363.33,572,0,572
763,TSLA  ,2023-02-10,2023-03-17,366.67,7783,0,7783
764,TSLA  ,2023-02-10,2023-03-17,370.0,1422,1,1423
765,TSLA  ,2023-02-10,2023-03-17,373.33,690,0,690
766,TSLA  ,2023-02-10,2023-03-17,383.33,12601,0,12601
767,TSLA  ,2023-02-10,2023-03-17,400.0,25686,1,25687
768,TSLA  ,2023-02-10,2023-03-17,416.67,13154,0,13154
769,TSLA  ,2023-02-10,2023-03-17,433.33,19329,0,19329
770,TSLA  ,2023-02-10,2023-03-17,441.67,2030,0,2030
771,TSLA  ,2023-02-10,2023-03-17,450.0,5463,0,5463
772,TSLA  ,2023-02-10,2023-03-17,458.33,2421,0,2421
773,TSLA  ,2023-02-10,2023-03-17,466.67,2833,4,2837
774,TSLA  ,2023-02-10,2023-03-17,475.0,3438,0,3438
775,TSLA  ,2023-02-10,2023-03-17,483.33,1962,0,1962
776,TSLA  ,2023-02-10,2023-03-17,491.67,2483,0,2483
777,TSLA  ,2023-02-10,2023-03-17,500.0,13560,6,13566
778,TSLA  ,2023-02-10,2023-03-17,508.33,3135,0,3135
779,TSLA  ,2023-02-10,2023-03-17,516.67,1108,0,1108
780,TSLA  ,2023-02-10,2023-03-17,525.0,4711,0,4711
781,TSLA  ,2023-02-10,2023-03-17,533.33,4766,0,4766
782,TSLA  ,2023-02-10,2023-03-17,541.67,1031,0,1031
783,TSLA  ,2023-02-10,2023-03-17,550.0,5022,0,5022
784,TSLA  ,2023-02-10,2023-03-17,558.33,3777,0,3777
785,TSLA  ,2023-02-10,2023-03-17,566.67,7591,0,7591
786,TSLA  ,2023-02-10,2023-03-17,575.0,11860,0,11860
787,TSLA  ,2023-02-10,2023-03-17,583.33,2651,0,2651
788,TSLA  ,2023-02-10,2023-03-17,591.67,803,0,803
789,TSLA  ,2023-02-10,2023-03-17,600.0,5135,0,5135
790,TSLA  ,2023-02-10,2023-03-17,608.33,530,0,530
791,TSLA  ,2023-02-10,2023-03-17,616.67,3980,0,3980
792,TSLA  ,2023-02-10,2023-03-17,625.0,959,0,959
793,TSLA  ,2023-02-10,2023-03-17,633.33,2364,0,2364
794,TSLA  ,2023-02-10,2023-03-17,641.67,1451,0,1451
795,TSLA  ,2023-02-10,2023-03-17,650.0,8218,0,8218
796,TSLA  ,2023-02-10,2023-03-17,666.67,70173,0,70173
797,TSLA  ,2023-02-10,2023-03-17,675.0,21560,0,21560
798,TSLA  ,2023-02-10,2023-03-17,683.33,3814,0,3814
799,TSLA  ,2023-02-10,2023-03-17,691.67,1167,0,1167
800,TSLA  ,2023-02-10,2023-03-17,700.0,4668,0,4668
801,TSLA  ,2023-02-10,2023-03-17,708.33,587,0,587
802,TSLA  ,2023-02-10,2023-03-17,716.67,782,0,782
803,TSLA  ,2023-02-10,2023-03-17,725.0,1032,0,1032
804,TSLA  ,2023-02-10,2023-03-17,733.33,1723,0,1723
805,TSLA  ,2023-02-10,2023-03-17,741.67,754,0,754
806,TSLA  ,2023-02-10,2023-03-17,750.0,754,0,754
807,TSLA  ,2023-02-10,2023-03-17,758.33,1235,0,1235
808,TSLA  ,2023-02-10,2023-03-17,766.67,1260,0,1260
809,TSLA  ,2023-02-10,2023-03-17,775.0,829,0,829
810,TSLA  ,2023-02-10,2023-03-17,783.33,1306,0,1306
811,TSLA  ,2023-02-10,2023-03-17,791.67,1447,0,1447
812,TSLA  ,2023-02-10,2023-03-17,800.0,5373,0,5373
813,TSLA  ,2023-02-10,2023-03-17,808.33,1842,0,1842
814,TSLA  ,2023-02-10,2023-03-17,816.67,2568,0,2568
815,TSLA  ,2023-02-10,2023-03-17,825.0,59770,0,59770
816,TSLA  ,2023-02-10,2023-03-24,20.0,6,122,128
817,TSLA  ,2023-02-10,2023-03-24,30.0,0,0,0
818,TSLA  ,2023-02-10,2023-03-24,40.0,0,0,0
819,TSLA  ,2023-02-10,2023-03-24,50.0,11,1543,1554
820,TSLA  ,2023-02-10,2023-03-24,55.0,3,0,3
821,TSLA  ,2023-02-10,2023-03-24,60.0,0,13,13
822,TSLA  ,2023-02-10,2023-03-24,65.0,0,0,0
823,TSLA  ,2023-02-10,2023-03-24,70.0,0,6,6
824,TSLA  ,2023-02-10,2023-03-24,75.0,0,4,4
825,TSLA  ,2023-02-10,2023-03-24,80.0,0,30,30
826,TSLA  ,2023-02-10,2023-03-24,85.0,1,22,23
827,TSLA  ,2023-02-10,2023-03-24,90.0,0,23,23
828,TSLA  ,2023-02-10,2023-03-24,95.0,0,22,22
829,TSLA  ,2023-02-10,2023-03-24,100.0,11,148,159
830,TSLA  ,2023-02-10,2023-03-24,105.0,10,86,96
831,TSLA  ,2023-02-10,2023-03-24,110.0,6,57,63
832,TSLA  ,2023-02-10,2023-03-24,115.0,1,42,43
833,TSLA  ,2023-02-10,2023-03-24,120.0,1,189,190
834,TSLA  ,2023-02-10,2023-03-24,125.0,5,120,125
835,TSLA  ,2023-02-10,2023-03-24,130.0,131,283,414
836,TSLA  ,2023-02-10,2023-03-24,135.0,16,99,115
837,TSLA  ,2023-02-10,2023-03-24,140.0,25,350,375
838,TSLA  ,2023-02-10,2023-03-24,145.0,53,172,225
839,TSLA  ,2023-02-10,2023-03-24,146.0,7,12,19
840,TSLA  ,2023-02-10,2023-03-24,147.0,74,16,90
841,TSLA  ,2023-02-10,2023-03-24,148.0,58,68,126
842,TSLA  ,2023-02-10,2023-03-24,149.0,59,63,122
843,TSLA  ,2023-02-10,2023-03-24,150.0,52,632,684
844,TSLA  ,2023-02-10,2023-03-24,152.5,1,34,35
845,TSLA  ,2023-02-10,2023-03-24,155.0,437,439,876
846,TSLA  ,2023-02-10,2023-03-24,157.5,31,432,463
847,TSLA  ,2023-02-10,2023-03-24,160.0,112,348,460
848,TSLA  ,2023-02-10,2023-03-24,162.5,16,60,76
849,TSLA  ,2023-02-10,2023-03-24,165.0,59,432,491
850,TSLA  ,2023-02-10,2023-03-24,167.5,20,470,490
851,TSLA  ,2023-02-10,2023-03-24,170.0,162,486,648
852,TSLA  ,2023-02-10,2023-03-24,172.5,27,142,169
853,TSLA  ,2023-02-10,2023-03-24,175.0,125,336,461
854,TSLA  ,2023-02-10,2023-03-24,177.5,25,446,471
855,TSLA  ,2023-02-10,2023-03-24,180.0,194,610,804
856,TSLA  ,2023-02-10,2023-03-24,182.5,3,114,117
857,TSLA  ,2023-02-10,2023-03-24,185.0,89,200,289
858,TSLA  ,2023-02-10,2023-03-24,187.5,114,38,152
859,TSLA  ,2023-02-10,2023-03-24,190.0,323,611,934
860,TSLA  ,2023-02-10,2023-03-24,192.5,55,76,131
861,TSLA  ,2023-02-10,2023-03-24,195.0,262,169,431
862,TSLA  ,2023-02-10,2023-03-24,197.5,157,56,213
863,TSLA  ,2023-02-10,2023-03-24,200.0,1775,1592,3367
864,TSLA  ,2023-02-10,2023-03-24,202.5,130,74,204
865,TSLA  ,2023-02-10,2023-03-24,205.0,1073,88,1161
866,TSLA  ,2023-02-10,2023-03-24,207.5,77,93,170
867,TSLA  ,2023-02-10,2023-03-24,210.0,2503,173,2676
868,TSLA  ,2023-02-10,2023-03-24,212.5,117,24,141
869,TSLA  ,2023-02-10,2023-03-24,215.0,388,19,407
870,TSLA  ,2023-02-10,2023-03-24,217.5,99,37,136
871,TSLA  ,2023-02-10,2023-03-24,220.0,1002,815,1817
872,TSLA  ,2023-02-10,2023-03-24,222.5,176,12,188
873,TSLA  ,2023-02-10,2023-03-24,225.0,199,108,307
874,TSLA  ,2023-02-10,2023-03-24,230.0,452,126,578
875,TSLA  ,2023-02-10,2023-03-24,235.0,257,64,321
876,TSLA  ,2023-02-10,2023-03-24,240.0,174,135,309
877,TSLA  ,2023-02-10,2023-03-24,245.0,514,18,532
878,TSLA  ,2023-02-10,2023-03-24,250.0,666,36,702
879,TSLA  ,2023-02-10,2023-03-24,255.0,98,14,112
880,TSLA  ,2023-02-10,2023-03-24,260.0,302,1,303
881,TSLA  ,2023-02-10,2023-03-24,265.0,58,1,59
882,TSLA  ,2023-02-10,2023-03-24,270.0,72,1,73
883,TSLA  ,2023-02-10,2023-03-24,275.0,161,2,163
884,TSLA  ,2023-02-10,2023-03-24,280.0,277,0,277
885,TSLA  ,2023-02-10,2023-03-24,285.0,66,0,66
886,TSLA  ,2023-02-10,2023-03-24,290.0,190,0,190
887,TSLA  ,2023-02-10,2023-03-24,300.0,487,0,487
888,TSLA  ,2023-02-10,2023-03-24,310.0,113,0,113
889,TSLA  ,2023-02-10,2023-03-24,320.0,153,0,153
890,TSLA  ,2023-02-10,2023-03-24,330.0,13,0,13
891,TSLA  ,2023-02-10,2023-03-24,340.0,256,0,256
892,TSLA  ,2023-02-10,2023-03-24,350.0,136,0,136
893,TSLA  ,2023-02-10,2023-03-24,360.0,255,0,255
894,TSLA  ,2023-02-10,2023-03-31,100.0,1,12,13
895,TSLA  ,2023-02-10,2023-03-31,105.0,0,117,117
896,TSLA  ,2023-02-10,2023-03-31,110.0,0,2,2
897,TSLA  ,2023-02-10,2023-03-31,115.0,0,3,3
898,TSLA  ,2023-02-10,2023-03-31,120.0,0,1,1
899,TSLA  ,2023-02-10,2023-03-31,125.0,0,5,5
900,TSLA  ,2023-02-10,2023-03-31,130.0,0,3,3
901,TSLA  ,2023-02-10,2023-03-31,135.0,0,4,4
902,TSLA  ,2023-02-10,2023-03-31,140.0,1,10,11
903,TSLA  ,2023-02-10,2023-03-31,145.0,14,7,21
904,TSLA  ,2023-02-10,2023-03-31,150.0,54,74,128
905,TSLA  ,2023-02-10,2023-03-31,155.0,71,8,79
906,TSLA  ,2023-02-10,2023-03-31,160.0,14,14,28
907,TSLA  ,2023-02-10,2023-03-31,165.0,15,63,78
908,TSLA  ,2023-02-10,2023-03-31,170.0,0,19,19
909,TSLA  ,2023-02-10,2023-03-31,172.5,0,42,42
910,TSLA  ,2023-02-10,2023-03-31,175.0,5,12,17
911,TSLA  ,2023-02-10,2023-03-31,177.5,5,2,7
912,TSLA  ,2023-02-10,2023-03-31,180.0,10,39,49
913,TSLA  ,2023-02-10,2023-03-31,182.5,0,4,4
914,TSLA  ,2023-02-10,2023-03-31,185.0,27,3,30
915,TSLA  ,2023-02-10,2023-03-31,187.5,0,1,1
916,TSLA  ,2023-02-10,2023-03-31,190.0,10,30,40
917,TSLA  ,2023-02-10,2023-03-31,192.5,0,2,2
918,TSLA  ,2023-02-10,2023-03-31,195.0,7,4,11
919,TSLA  ,2023-02-10,2023-03-31,197.5,2,2,4
920,TSLA  ,2023-02-10,2023-03-31,200.0,41,47,88
921,TSLA  ,2023-02-10,2023-03-31,202.5,13,22,35
922,TSLA  ,2023-02-10,2023-03-31,205.0,14,55,69
923,TSLA  ,2023-02-10,2023-03-31,207.5,22,19,41
924,TSLA  ,2023-02-10,2023-03-31,210.0,109,44,153
925,TSLA  ,2023-02-10,2023-03-31,212.5,47,13,60
926,TSLA  ,2023-02-10,2023-03-31,215.0,77,11,88
927,TSLA  ,2023-02-10,2023-03-31,220.0,214,4,218
928,TSLA  ,2023-02-10,2023-03-31,225.0,17,2,19
929,TSLA  ,2023-02-10,2023-03-31,230.0,49,1,50
930,TSLA  ,2023-02-10,2023-03-31,235.0,13,0,13
931,TSLA  ,2023-02-10,2023-03-31,240.0,27,1,28
932,TSLA  ,2023-02-10,2023-03-31,245.0,11,1,12
933,TSLA  ,2023-02-10,2023-03-31,250.0,50,0,50
934,TSLA  ,2023-02-10,2023-03-31,255.0,6,0,6
935,TSLA  ,2023-02-10,2023-03-31,260.0,34,21,55
936,TSLA  ,2023-02-10,2023-03-31,265.0,1,0,1
937,TSLA  ,2023-02-10,2023-03-31,270.0,6,1,7
938,TSLA  ,2023-02-10,2023-03-31,275.0,25,0,25
939,TSLA  ,2023-02-10,2023-03-31,280.0,20,1,21
940,TSLA  ,2023-02-10,2023-03-31,285.0,26,0,26
941,TSLA  ,2023-02-10,2023-03-31,290.0,3,0,3
942,TSLA  ,2023-02-10,2023-03-31,295.0,0,0,0
943,TSLA  ,2023-02-10,2023-03-31,300.0,22,0,22
944,TSLA  ,2023-02-10,2023-04-21,5.0,14,101,115
945,TSLA  ,2023-02-10,2023-04-21,10.0,0,8,8
946,TSLA  ,2023-02-10,2023-04-21,15.0,0,41,41
947,TSLA  ,2023-02-10,2023-04-21,20.0,4,320,324
948,TSLA  ,2023-02-10,2023-04-21,25.0,8,2484,2492
949,TSLA  ,2023-02-10,2023-04-21,30.0,0,2003,2003
950,TSLA  ,2023-02-10,2023-04-21,35.0,5,436,441
951,TSLA  ,2023-02-10,2023-04-21,40.0,6,507,513
952,TSLA  ,2023-02-10,2023-04-21,45.0,2,790,792
953,TSLA  ,2023-02-10,2023-04-21,50.0,128,5245,5373
954,TSLA  ,2023-02-10,2023-04-21,55.0,15,2836,2851
955,TSLA  ,2023-02-10,2023-04-21,60.0,19,1999,2018
956,TSLA  ,2023-02-10,2023-04-21,65.0,65,5104,5169
957,TSLA  ,2023-02-10,2023-04-21,70.0,65,4409,4474
958,TSLA  ,2023-02-10,2023-04-21,75.0,124,13190,13314
959,TSLA  ,2023-02-10,2023-04-21,80.0,25226,4520,29746
960,TSLA  ,2023-02-10,2023-04-21,85.0,90,3278,3368
961,TSLA  ,2023-02-10,2023-04-21,90.0,266,2303,2569
962,TSLA  ,2023-02-10,2023-04-21,95.0,151,6155,6306
963,TSLA  ,2023-02-10,2023-04-21,100.0,1570,24215,25785
964,TSLA  ,2023-02-10,2023-04-21,105.0,372,2499,2871
965,TSLA  ,2023-02-10,2023-04-21,108.33,900,4917,5817
966,TSLA  ,2023-02-10,2023-04-21,110.0,1083,5108,6191
967,TSLA  ,2023-02-10,2023-04-21,115.0,1435,3353,4788
968,TSLA  ,2023-02-10,2023-04-21,116.67,2541,9633,12174
969,TSLA  ,2023-02-10,2023-04-21,120.0,7448,6962,14410
970,TSLA  ,2023-02-10,2023-04-21,125.0,11126,12531,23657
971,TSLA  ,2023-02-10,2023-04-21,130.0,1819,6332,8151
972,TSLA  ,2023-02-10,2023-04-21,133.33,4578,3713,8291
973,TSLA  ,2023-02-10,2023-04-21,135.0,1861,2346,4207
974,TSLA  ,2023-02-10,2023-04-21,140.0,2949,7343,10292
975,TSLA  ,2023-02-10,2023-04-21,141.67,6325,3679,10004
976,TSLA  ,2023-02-10,2023-04-21,145.0,1902,2059,3961
977,TSLA  ,2023-02-10,2023-04-21,150.0,7199,17705,24904
978,TSLA  ,2023-02-10,2023-04-21,155.0,1285,1053,2338
979,TSLA  ,2023-02-10,2023-04-21,158.33,2991,3960,6951
980,TSLA  ,2023-02-10,2023-04-21,160.0,2795,4128,6923
981,TSLA  ,2023-02-10,2023-04-21,165.0,1494,1155,2649
982,TSLA  ,2023-02-10,2023-04-21,166.67,2670,5472,8142
983,TSLA  ,2023-02-10,2023-04-21,170.0,2081,2993,5074
984,TSLA  ,2023-02-10,2023-04-21,175.0,10682,7387,18069
985,TSLA  ,2023-02-10,2023-04-21,180.0,2859,4380,7239
986,TSLA  ,2023-02-10,2023-04-21,183.33,2665,4127,6792
987,TSLA  ,2023-02-10,2023-04-21,185.0,1791,3999,5790
988,TSLA  ,2023-02-10,2023-04-21,190.0,1884,3279,5163
989,TSLA  ,2023-02-10,2023-04-21,191.67,3147,14035,17182
990,TSLA  ,2023-02-10,2023-04-21,195.0,2897,1853,4750
991,TSLA  ,2023-02-10,2023-04-21,200.0,11649,8732,20381
992,TSLA  ,2023-02-10,2023-04-21,205.0,4348,1864,6212
993,TSLA  ,2023-02-10,2023-04-21,208.33,6458,2790,9248
994,TSLA  ,2023-02-10,2023-04-21,210.0,4760,2128,6888
995,TSLA  ,2023-02-10,2023-04-21,215.0,2059,903,2962
996,TSLA  ,2023-02-10,2023-04-21,216.67,1780,2320,4100
997,TSLA  ,2023-02-10,2023-04-21,220.0,6944,706,7650
998,TSLA  ,2023-02-10,2023-04-21,225.0,8603,1999,10602
999,TSLA  ,2023-02-10,2023-04-21,230.0,1599,465,2064
1000,TSLA  ,2023-02-10,2023-04-21,233.33,1582,664,2246
1001,TSLA  ,2023-02-10,2023-04-21,235.0,999,271,1270
1002,TSLA  ,2023-02-10,2023-04-21,240.0,4365,520,4885
1003,TSLA  ,2023-02-10,2023-04-21,241.67,959,71,1030
1004,TSLA  ,2023-02-10,2023-04-21,243.33,1217,62,1279
1005,TSLA  ,2023-02-10,2023-04-21,245.0,1515,146,1661
1006,TSLA  ,2023-02-10,2023-04-21,246.67,1148,28,1176
1007,TSLA  ,2023-02-10,2023-04-21,248.33,761,330,1091
1008,TSLA  ,2023-02-10,2023-04-21,250.0,8705,818,9523
1009,TSLA  ,2023-02-10,2023-04-21,251.67,1591,61,1652
1010,TSLA  ,2023-02-10,2023-04-21,253.33,439,37,476
1011,TSLA  ,2023-02-10,2023-04-21,255.0,1365,34,1399
1012,TSLA  ,2023-02-10,2023-04-21,258.33,879,894,1773
1013,TSLA  ,2023-02-10,2023-04-21,260.0,1799,6,1805
1014,TSLA  ,2023-02-10,2023-04-21,265.0,247,1,248
1015,TSLA  ,2023-02-10,2023-04-21,266.67,1445,194,1639
1016,TSLA  ,2023-02-10,2023-04-21,270.0,643,2,645
1017,TSLA  ,2023-02-10,2023-04-21,275.0,2133,90,2223
1018,TSLA  ,2023-02-10,2023-04-21,280.0,1409,206,1615
1019,TSLA  ,2023-02-10,2023-04-21,283.33,1385,214,1599
1020,TSLA  ,2023-02-10,2023-04-21,285.0,159,15,174
1021,TSLA  ,2023-02-10,2023-04-21,290.0,84,0,84
1022,TSLA  ,2023-02-10,2023-04-21,291.67,3052,30,3082
1023,TSLA  ,2023-02-10,2023-04-21,300.0,8068,38,8106
1024,TSLA  ,2023-02-10,2023-04-21,308.33,4413,26,4439
1025,TSLA  ,2023-02-10,2023-04-21,316.67,21923,2,21925
1026,TSLA  ,2023-02-10,2023-04-21,325.0,2723,0,2723
1027,TSLA  ,2023-02-10,2023-04-21,333.33,4498,0,4498
1028,TSLA  ,2023-02-10,2023-04-21,341.67,755,8,763
1029,TSLA  ,2023-02-10,2023-04-21,350.0,3080,0,3080
1030,TSLA  ,2023-02-10,2023-04-21,358.33,937,0,937
1031,TSLA  ,2023-02-10,2023-04-21,366.67,1076,4,1080
1032,TSLA  ,2023-02-10,2023-04-21,375.0,1063,11,1074
1033,TSLA  ,2023-02-10,2023-04-21,383.33,668,3,671
1034,TSLA  ,2023-02-10,2023-04-21,391.67,418,0,418
1035,TSLA  ,2023-02-10,2023-04-21,400.0,2598,0,2598
1036,TSLA  ,2023-02-10,2023-04-21,408.33,382,0,382
1037,TSLA  ,2023-02-10,2023-04-21,416.67,1135,0,1135
1038,TSLA  ,2023-02-10,2023-04-21,425.0,4945,0,4945
1039,TSLA  ,2023-02-10,2023-04-21,433.33,12429,0,12429
1040,TSLA  ,2023-02-10,2023-04-21,441.67,724,0,724
1041,TSLA  ,2023-02-10,2023-04-21,450.0,937,0,937
1042,TSLA  ,2023-02-10,2023-04-21,458.33,3202,0,3202
1043,TSLA  ,2023-02-10,2023-04-21,466.67,433,0,433
1044,TSLA  ,2023-02-10,2023-04-21,475.0,1667,0,1667
1045,TSLA  ,2023-02-10,2023-04-21,483.33,821,0,821
1046,TSLA  ,2023-02-10,2023-04-21,491.67,176,0,176
1047,TSLA  ,2023-02-10,2023-04-21,500.0,3554,0,3554
1048,TSLA  ,2023-02-10,2023-04-21,508.33,884,0,884
1049,TSLA  ,2023-02-10,2023-04-21,516.67,506,0,506
1050,TSLA  ,2023-02-10,2023-04-21,525.0,436,0,436
1051,TSLA  ,2023-02-10,2023-04-21,533.33,486,0,486
1052,TSLA  ,2023-02-10,2023-04-21,541.67,548,0,548
1053,TSLA  ,2023-02-10,2023-04-21,550.0,11146,0,11146
1054,TSLA  ,2023-02-10,2023-04-21,558.33,178,0,178
1055,TSLA  ,2023-02-10,2023-04-21,566.67,560,0,560
1056,TSLA  ,2023-02-10,2023-04-21,575.0,1606,0,1606
1057,TSLA  ,2023-02-10,2023-04-21,583.33,972,1,973
1058,TSLA  ,2023-02-10,2023-04-21,600.0,19528,0,19528
1059,TSLA  ,2023-02-10,2023-05-19,50.0,62,2815,2877
1060,TSLA  ,2023-02-10,2023-05-19,55.0,51,597,648
1061,TSLA  ,2023-02-10,2023-05-19,60.0,159,950,1109
1062,TSLA  ,2023-02-10,2023-05-19,65.0,65,437,502
1063,TSLA  ,2023-02-10,2023-05-19,70.0,178,1446,1624
1064,TSLA  ,2023-02-10,2023-05-19,75.0,135,1674,1809
1065,TSLA  ,2023-02-10,2023-05-19,80.0,85,1609,1694
1066,TSLA  ,2023-02-10,2023-05-19,85.0,63,1765,1828
1067,TSLA  ,2023-02-10,2023-05-19,90.0,243,2779,3022
1068,TSLA  ,2023-02-10,2023-05-19,95.0,132,1636,1768
1069,TSLA  ,2023-02-10,2023-05-19,100.0,1078,24336,25414
1070,TSLA  ,2023-02-10,2023-05-19,105.0,275,6125,6400
1071,TSLA  ,2023-02-10,2023-05-19,110.0,15971,7213,23184
1072,TSLA  ,2023-02-10,2023-05-19,115.0,1343,1917,3260
1073,TSLA  ,2023-02-10,2023-05-19,120.0,2125,7865,9990
1074,TSLA  ,2023-02-10,2023-05-19,125.0,3620,2503,6123
1075,TSLA  ,2023-02-10,2023-05-19,130.0,2704,4922,7626
1076,TSLA  ,2023-02-10,2023-05-19,135.0,2007,2137,4144
1077,TSLA  ,2023-02-10,2023-05-19,140.0,1957,11286,13243
1078,TSLA  ,2023-02-10,2023-05-19,145.0,2359,2375,4734
1079,TSLA  ,2023-02-10,2023-05-19,150.0,3882,4926,8808
1080,TSLA  ,2023-02-10,2023-05-19,155.0,1468,1604,3072
1081,TSLA  ,2023-02-10,2023-05-19,160.0,3121,4616,7737
1082,TSLA  ,2023-02-10,2023-05-19,165.0,1370,1344,2714
1083,TSLA  ,2023-02-10,2023-05-19,170.0,2758,4723,7481
1084,TSLA  ,2023-02-10,2023-05-19,175.0,2025,1779,3804
1085,TSLA  ,2023-02-10,2023-05-19,180.0,8194,6178,14372
1086,TSLA  ,2023-02-10,2023-05-19,185.0,1724,1476,3200
1087,TSLA  ,2023-02-10,2023-05-19,190.0,2622,3249,5871
1088,TSLA  ,2023-02-10,2023-05-19,195.0,2475,2127,4602
1089,TSLA  ,2023-02-10,2023-05-19,200.0,7443,2303,9746
1090,TSLA  ,2023-02-10,2023-05-19,205.0,4241,1265,5506
1091,TSLA  ,2023-02-10,2023-05-19,210.0,10617,779,11396
1092,TSLA  ,2023-02-10,2023-05-19,215.0,2906,1073,3979
1093,TSLA  ,2023-02-10,2023-05-19,220.0,2572,990,3562
1094,TSLA  ,2023-02-10,2023-05-19,225.0,1599,343,1942
1095,TSLA  ,2023-02-10,2023-05-19,230.0,1975,386,2361
1096,TSLA  ,2023-02-10,2023-05-19,235.0,1041,128,1169
1097,TSLA  ,2023-02-10,2023-05-19,240.0,2096,84,2180
1098,TSLA  ,2023-02-10,2023-05-19,245.0,428,133,561
1099,TSLA  ,2023-02-10,2023-05-19,250.0,2469,38,2507
1100,TSLA  ,2023-02-10,2023-05-19,260.0,737,117,854
1101,TSLA  ,2023-02-10,2023-05-19,270.0,1933,136,2069
1102,TSLA  ,2023-02-10,2023-05-19,280.0,645,22,667
1103,TSLA  ,2023-02-10,2023-05-19,290.0,401,367,768
1104,TSLA  ,2023-02-10,2023-05-19,300.0,1256,545,1801
1105,TSLA  ,2023-02-10,2023-05-19,310.0,335,5255,5590
1106,TSLA  ,2023-02-10,2023-05-19,320.0,727,1175,1902
1107,TSLA  ,2023-02-10,2023-05-19,330.0,439,26,465
1108,TSLA  ,2023-02-10,2023-05-19,340.0,382,1,383
1109,TSLA  ,2023-02-10,2023-05-19,350.0,291,5,296
1110,TSLA  ,2023-02-10,2023-05-19,360.0,704,1,705
1111,TSLA  ,2023-02-10,2023-05-19,370.0,83,0,83
1112,TSLA  ,2023-02-10,2023-05-19,380.0,53,0,53
1113,TSLA  ,2023-02-10,2023-05-19,390.0,703,1,704
1114,TSLA  ,2023-02-10,2023-06-16,1.67,106,41907,42013
1115,TSLA  ,2023-02-10,2023-06-16,3.33,399,5010,5409
1116,TSLA  ,2023-02-10,2023-06-16,5.0,108,1684,1792
1117,TSLA  ,2023-02-10,2023-06-16,6.67,75,1309,1384
1118,TSLA  ,2023-02-10,2023-06-16,8.33,425,2371,2796
1119,TSLA  ,2023-02-10,2023-06-16,10.0,3234,3724,6958
1120,TSLA  ,2023-02-10,2023-06-16,11.67,155,8573,8728
1121,TSLA  ,2023-02-10,2023-06-16,13.33,1234,5642,6876
1122,TSLA  ,2023-02-10,2023-06-16,15.0,168,4102,4270
1123,TSLA  ,2023-02-10,2023-06-16,16.67,489,9827,10316
1124,TSLA  ,2023-02-10,2023-06-16,18.33,88,4925,5013
1125,TSLA  ,2023-02-10,2023-06-16,33.33,862,16605,17467
1126,TSLA  ,2023-02-10,2023-06-16,50.0,1108,17516,18624
1127,TSLA  ,2023-02-10,2023-06-16,55.0,31,7345,7376
1128,TSLA  ,2023-02-10,2023-06-16,60.0,15,2291,2306
1129,TSLA  ,2023-02-10,2023-06-16,65.0,4,623,627
1130,TSLA  ,2023-02-10,2023-06-16,66.67,1036,14253,15289
1131,TSLA  ,2023-02-10,2023-06-16,70.0,51,4051,4102
1132,TSLA  ,2023-02-10,2023-06-16,75.0,84,6656,6740
1133,TSLA  ,2023-02-10,2023-06-16,80.0,184,3751,3935
1134,TSLA  ,2023-02-10,2023-06-16,83.33,714,5063,5777
1135,TSLA  ,2023-02-10,2023-06-16,85.0,86,4265,4351
1136,TSLA  ,2023-02-10,2023-06-16,90.0,202,3370,3572
1137,TSLA  ,2023-02-10,2023-06-16,95.0,173,1610,1783
1138,TSLA  ,2023-02-10,2023-06-16,100.0,3478,27661,31139
1139,TSLA  ,2023-02-10,2023-06-16,105.0,365,5327,5692
1140,TSLA  ,2023-02-10,2023-06-16,110.0,1170,5628,6798
1141,TSLA  ,2023-02-10,2023-06-16,115.0,593,2708,3301
1142,TSLA  ,2023-02-10,2023-06-16,116.67,1786,5224,7010
1143,TSLA  ,2023-02-10,2023-06-16,120.0,3438,8835,12273
1144,TSLA  ,2023-02-10,2023-06-16,123.33,456,1128,1584
1145,TSLA  ,2023-02-10,2023-06-16,125.0,4098,7124,11222
1146,TSLA  ,2023-02-10,2023-06-16,126.67,863,1308,2171
1147,TSLA  ,2023-02-10,2023-06-16,130.0,3688,8556,12244
1148,TSLA  ,2023-02-10,2023-06-16,133.33,2532,8960,11492
1149,TSLA  ,2023-02-10,2023-06-16,135.0,2767,2716,5483
1150,TSLA  ,2023-02-10,2023-06-16,136.67,1079,2570,3649
1151,TSLA  ,2023-02-10,2023-06-16,140.0,7793,6261,14054
1152,TSLA  ,2023-02-10,2023-06-16,143.33,1232,3384,4616
1153,TSLA  ,2023-02-10,2023-06-16,145.0,2164,3422,5586
1154,TSLA  ,2023-02-10,2023-06-16,146.67,1591,1921,3512
1155,TSLA  ,2023-02-10,2023-06-16,150.0,12854,13757,26611
1156,TSLA  ,2023-02-10,2023-06-16,153.33,2469,3489,5958
1157,TSLA  ,2023-02-10,2023-06-16,155.0,1237,3096,4333
1158,TSLA  ,2023-02-10,2023-06-16,156.67,1683,755,2438
1159,TSLA  ,2023-02-10,2023-06-16,160.0,6611,7126,13737
1160,TSLA  ,2023-02-10,2023-06-16,163.33,975,1178,2153
1161,TSLA  ,2023-02-10,2023-06-16,165.0,1841,2819,4660
1162,TSLA  ,2023-02-10,2023-06-16,166.67,3674,13101,16775
1163,TSLA  ,2023-02-10,2023-06-16,170.0,2774,4231,7005
1164,TSLA  ,2023-02-10,2023-06-16,173.33,1457,6250,7707
1165,TSLA  ,2023-02-10,2023-06-16,175.0,2784,4555,7339
1166,TSLA  ,2023-02-10,2023-06-16,180.0,8346,7967,16313
1167,TSLA  ,2023-02-10,2023-06-16,183.33,10021,10216,20237
1168,TSLA  ,2023-02-10,2023-06-16,185.0,8076,6802,14878
1169,TSLA  ,2023-02-10,2023-06-16,186.67,917,1878,2795
1170,TSLA  ,2023-02-10,2023-06-16,190.0,5795,4652,10447
1171,TSLA  ,2023-02-10,2023-06-16,193.33,1910,7838,9748
1172,TSLA  ,2023-02-10,2023-06-16,195.0,2564,2548,5112
1173,TSLA  ,2023-02-10,2023-06-16,200.0,24583,21462,46045
1174,TSLA  ,2023-02-10,2023-06-16,205.0,2686,1095,3781
1175,TSLA  ,2023-02-10,2023-06-16,206.67,2158,3365,5523
1176,TSLA  ,2023-02-10,2023-06-16,210.0,4655,1321,5976
1177,TSLA  ,2023-02-10,2023-06-16,213.33,1710,2624,4334
1178,TSLA  ,2023-02-10,2023-06-16,215.0,3342,1162,4504
1179,TSLA  ,2023-02-10,2023-06-16,216.67,6709,6140,12849
1180,TSLA  ,2023-02-10,2023-06-16,220.0,7694,6950,14644
1181,TSLA  ,2023-02-10,2023-06-16,225.0,1807,1200,3007
1182,TSLA  ,2023-02-10,2023-06-16,226.67,1372,1920,3292
1183,TSLA  ,2023-02-10,2023-06-16,230.0,6756,2973,9729
1184,TSLA  ,2023-02-10,2023-06-16,233.33,10630,7536,18166
1185,TSLA  ,2023-02-10,2023-06-16,235.0,2539,692,3231
1186,TSLA  ,2023-02-10,2023-06-16,240.0,6480,3052,9532
1187,TSLA  ,2023-02-10,2023-06-16,243.33,1303,1692,2995
1188,TSLA  ,2023-02-10,2023-06-16,245.0,1842,64,1906
1189,TSLA  ,2023-02-10,2023-06-16,246.67,2999,90,3089
1190,TSLA  ,2023-02-10,2023-06-16,250.0,14864,3411,18275
1191,TSLA  ,2023-02-10,2023-06-16,253.33,1335,195,1530
1192,TSLA  ,2023-02-10,2023-06-16,255.0,1180,73,1253
1193,TSLA  ,2023-02-10,2023-06-16,260.0,5101,79,5180
1194,TSLA  ,2023-02-10,2023-06-16,265.0,1977,56,2033
1195,TSLA  ,2023-02-10,2023-06-16,266.67,7256,409,7665
1196,TSLA  ,2023-02-10,2023-06-16,270.0,1388,7,1395
1197,TSLA  ,2023-02-10,2023-06-16,273.33,1335,1051,2386
1198,TSLA  ,2023-02-10,2023-06-16,275.0,2281,5,2286
1199,TSLA  ,2023-02-10,2023-06-16,280.0,3874,58,3932
1200,TSLA  ,2023-02-10,2023-06-16,283.33,4583,51,4634
1201,TSLA  ,2023-02-10,2023-06-16,285.0,985,2,987
1202,TSLA  ,2023-02-10,2023-06-16,286.67,766,30,796
1203,TSLA  ,2023-02-10,2023-06-16,290.0,722,827,1549
1204,TSLA  ,2023-02-10,2023-06-16,293.33,1612,62,1674
1205,TSLA  ,2023-02-10,2023-06-16,295.0,311,258,569
1206,TSLA  ,2023-02-10,2023-06-16,300.0,17752,116,17868
1207,TSLA  ,2023-02-10,2023-06-16,305.0,3114,5,3119
1208,TSLA  ,2023-02-10,2023-06-16,306.67,1470,31,1501
1209,TSLA  ,2023-02-10,2023-06-16,310.0,1655,46,1701
1210,TSLA  ,2023-02-10,2023-06-16,313.33,505,36,541
1211,TSLA  ,2023-02-10,2023-06-16,315.0,331,82,413
1212,TSLA  ,2023-02-10,2023-06-16,316.67,6691,241,6932
1213,TSLA  ,2023-02-10,2023-06-16,320.0,2468,3,2471
1214,TSLA  ,2023-02-10,2023-06-16,326.67,9704,6,9710
1215,TSLA  ,2023-02-10,2023-06-16,330.0,1154,50,1204
1216,TSLA  ,2023-02-10,2023-06-16,333.33,33330,231,33561
1217,TSLA  ,2023-02-10,2023-06-16,340.0,1590,3,1593
1218,TSLA  ,2023-02-10,2023-06-16,346.67,1306,0,1306
1219,TSLA  ,2023-02-10,2023-06-16,350.0,8440,334,8774
1220,TSLA  ,2023-02-10,2023-06-16,353.33,847,0,847
1221,TSLA  ,2023-02-10,2023-06-16,360.0,2059,1,2060
1222,TSLA  ,2023-02-10,2023-06-16,366.67,10784,450,11234
1223,TSLA  ,2023-02-10,2023-06-16,370.0,821,0,821
1224,TSLA  ,2023-02-10,2023-06-16,383.33,10978,0,10978
1225,TSLA  ,2023-02-10,2023-06-16,400.0,18812,904,19716
1226,TSLA  ,2023-02-10,2023-06-16,416.67,3621,1,3622
1227,TSLA  ,2023-02-10,2023-06-16,433.33,9668,0,9668
1228,TSLA  ,2023-02-10,2023-06-16,450.0,8403,0,8403
1229,TSLA  ,2023-02-10,2023-06-16,466.67,20830,0,20830
1230,TSLA  ,2023-02-10,2023-06-16,483.33,8219,0,8219
1231,TSLA  ,2023-02-10,2023-06-16,500.0,20905,0,20905
1232,TSLA  ,2023-02-10,2023-06-16,516.67,2709,0,2709
1233,TSLA  ,2023-02-10,2023-06-16,533.33,4880,0,4880
1234,TSLA  ,2023-02-10,2023-06-16,550.0,6227,0,6227
1235,TSLA  ,2023-02-10,2023-06-16,558.33,1694,0,1694
1236,TSLA  ,2023-02-10,2023-06-16,566.67,1314,0,1314
1237,TSLA  ,2023-02-10,2023-06-16,575.0,698,0,698
1238,TSLA  ,2023-02-10,2023-06-16,583.33,1216,0,1216
1239,TSLA  ,2023-02-10,2023-06-16,591.67,400,0,400
1240,TSLA  ,2023-02-10,2023-06-16,600.0,6550,0,6550
1241,TSLA  ,2023-02-10,2023-06-16,608.33,1140,0,1140
1242,TSLA  ,2023-02-10,2023-06-16,616.67,808,0,808
1243,TSLA  ,2023-02-10,2023-06-16,625.0,2171,0,2171
1244,TSLA  ,2023-02-10,2023-06-16,633.33,5441,0,5441
1245,TSLA  ,2023-02-10,2023-06-16,641.67,436,0,436
1246,TSLA  ,2023-02-10,2023-06-16,650.0,601,0,601
1247,TSLA  ,2023-02-10,2023-06-16,666.67,17979,0,17979
1248,TSLA  ,2023-02-10,2023-06-16,675.0,938,0,938
1249,TSLA  ,2023-02-10,2023-06-16,683.33,604,0,604
1250,TSLA  ,2023-02-10,2023-06-16,691.67,884,0,884
1251,TSLA  ,2023-02-10,2023-06-16,700.0,2662,0,2662
1252,TSLA  ,2023-02-10,2023-06-16,708.33,537,0,537
1253,TSLA  ,2023-02-10,2023-06-16,716.67,715,0,715
1254,TSLA  ,2023-02-10,2023-06-16,725.0,1171,0,1171
1255,TSLA  ,2023-02-10,2023-06-16,733.33,2256,0,2256
1256,TSLA  ,2023-02-10,2023-06-16,741.67,778,0,778
1257,TSLA  ,2023-02-10,2023-06-16,750.0,11807,0,11807
1258,TSLA  ,2023-02-10,2023-06-16,758.33,1292,0,1292
1259,TSLA  ,2023-02-10,2023-06-16,766.67,1267,0,1267
1260,TSLA  ,2023-02-10,2023-06-16,775.0,1148,0,1148
1261,TSLA  ,2023-02-10,2023-06-16,783.33,2176,0,2176
1262,TSLA  ,2023-02-10,2023-06-16,791.67,1838,0,1838
1263,TSLA  ,2023-02-10,2023-06-16,800.0,9664,0,9664
1264,TSLA  ,2023-02-10,2023-06-16,808.33,1307,0,1307
1265,TSLA  ,2023-02-10,2023-06-16,816.67,1823,0,1823
1266,TSLA  ,2023-02-10,2023-06-16,825.0,38759,0,38759
1267,TSLA  ,2023-02-10,2023-07-21,5.0,32,721,753
1268,TSLA  ,2023-02-10,2023-07-21,10.0,5,906,911
1269,TSLA  ,2023-02-10,2023-07-21,15.0,4,379,383
1270,TSLA  ,2023-02-10,2023-07-21,20.0,12,1205,1217
1271,TSLA  ,2023-02-10,2023-07-21,25.0,25,1002,1027
1272,TSLA  ,2023-02-10,2023-07-21,30.0,111,1368,1479
1273,TSLA  ,2023-02-10,2023-07-21,35.0,45,792,837
1274,TSLA  ,2023-02-10,2023-07-21,40.0,21,1137,1158
1275,TSLA  ,2023-02-10,2023-07-21,45.0,38,425,463
1276,TSLA  ,2023-02-10,2023-07-21,50.0,71,5093,5164
1277,TSLA  ,2023-02-10,2023-07-21,55.0,86,1855,1941
1278,TSLA  ,2023-02-10,2023-07-21,60.0,94,3333,3427
1279,TSLA  ,2023-02-10,2023-07-21,65.0,86,393,479
1280,TSLA  ,2023-02-10,2023-07-21,70.0,25,2459,2484
1281,TSLA  ,2023-02-10,2023-07-21,75.0,63,4159,4222
1282,TSLA  ,2023-02-10,2023-07-21,80.0,79,3655,3734
1283,TSLA  ,2023-02-10,2023-07-21,85.0,54,1381,1435
1284,TSLA  ,2023-02-10,2023-07-21,90.0,122,3387,3509
1285,TSLA  ,2023-02-10,2023-07-21,95.0,59,1623,1682
1286,TSLA  ,2023-02-10,2023-07-21,100.0,295,5617,5912
1287,TSLA  ,2023-02-10,2023-07-21,105.0,334,2494,2828
1288,TSLA  ,2023-02-10,2023-07-21,110.0,1116,3024,4140
1289,TSLA  ,2023-02-10,2023-07-21,115.0,468,1015,1483
1290,TSLA  ,2023-02-10,2023-07-21,120.0,1247,4405,5652
1291,TSLA  ,2023-02-10,2023-07-21,125.0,1409,2160,3569
1292,TSLA  ,2023-02-10,2023-07-21,130.0,1505,1731,3236
1293,TSLA  ,2023-02-10,2023-07-21,135.0,1157,2950,4107
1294,TSLA  ,2023-02-10,2023-07-21,140.0,1486,2977,4463
1295,TSLA  ,2023-02-10,2023-07-21,145.0,1057,2200,3257
1296,TSLA  ,2023-02-10,2023-07-21,150.0,3196,3702,6898
1297,TSLA  ,2023-02-10,2023-07-21,155.0,1651,2863,4514
1298,TSLA  ,2023-02-10,2023-07-21,160.0,1668,1327,2995
1299,TSLA  ,2023-02-10,2023-07-21,165.0,657,1392,2049
1300,TSLA  ,2023-02-10,2023-07-21,170.0,1749,2070,3819
1301,TSLA  ,2023-02-10,2023-07-21,175.0,1643,1359,3002
1302,TSLA  ,2023-02-10,2023-07-21,180.0,2069,1683,3752
1303,TSLA  ,2023-02-10,2023-07-21,185.0,3901,12871,16772
1304,TSLA  ,2023-02-10,2023-07-21,190.0,2239,2305,4544
1305,TSLA  ,2023-02-10,2023-07-21,195.0,1358,1951,3309
1306,TSLA  ,2023-02-10,2023-07-21,200.0,5234,2106,7340
1307,TSLA  ,2023-02-10,2023-07-21,205.0,2110,673,2783
1308,TSLA  ,2023-02-10,2023-07-21,210.0,5121,1486,6607
1309,TSLA  ,2023-02-10,2023-07-21,215.0,3713,831,4544
1310,TSLA  ,2023-02-10,2023-07-21,220.0,2918,1547,4465
1311,TSLA  ,2023-02-10,2023-07-21,225.0,2715,1998,4713
1312,TSLA  ,2023-02-10,2023-07-21,230.0,2625,1252,3877
1313,TSLA  ,2023-02-10,2023-07-21,235.0,1045,666,1711
1314,TSLA  ,2023-02-10,2023-07-21,240.0,1264,1740,3004
1315,TSLA  ,2023-02-10,2023-07-21,245.0,772,679,1451
1316,TSLA  ,2023-02-10,2023-07-21,250.0,24445,1578,26023
1317,TSLA  ,2023-02-10,2023-07-21,255.0,821,641,1462
1318,TSLA  ,2023-02-10,2023-07-21,260.0,616,69,685
1319,TSLA  ,2023-02-10,2023-07-21,265.0,266,9,275
1320,TSLA  ,2023-02-10,2023-07-21,270.0,497,126,623
1321,TSLA  ,2023-02-10,2023-07-21,275.0,278,78,356
1322,TSLA  ,2023-02-10,2023-07-21,280.0,1345,146,1491
1323,TSLA  ,2023-02-10,2023-07-21,285.0,963,147,1110
1324,TSLA  ,2023-02-10,2023-07-21,290.0,393,31,424
1325,TSLA  ,2023-02-10,2023-07-21,295.0,320,11,331
1326,TSLA  ,2023-02-10,2023-07-21,300.0,1721,4,1725
1327,TSLA  ,2023-02-10,2023-07-21,305.0,288,5,293
1328,TSLA  ,2023-02-10,2023-07-21,310.0,1346,6,1352
1329,TSLA  ,2023-02-10,2023-07-21,315.0,391,1,392
1330,TSLA  ,2023-02-10,2023-07-21,320.0,570,0,570
1331,TSLA  ,2023-02-10,2023-07-21,325.0,657,0,657
1332,TSLA  ,2023-02-10,2023-07-21,330.0,392,26,418
1333,TSLA  ,2023-02-10,2023-07-21,335.0,157,7,164
1334,TSLA  ,2023-02-10,2023-07-21,340.0,433,16,449
1335,TSLA  ,2023-02-10,2023-07-21,345.0,160,0,160
1336,TSLA  ,2023-02-10,2023-07-21,350.0,663,1,664
1337,TSLA  ,2023-02-10,2023-07-21,355.0,267,1,268
1338,TSLA  ,2023-02-10,2023-07-21,360.0,532,0,532
1339,TSLA  ,2023-02-10,2023-07-21,365.0,878,0,878
1340,TSLA  ,2023-02-10,2023-07-21,370.0,951,0,951
1341,TSLA  ,2023-02-10,2023-07-21,375.0,3174,0,3174
1342,TSLA  ,2023-02-10,2023-07-21,380.0,161,0,161
1343,TSLA  ,2023-02-10,2023-07-21,390.0,334,0,334
1344,TSLA  ,2023-02-10,2023-09-15,1.67,861,20022,20883
1345,TSLA  ,2023-02-10,2023-09-15,3.33,1085,2849,3934
1346,TSLA  ,2023-02-10,2023-09-15,5.0,25,942,967
1347,TSLA  ,2023-02-10,2023-09-15,6.67,29,3366,3395
1348,TSLA  ,2023-02-10,2023-09-15,8.33,32,1178,1210
1349,TSLA  ,2023-02-10,2023-09-15,10.0,26,2175,2201
1350,TSLA  ,2023-02-10,2023-09-15,11.67,49,617,666
1351,TSLA  ,2023-02-10,2023-09-15,13.33,83,230,313
1352,TSLA  ,2023-02-10,2023-09-15,15.0,0,116,116
1353,TSLA  ,2023-02-10,2023-09-15,16.67,143,4190,4333
1354,TSLA  ,2023-02-10,2023-09-15,30.0,0,74,74
1355,TSLA  ,2023-02-10,2023-09-15,33.33,3118,11367,14485
1356,TSLA  ,2023-02-10,2023-09-15,35.0,5,32,37
1357,TSLA  ,2023-02-10,2023-09-15,40.0,3,171,174
1358,TSLA  ,2023-02-10,2023-09-15,45.0,6,49,55
1359,TSLA  ,2023-02-10,2023-09-15,50.0,411,7522,7933
1360,TSLA  ,2023-02-10,2023-09-15,55.0,22,2385,2407
1361,TSLA  ,2023-02-10,2023-09-15,60.0,30,4724,4754
1362,TSLA  ,2023-02-10,2023-09-15,65.0,4,2115,2119
1363,TSLA  ,2023-02-10,2023-09-15,66.67,434,5667,6101
1364,TSLA  ,2023-02-10,2023-09-15,70.0,84,612,696
1365,TSLA  ,2023-02-10,2023-09-15,75.0,26,630,656
1366,TSLA  ,2023-02-10,2023-09-15,80.0,260,801,1061
1367,TSLA  ,2023-02-10,2023-09-15,83.33,407,4460,4867
1368,TSLA  ,2023-02-10,2023-09-15,85.0,50,316,366
1369,TSLA  ,2023-02-10,2023-09-15,90.0,485,2640,3125
1370,TSLA  ,2023-02-10,2023-09-15,95.0,70,2470,2540
1371,TSLA  ,2023-02-10,2023-09-15,100.0,2363,11994,14357
1372,TSLA  ,2023-02-10,2023-09-15,105.0,88,2140,2228
1373,TSLA  ,2023-02-10,2023-09-15,108.33,399,2141,2540
1374,TSLA  ,2023-02-10,2023-09-15,110.0,1243,1485,2728
1375,TSLA  ,2023-02-10,2023-09-15,115.0,181,2715,2896
1376,TSLA  ,2023-02-10,2023-09-15,116.67,569,12236,12805
1377,TSLA  ,2023-02-10,2023-09-15,120.0,779,1891,2670
1378,TSLA  ,2023-02-10,2023-09-15,123.33,543,1349,1892
1379,TSLA  ,2023-02-10,2023-09-15,125.0,1743,7555,9298
1380,TSLA  ,2023-02-10,2023-09-15,126.67,130,1074,1204
1381,TSLA  ,2023-02-10,2023-09-15,130.0,1397,4905,6302
1382,TSLA  ,2023-02-10,2023-09-15,133.33,209,2369,2578
1383,TSLA  ,2023-02-10,2023-09-15,135.0,206,1230,1436
1384,TSLA  ,2023-02-10,2023-09-15,136.67,283,951,1234
1385,TSLA  ,2023-02-10,2023-09-15,140.0,1767,1973,3740
1386,TSLA  ,2023-02-10,2023-09-15,141.67,765,1681,2446
1387,TSLA  ,2023-02-10,2023-09-15,143.33,283,1540,1823
1388,TSLA  ,2023-02-10,2023-09-15,145.0,350,2643,2993
1389,TSLA  ,2023-02-10,2023-09-15,146.67,1372,1076,2448
1390,TSLA  ,2023-02-10,2023-09-15,150.0,33794,9251,43045
1391,TSLA  ,2023-02-10,2023-09-15,153.33,30481,1851,32332
1392,TSLA  ,2023-02-10,2023-09-15,155.0,424,392,816
1393,TSLA  ,2023-02-10,2023-09-15,156.67,394,668,1062
1394,TSLA  ,2023-02-10,2023-09-15,158.33,316,582,898
1395,TSLA  ,2023-02-10,2023-09-15,160.0,3750,6085,9835
1396,TSLA  ,2023-02-10,2023-09-15,163.33,415,1490,1905
1397,TSLA  ,2023-02-10,2023-09-15,165.0,1297,817,2114
1398,TSLA  ,2023-02-10,2023-09-15,166.67,1398,3092,4490
1399,TSLA  ,2023-02-10,2023-09-15,170.0,631,709,1340
1400,TSLA  ,2023-02-10,2023-09-15,173.33,10316,2905,13221
1401,TSLA  ,2023-02-10,2023-09-15,175.0,10953,7605,18558
1402,TSLA  ,2023-02-10,2023-09-15,180.0,33739,6459,40198
1403,TSLA  ,2023-02-10,2023-09-15,183.33,32296,5270,37566
1404,TSLA  ,2023-02-10,2023-09-15,185.0,331,299,630
1405,TSLA  ,2023-02-10,2023-09-15,186.67,525,3365,3890
1406,TSLA  ,2023-02-10,2023-09-15,190.0,750,2737,3487
1407,TSLA  ,2023-02-10,2023-09-15,191.67,491,1151,1642
1408,TSLA  ,2023-02-10,2023-09-15,193.33,895,2813,3708
1409,TSLA  ,2023-02-10,2023-09-15,195.0,331,575,906
1410,TSLA  ,2023-02-10,2023-09-15,200.0,11981,17206,29187
1411,TSLA  ,2023-02-10,2023-09-15,205.0,367,151,518
1412,TSLA  ,2023-02-10,2023-09-15,206.67,992,522,1514
1413,TSLA  ,2023-02-10,2023-09-15,208.33,565,2167,2732
1414,TSLA  ,2023-02-10,2023-09-15,210.0,2431,313,2744
1415,TSLA  ,2023-02-10,2023-09-15,213.33,607,1280,1887
1416,TSLA  ,2023-02-10,2023-09-15,215.0,620,168,788
1417,TSLA  ,2023-02-10,2023-09-15,216.67,2294,4252,6546
1418,TSLA  ,2023-02-10,2023-09-15,220.0,7424,3150,10574
1419,TSLA  ,2023-02-10,2023-09-15,225.0,2501,3318,5819
1420,TSLA  ,2023-02-10,2023-09-15,226.67,1291,1436,2727
1421,TSLA  ,2023-02-10,2023-09-15,230.0,2539,762,3301
1422,TSLA  ,2023-02-10,2023-09-15,233.33,2774,3092,5866
1423,TSLA  ,2023-02-10,2023-09-15,235.0,328,440,768
1424,TSLA  ,2023-02-10,2023-09-15,240.0,1355,2199,3554
1425,TSLA  ,2023-02-10,2023-09-15,241.67,1095,838,1933
1426,TSLA  ,2023-02-10,2023-09-15,245.0,118,208,326
1427,TSLA  ,2023-02-10,2023-09-15,246.67,519,488,1007
1428,TSLA  ,2023-02-10,2023-09-15,250.0,10720,4572,15292
1429,TSLA  ,2023-02-10,2023-09-15,253.33,842,534,1376
1430,TSLA  ,2023-02-10,2023-09-15,255.0,62,12,74
1431,TSLA  ,2023-02-10,2023-09-15,258.33,729,2408,3137
1432,TSLA  ,2023-02-10,2023-09-15,260.0,11804,1419,13223
1433,TSLA  ,2023-02-10,2023-09-15,265.0,273,136,409
1434,TSLA  ,2023-02-10,2023-09-15,266.67,2423,319,2742
1435,TSLA  ,2023-02-10,2023-09-15,270.0,380,162,542
1436,TSLA  ,2023-02-10,2023-09-15,273.33,723,355,1078
1437,TSLA  ,2023-02-10,2023-09-15,275.0,2822,344,3166
1438,TSLA  ,2023-02-10,2023-09-15,280.0,2107,580,2687
1439,TSLA  ,2023-02-10,2023-09-15,283.33,1242,315,1557
1440,TSLA  ,2023-02-10,2023-09-15,286.67,535,96,631
1441,TSLA  ,2023-02-10,2023-09-15,290.0,1272,60,1332
1442,TSLA  ,2023-02-10,2023-09-15,291.67,989,376,1365
1443,TSLA  ,2023-02-10,2023-09-15,293.33,1323,402,1725
1444,TSLA  ,2023-02-10,2023-09-15,300.0,8129,965,9094
1445,TSLA  ,2023-02-10,2023-09-15,306.67,2707,328,3035
1446,TSLA  ,2023-02-10,2023-09-15,308.33,807,335,1142
1447,TSLA  ,2023-02-10,2023-09-15,313.33,832,286,1118
1448,TSLA  ,2023-02-10,2023-09-15,316.67,1571,161,1732
1449,TSLA  ,2023-02-10,2023-09-15,320.0,1744,169,1913
1450,TSLA  ,2023-02-10,2023-09-15,325.0,2747,75,2822
1451,TSLA  ,2023-02-10,2023-09-15,326.67,1092,5,1097
1452,TSLA  ,2023-02-10,2023-09-15,333.33,6444,84,6528
1453,TSLA  ,2023-02-10,2023-09-15,340.0,23338,147,23485
1454,TSLA  ,2023-02-10,2023-09-15,341.67,177,187,364
1455,TSLA  ,2023-02-10,2023-09-15,346.67,549,135,684
1456,TSLA  ,2023-02-10,2023-09-15,350.0,20852,328,21180
1457,TSLA  ,2023-02-10,2023-09-15,353.33,22686,149,22835
1458,TSLA  ,2023-02-10,2023-09-15,358.33,461,287,748
1459,TSLA  ,2023-02-10,2023-09-15,360.0,3289,341,3630
1460,TSLA  ,2023-02-10,2023-09-15,366.67,3062,561,3623
1461,TSLA  ,2023-02-10,2023-09-15,375.0,3218,161,3379
1462,TSLA  ,2023-02-10,2023-09-15,383.33,4577,17,4594
1463,TSLA  ,2023-02-10,2023-09-15,391.67,836,14,850
1464,TSLA  ,2023-02-10,2023-09-15,400.0,5535,69,5604
1465,TSLA  ,2023-02-10,2023-09-15,408.33,1599,1,1600
1466,TSLA  ,2023-02-10,2023-09-15,416.67,973,0,973
1467,TSLA  ,2023-02-10,2023-09-15,425.0,3241,0,3241
1468,TSLA  ,2023-02-10,2023-09-15,433.33,4926,8,4934
1469,TSLA  ,2023-02-10,2023-09-15,441.67,1021,0,1021
1470,TSLA  ,2023-02-10,2023-09-15,450.0,2445,0,2445
1471,TSLA  ,2023-02-10,2023-09-15,458.33,402,0,402
1472,TSLA  ,2023-02-10,2023-09-15,466.67,2691,0,2691
1473,TSLA  ,2023-02-10,2023-09-15,475.0,337,0,337
1474,TSLA  ,2023-02-10,2023-09-15,483.33,667,0,667
1475,TSLA  ,2023-02-10,2023-09-15,491.67,1098,0,1098
1476,TSLA  ,2023-02-10,2023-09-15,500.0,5053,0,5053
1477,TSLA  ,2023-02-10,2023-09-15,508.33,811,0,811
1478,TSLA  ,2023-02-10,2023-09-15,516.67,1266,0,1266
1479,TSLA  ,2023-02-10,2023-09-15,525.0,1197,0,1197
1480,TSLA  ,2023-02-10,2023-09-15,533.33,1596,0,1596
1481,TSLA  ,2023-02-10,2023-09-15,541.67,1161,0,1161
1482,TSLA  ,2023-02-10,2023-09-15,550.0,11701,0,11701
1483,TSLA  ,2023-02-10,2023-09-15,558.33,189,0,189
1484,TSLA  ,2023-02-10,2023-09-15,566.67,4082,0,4082
1485,TSLA  ,2023-02-10,2023-09-15,575.0,353,0,353
1486,TSLA  ,2023-02-10,2023-09-15,583.33,512,0,512
1487,TSLA  ,2023-02-10,2023-09-15,591.67,2115,0,2115
1488,TSLA  ,2023-02-10,2023-09-15,600.0,8623,0,8623
1489,TSLA  ,2023-02-10,2023-09-15,608.33,672,0,672
1490,TSLA  ,2023-02-10,2023-09-15,616.67,1021,0,1021
1491,TSLA  ,2023-02-10,2023-09-15,625.0,1034,0,1034
1492,TSLA  ,2023-02-10,2023-09-15,633.33,643,0,643
1493,TSLA  ,2023-02-10,2023-09-15,641.67,421,0,421
1494,TSLA  ,2023-02-10,2023-09-15,650.0,27320,0,27320
1495,TSLA  ,2023-02-10,2023-09-15,658.33,1206,0,1206
1496,TSLA  ,2023-02-10,2023-09-15,666.67,1308,0,1308
1497,TSLA  ,2023-02-10,2023-09-15,675.0,496,0,496
1498,TSLA  ,2023-02-10,2023-09-15,683.33,361,0,361
1499,TSLA  ,2023-02-10,2023-09-15,700.0,1526,0,1526
1500,TSLA  ,2023-02-10,2023-09-15,716.67,1128,0,1128
1501,TSLA  ,2023-02-10,2023-09-15,733.33,2325,0,2325
1502,TSLA  ,2023-02-10,2023-09-15,750.0,8193,0,8193
1503,TSLA  ,2023-02-10,2023-09-15,758.33,71874,0,71874
1504,TSLA  ,2023-02-10,2023-12-15,50.0,1277,3373,4650
1505,TSLA  ,2023-02-10,2023-12-15,55.0,64,1139,1203
1506,TSLA  ,2023-02-10,2023-12-15,60.0,40,1136,1176
1507,TSLA  ,2023-02-10,2023-12-15,65.0,4,364,368
1508,TSLA  ,2023-02-10,2023-12-15,70.0,27,3821,3848
1509,TSLA  ,2023-02-10,2023-12-15,75.0,19,3985,4004
1510,TSLA  ,2023-02-10,2023-12-15,80.0,157,787,944
1511,TSLA  ,2023-02-10,2023-12-15,85.0,2577,2380,4957
1512,TSLA  ,2023-02-10,2023-12-15,90.0,1647,6015,7662
1513,TSLA  ,2023-02-10,2023-12-15,95.0,831,499,1330
1514,TSLA  ,2023-02-10,2023-12-15,100.0,1912,6013,7925
1515,TSLA  ,2023-02-10,2023-12-15,105.0,324,737,1061
1516,TSLA  ,2023-02-10,2023-12-15,110.0,753,2147,2900
1517,TSLA  ,2023-02-10,2023-12-15,115.0,1715,956,2671
1518,TSLA  ,2023-02-10,2023-12-15,120.0,1021,1273,2294
1519,TSLA  ,2023-02-10,2023-12-15,125.0,491,1438,1929
1520,TSLA  ,2023-02-10,2023-12-15,130.0,778,10590,11368
1521,TSLA  ,2023-02-10,2023-12-15,135.0,790,5794,6584
1522,TSLA  ,2023-02-10,2023-12-15,140.0,936,1423,2359
1523,TSLA  ,2023-02-10,2023-12-15,145.0,633,966,1599
1524,TSLA  ,2023-02-10,2023-12-15,150.0,1515,12283,13798
1525,TSLA  ,2023-02-10,2023-12-15,155.0,417,1004,1421
1526,TSLA  ,2023-02-10,2023-12-15,160.0,2833,10735,13568
1527,TSLA  ,2023-02-10,2023-12-15,165.0,1468,492,1960
1528,TSLA  ,2023-02-10,2023-12-15,170.0,741,4460,5201
1529,TSLA  ,2023-02-10,2023-12-15,175.0,2140,378,2518
1530,TSLA  ,2023-02-10,2023-12-15,180.0,1625,1177,2802
1531,TSLA  ,2023-02-10,2023-12-15,185.0,552,593,1145
1532,TSLA  ,2023-02-10,2023-12-15,190.0,1175,547,1722
1533,TSLA  ,2023-02-10,2023-12-15,195.0,732,592,1324
1534,TSLA  ,2023-02-10,2023-12-15,200.0,8599,1340,9939
1535,TSLA  ,2023-02-10,2023-12-15,205.0,7180,323,7503
1536,TSLA  ,2023-02-10,2023-12-15,210.0,2738,454,3192
1537,TSLA  ,2023-02-10,2023-12-15,215.0,1190,363,1553
1538,TSLA  ,2023-02-10,2023-12-15,220.0,1527,1153,2680
1539,TSLA  ,2023-02-10,2023-12-15,225.0,1240,255,1495
1540,TSLA  ,2023-02-10,2023-12-15,230.0,1609,682,2291
1541,TSLA  ,2023-02-10,2023-12-15,235.0,511,438,949
1542,TSLA  ,2023-02-10,2023-12-15,240.0,5760,563,6323
1543,TSLA  ,2023-02-10,2023-12-15,245.0,1930,501,2431
1544,TSLA  ,2023-02-10,2023-12-15,250.0,15738,3455,19193
1545,TSLA  ,2023-02-10,2023-12-15,260.0,10090,750,10840
1546,TSLA  ,2023-02-10,2023-12-15,270.0,3999,515,4514
1547,TSLA  ,2023-02-10,2023-12-15,280.0,1279,676,1955
1548,TSLA  ,2023-02-10,2023-12-15,290.0,598,491,1089
1549,TSLA  ,2023-02-10,2023-12-15,300.0,1283,1013,2296
1550,TSLA  ,2023-02-10,2023-12-15,310.0,947,615,1562
1551,TSLA  ,2023-02-10,2023-12-15,320.0,1209,537,1746
1552,TSLA  ,2023-02-10,2023-12-15,330.0,488,232,720
1553,TSLA  ,2023-02-10,2023-12-15,340.0,328,120,448
1554,TSLA  ,2023-02-10,2023-12-15,350.0,864,181,1045
1555,TSLA  ,2023-02-10,2023-12-15,360.0,542,117,659
1556,TSLA  ,2023-02-10,2023-12-15,370.0,19,243,262
1557,TSLA  ,2023-02-10,2023-12-15,380.0,103,321,424
1558,TSLA  ,2023-02-10,2023-12-15,390.0,356,105,461
1559,TSLA  ,2023-02-10,2024-01-19,1.67,2491,29256,31747
1560,TSLA  ,2023-02-10,2024-01-19,3.33,966,5937,6903
1561,TSLA  ,2023-02-10,2024-01-19,5.0,256,10180,10436
1562,TSLA  ,2023-02-10,2024-01-19,6.67,76,3242,3318
1563,TSLA  ,2023-02-10,2024-01-19,8.33,3902,2779,6681
1564,TSLA  ,2023-02-10,2024-01-19,10.0,294,4647,4941
1565,TSLA  ,2023-02-10,2024-01-19,11.67,253,3193,3446
1566,TSLA  ,2023-02-10,2024-01-19,13.33,819,507,1326
1567,TSLA  ,2023-02-10,2024-01-19,15.0,279,2066,2345
1568,TSLA  ,2023-02-10,2024-01-19,16.67,486,4566,5052
1569,TSLA  ,2023-02-10,2024-01-19,18.33,393,6127,6520
1570,TSLA  ,2023-02-10,2024-01-19,20.0,258,7593,7851
1571,TSLA  ,2023-02-10,2024-01-19,21.67,108,842,950
1572,TSLA  ,2023-02-10,2024-01-19,23.33,382,3838,4220
1573,TSLA  ,2023-02-10,2024-01-19,25.0,369,2800,3169
1574,TSLA  ,2023-02-10,2024-01-19,26.67,833,1194,2027
1575,TSLA  ,2023-02-10,2024-01-19,28.33,341,851,1192
1576,TSLA  ,2023-02-10,2024-01-19,30.0,228,8805,9033
1577,TSLA  ,2023-02-10,2024-01-19,31.67,1328,1353,2681
1578,TSLA  ,2023-02-10,2024-01-19,33.33,4315,32826,37141
1579,TSLA  ,2023-02-10,2024-01-19,50.0,2167,30356,32523
1580,TSLA  ,2023-02-10,2024-01-19,55.0,81,1277,1358
1581,TSLA  ,2023-02-10,2024-01-19,60.0,250,2628,2878
1582,TSLA  ,2023-02-10,2024-01-19,65.0,266,769,1035
1583,TSLA  ,2023-02-10,2024-01-19,66.67,4703,14619,19322
1584,TSLA  ,2023-02-10,2024-01-19,70.0,143,881,1024
1585,TSLA  ,2023-02-10,2024-01-19,75.0,93,1252,1345
1586,TSLA  ,2023-02-10,2024-01-19,80.0,414,1932,2346
1587,TSLA  ,2023-02-10,2024-01-19,83.33,1066,7981,9047
1588,TSLA  ,2023-02-10,2024-01-19,85.0,512,457,969
1589,TSLA  ,2023-02-10,2024-01-19,90.0,3540,1383,4923
1590,TSLA  ,2023-02-10,2024-01-19,95.0,3024,1426,4450
1591,TSLA  ,2023-02-10,2024-01-19,100.0,13914,39514,53428
1592,TSLA  ,2023-02-10,2024-01-19,105.0,1289,1951,3240
1593,TSLA  ,2023-02-10,2024-01-19,110.0,4988,7061,12049
1594,TSLA  ,2023-02-10,2024-01-19,115.0,4695,5526,10221
1595,TSLA  ,2023-02-10,2024-01-19,116.67,1936,8366,10302
1596,TSLA  ,2023-02-10,2024-01-19,120.0,3449,6141,9590
1597,TSLA  ,2023-02-10,2024-01-19,123.33,1983,2317,4300
1598,TSLA  ,2023-02-10,2024-01-19,125.0,2413,13218,15631
1599,TSLA  ,2023-02-10,2024-01-19,126.67,1741,6599,8340
1600,TSLA  ,2023-02-10,2024-01-19,130.0,5066,11963,17029
1601,TSLA  ,2023-02-10,2024-01-19,133.33,2436,10987,13423
1602,TSLA  ,2023-02-10,2024-01-19,135.0,1330,1291,2621
1603,TSLA  ,2023-02-10,2024-01-19,136.67,2435,2296,4731
1604,TSLA  ,2023-02-10,2024-01-19,140.0,5070,4281,9351
1605,TSLA  ,2023-02-10,2024-01-19,143.33,1671,2273,3944
1606,TSLA  ,2023-02-10,2024-01-19,145.0,753,836,1589
1607,TSLA  ,2023-02-10,2024-01-19,146.67,1026,955,1981
1608,TSLA  ,2023-02-10,2024-01-19,150.0,17564,22456,40020
1609,TSLA  ,2023-02-10,2024-01-19,153.33,10747,1047,11794
1610,TSLA  ,2023-02-10,2024-01-19,155.0,537,1397,1934
1611,TSLA  ,2023-02-10,2024-01-19,156.67,1730,813,2543
1612,TSLA  ,2023-02-10,2024-01-19,160.0,3576,12221,15797
1613,TSLA  ,2023-02-10,2024-01-19,163.33,505,7396,7901
1614,TSLA  ,2023-02-10,2024-01-19,165.0,704,471,1175
1615,TSLA  ,2023-02-10,2024-01-19,166.67,6754,6896,13650
1616,TSLA  ,2023-02-10,2024-01-19,170.0,2795,6297,9092
1617,TSLA  ,2023-02-10,2024-01-19,173.33,855,2567,3422
1618,TSLA  ,2023-02-10,2024-01-19,175.0,1720,2660,4380
1619,TSLA  ,2023-02-10,2024-01-19,176.67,1017,1267,2284
1620,TSLA  ,2023-02-10,2024-01-19,180.0,39249,11059,50308
1621,TSLA  ,2023-02-10,2024-01-19,183.33,34393,7411,41804
1622,TSLA  ,2023-02-10,2024-01-19,185.0,1349,720,2069
1623,TSLA  ,2023-02-10,2024-01-19,186.67,1263,2266,3529
1624,TSLA  ,2023-02-10,2024-01-19,190.0,1627,683,2310
1625,TSLA  ,2023-02-10,2024-01-19,193.33,2288,9810,12098
1626,TSLA  ,2023-02-10,2024-01-19,195.0,394,1665,2059
1627,TSLA  ,2023-02-10,2024-01-19,200.0,32399,24170,56569
1628,TSLA  ,2023-02-10,2024-01-19,203.33,6274,2302,8576
1629,TSLA  ,2023-02-10,2024-01-19,206.67,1660,1199,2859
1630,TSLA  ,2023-02-10,2024-01-19,210.0,10925,6496,17421
1631,TSLA  ,2023-02-10,2024-01-19,213.33,1535,2693,4228
1632,TSLA  ,2023-02-10,2024-01-19,216.67,9192,6557,15749
1633,TSLA  ,2023-02-10,2024-01-19,220.0,7044,7093,14137
1634,TSLA  ,2023-02-10,2024-01-19,223.33,5809,1429,7238
1635,TSLA  ,2023-02-10,2024-01-19,226.67,19993,2963,22956
1636,TSLA  ,2023-02-10,2024-01-19,230.0,14499,19042,33541
1637,TSLA  ,2023-02-10,2024-01-19,233.33,37115,13915,51030
1638,TSLA  ,2023-02-10,2024-01-19,236.67,2002,1676,3678
1639,TSLA  ,2023-02-10,2024-01-19,240.0,4479,3914,8393
1640,TSLA  ,2023-02-10,2024-01-19,243.33,1239,1999,3238
1641,TSLA  ,2023-02-10,2024-01-19,246.67,1056,2118,3174
1642,TSLA  ,2023-02-10,2024-01-19,250.0,23019,5320,28339
1643,TSLA  ,2023-02-10,2024-01-19,253.33,2841,2101,4942
1644,TSLA  ,2023-02-10,2024-01-19,256.67,2825,1640,4465
1645,TSLA  ,2023-02-10,2024-01-19,260.0,7512,3164,10676
1646,TSLA  ,2023-02-10,2024-01-19,263.33,7761,2146,9907
1647,TSLA  ,2023-02-10,2024-01-19,266.67,10344,8881,19225
1648,TSLA  ,2023-02-10,2024-01-19,270.0,4515,5215,9730
1649,TSLA  ,2023-02-10,2024-01-19,273.33,3244,3091,6335
1650,TSLA  ,2023-02-10,2024-01-19,276.67,1758,1761,3519
1651,TSLA  ,2023-02-10,2024-01-19,280.0,9323,6497,15820
1652,TSLA  ,2023-02-10,2024-01-19,283.33,3100,3089,6189
1653,TSLA  ,2023-02-10,2024-01-19,286.67,2486,1504,3990
1654,TSLA  ,2023-02-10,2024-01-19,290.0,9120,556,9676
1655,TSLA  ,2023-02-10,2024-01-19,293.33,2697,1990,4687
1656,TSLA  ,2023-02-10,2024-01-19,296.67,2106,1688,3794
1657,TSLA  ,2023-02-10,2024-01-19,300.0,24976,6407,31383
1658,TSLA  ,2023-02-10,2024-01-19,303.33,3422,180,3602
1659,TSLA  ,2023-02-10,2024-01-19,306.67,6579,132,6711
1660,TSLA  ,2023-02-10,2024-01-19,310.0,3728,1013,4741
1661,TSLA  ,2023-02-10,2024-01-19,313.33,1184,22,1206
1662,TSLA  ,2023-02-10,2024-01-19,316.67,4195,306,4501
1663,TSLA  ,2023-02-10,2024-01-19,320.0,6226,318,6544
1664,TSLA  ,2023-02-10,2024-01-19,323.33,453,267,720
1665,TSLA  ,2023-02-10,2024-01-19,325.0,10245,129,10374
1666,TSLA  ,2023-02-10,2024-01-19,326.67,1348,633,1981
1667,TSLA  ,2023-02-10,2024-01-19,330.0,7240,11,7251
1668,TSLA  ,2023-02-10,2024-01-19,333.33,29779,2056,31835
1669,TSLA  ,2023-02-10,2024-01-19,336.67,1462,7,1469
1670,TSLA  ,2023-02-10,2024-01-19,340.0,3846,5,3851
1671,TSLA  ,2023-02-10,2024-01-19,341.67,888,10,898
1672,TSLA  ,2023-02-10,2024-01-19,343.33,526,0,526
1673,TSLA  ,2023-02-10,2024-01-19,346.67,2386,3,2389
1674,TSLA  ,2023-02-10,2024-01-19,350.0,15471,433,15904
1675,TSLA  ,2023-02-10,2024-01-19,353.33,1163,0,1163
1676,TSLA  ,2023-02-10,2024-01-19,356.67,878,0,878
1677,TSLA  ,2023-02-10,2024-01-19,358.33,1218,3,1221
1678,TSLA  ,2023-02-10,2024-01-19,360.0,9293,600,9893
1679,TSLA  ,2023-02-10,2024-01-19,363.33,443,7,450
1680,TSLA  ,2023-02-10,2024-01-19,366.67,38785,2787,41572
1681,TSLA  ,2023-02-10,2024-01-19,370.0,6194,4,6198
1682,TSLA  ,2023-02-10,2024-01-19,373.33,1053,11,1064
1683,TSLA  ,2023-02-10,2024-01-19,375.0,11420,8,11428
1684,TSLA  ,2023-02-10,2024-01-19,376.67,526,106,632
1685,TSLA  ,2023-02-10,2024-01-19,380.0,1010,2,1012
1686,TSLA  ,2023-02-10,2024-01-19,383.33,3076,2,3078
1687,TSLA  ,2023-02-10,2024-01-19,386.67,408,203,611
1688,TSLA  ,2023-02-10,2024-01-19,390.0,891,1,892
1689,TSLA  ,2023-02-10,2024-01-19,391.67,2129,1,2130
1690,TSLA  ,2023-02-10,2024-01-19,393.33,499,4,503
1691,TSLA  ,2023-02-10,2024-01-19,396.67,2629,0,2629
1692,TSLA  ,2023-02-10,2024-01-19,400.0,38575,980,39555
1693,TSLA  ,2023-02-10,2024-01-19,408.33,5122,1,5123
1694,TSLA  ,2023-02-10,2024-01-19,416.67,3775,2142,5917
1695,TSLA  ,2023-02-10,2024-01-19,425.0,4713,18,4731
1696,TSLA  ,2023-02-10,2024-01-19,433.33,5739,3,5742
1697,TSLA  ,2023-02-10,2024-01-19,441.67,1192,0,1192
1698,TSLA  ,2023-02-10,2024-01-19,450.0,8223,2427,10650
1699,TSLA  ,2023-02-10,2024-01-19,458.33,1996,0,1996
1700,TSLA  ,2023-02-10,2024-01-19,466.67,28837,0,28837
1701,TSLA  ,2023-02-10,2024-01-19,475.0,4823,10,4833
1702,TSLA  ,2023-02-10,2024-01-19,483.33,1579,0,1579
1703,TSLA  ,2023-02-10,2024-01-19,491.67,2140,0,2140
1704,TSLA  ,2023-02-10,2024-01-19,500.0,36906,145,37051
1705,TSLA  ,2023-02-10,2024-01-19,516.67,4795,2,4797
1706,TSLA  ,2023-02-10,2024-01-19,533.33,20787,0,20787
1707,TSLA  ,2023-02-10,2024-01-19,550.0,16383,82,16465
1708,TSLA  ,2023-02-10,2024-01-19,558.33,1181,0,1181
1709,TSLA  ,2023-02-10,2024-01-19,566.67,11367,0,11367
1710,TSLA  ,2023-02-10,2024-01-19,575.0,13939,0,13939
1711,TSLA  ,2023-02-10,2024-01-19,583.33,13826,0,13826
1712,TSLA  ,2023-02-10,2024-01-19,591.67,2273,0,2273
1713,TSLA  ,2023-02-10,2024-01-19,600.0,18727,0,18727
1714,TSLA  ,2023-02-10,2024-01-19,608.33,2278,0,2278
1715,TSLA  ,2023-02-10,2024-01-19,616.67,11853,0,11853
1716,TSLA  ,2023-02-10,2024-01-19,625.0,2424,0,2424
1717,TSLA  ,2023-02-10,2024-01-19,633.33,5751,0,5751
1718,TSLA  ,2023-02-10,2024-01-19,641.67,930,0,930
1719,TSLA  ,2023-02-10,2024-01-19,650.0,3198,0,3198
1720,TSLA  ,2023-02-10,2024-01-19,666.67,40830,0,40830
1721,TSLA  ,2023-02-10,2024-01-19,675.0,4348,0,4348
1722,TSLA  ,2023-02-10,2024-01-19,683.33,7132,0,7132
1723,TSLA  ,2023-02-10,2024-01-19,691.67,1563,0,1563
1724,TSLA  ,2023-02-10,2024-01-19,700.0,5253,0,5253
1725,TSLA  ,2023-02-10,2024-01-19,708.33,761,0,761
1726,TSLA  ,2023-02-10,2024-01-19,716.67,6059,0,6059
1727,TSLA  ,2023-02-10,2024-01-19,725.0,2694,3,2697
1728,TSLA  ,2023-02-10,2024-01-19,733.33,3399,0,3399
1729,TSLA  ,2023-02-10,2024-01-19,741.67,805,0,805
1730,TSLA  ,2023-02-10,2024-01-19,750.0,2330,0,2330
1731,TSLA  ,2023-02-10,2024-01-19,758.33,936,0,936
1732,TSLA  ,2023-02-10,2024-01-19,766.67,2124,0,2124
1733,TSLA  ,2023-02-10,2024-01-19,775.0,2797,0,2797
1734,TSLA  ,2023-02-10,2024-01-19,783.33,692,0,692
1735,TSLA  ,2023-02-10,2024-01-19,791.67,3177,0,3177
1736,TSLA  ,2023-02-10,2024-01-19,800.0,13752,0,13752
1737,TSLA  ,2023-02-10,2024-01-19,808.33,3927,0,3927
1738,TSLA  ,2023-02-10,2024-01-19,816.67,5804,0,5804
1739,TSLA  ,2023-02-10,2024-01-19,825.0,74430,0,74430
1740,TSLA  ,2023-02-10,2024-03-15,1.67,108,1887,1995
1741,TSLA  ,2023-02-10,2024-03-15,3.33,22,769,791
1742,TSLA  ,2023-02-10,2024-03-15,5.0,64,893,957
1743,TSLA  ,2023-02-10,2024-03-15,6.67,6,93,99
1744,TSLA  ,2023-02-10,2024-03-15,8.33,16,42,58
1745,TSLA  ,2023-02-10,2024-03-15,10.0,6,307,313
1746,TSLA  ,2023-02-10,2024-03-15,11.67,11,409,420
1747,TSLA  ,2023-02-10,2024-03-15,13.33,18,45,63
1748,TSLA  ,2023-02-10,2024-03-15,15.0,24,202,226
1749,TSLA  ,2023-02-10,2024-03-15,16.67,124,229,353
1750,TSLA  ,2023-02-10,2024-03-15,33.33,809,1998,2807
1751,TSLA  ,2023-02-10,2024-03-15,50.0,447,5570,6017
1752,TSLA  ,2023-02-10,2024-03-15,55.0,28,300,328
1753,TSLA  ,2023-02-10,2024-03-15,60.0,44,825,869
1754,TSLA  ,2023-02-10,2024-03-15,65.0,22,714,736
1755,TSLA  ,2023-02-10,2024-03-15,66.67,2035,1006,3041
1756,TSLA  ,2023-02-10,2024-03-15,70.0,50,231,281
1757,TSLA  ,2023-02-10,2024-03-15,75.0,20,398,418
1758,TSLA  ,2023-02-10,2024-03-15,80.0,191,556,747
1759,TSLA  ,2023-02-10,2024-03-15,83.33,999,4511,5510
1760,TSLA  ,2023-02-10,2024-03-15,85.0,291,212,503
1761,TSLA  ,2023-02-10,2024-03-15,90.0,742,385,1127
1762,TSLA  ,2023-02-10,2024-03-15,95.0,1558,409,1967
1763,TSLA  ,2023-02-10,2024-03-15,100.0,3365,3076,6441
1764,TSLA  ,2023-02-10,2024-03-15,105.0,818,718,1536
1765,TSLA  ,2023-02-10,2024-03-15,110.0,912,2508,3420
1766,TSLA  ,2023-02-10,2024-03-15,115.0,2043,193,2236
1767,TSLA  ,2023-02-10,2024-03-15,116.67,609,957,1566
1768,TSLA  ,2023-02-10,2024-03-15,120.0,327,594,921
1769,TSLA  ,2023-02-10,2024-03-15,125.0,792,741,1533
1770,TSLA  ,2023-02-10,2024-03-15,130.0,1546,493,2039
1771,TSLA  ,2023-02-10,2024-03-15,133.33,590,5692,6282
1772,TSLA  ,2023-02-10,2024-03-15,135.0,209,191,400
1773,TSLA  ,2023-02-10,2024-03-15,140.0,152,265,417
1774,TSLA  ,2023-02-10,2024-03-15,141.67,515,325,840
1775,TSLA  ,2023-02-10,2024-03-15,145.0,275,375,650
1776,TSLA  ,2023-02-10,2024-03-15,150.0,1310,4409,5719
1777,TSLA  ,2023-02-10,2024-03-15,155.0,83,205,288
1778,TSLA  ,2023-02-10,2024-03-15,158.33,172,581,753
1779,TSLA  ,2023-02-10,2024-03-15,160.0,216,4377,4593
1780,TSLA  ,2023-02-10,2024-03-15,165.0,148,3882,4030
1781,TSLA  ,2023-02-10,2024-03-15,166.67,583,1181,1764
1782,TSLA  ,2023-02-10,2024-03-15,170.0,283,8883,9166
1783,TSLA  ,2023-02-10,2024-03-15,175.0,719,1940,2659
1784,TSLA  ,2023-02-10,2024-03-15,180.0,303,638,941
1785,TSLA  ,2023-02-10,2024-03-15,183.33,523,1146,1669
1786,TSLA  ,2023-02-10,2024-03-15,185.0,217,150,367
1787,TSLA  ,2023-02-10,2024-03-15,190.0,180,238,418
1788,TSLA  ,2023-02-10,2024-03-15,191.67,628,1383,2011
1789,TSLA  ,2023-02-10,2024-03-15,195.0,538,131,669
1790,TSLA  ,2023-02-10,2024-03-15,200.0,5180,4694,9874
1791,TSLA  ,2023-02-10,2024-03-15,208.33,1171,728,1899
1792,TSLA  ,2023-02-10,2024-03-15,210.0,406,161,567
1793,TSLA  ,2023-02-10,2024-03-15,216.67,1267,831,2098
1794,TSLA  ,2023-02-10,2024-03-15,220.0,553,53,606
1795,TSLA  ,2023-02-10,2024-03-15,225.0,1435,2417,3852
1796,TSLA  ,2023-02-10,2024-03-15,230.0,234,57,291
1797,TSLA  ,2023-02-10,2024-03-15,233.33,1617,1225,2842
1798,TSLA  ,2023-02-10,2024-03-15,240.0,155,50,205
1799,TSLA  ,2023-02-10,2024-03-15,241.67,1123,955,2078
1800,TSLA  ,2023-02-10,2024-03-15,250.0,2125,1528,3653
1801,TSLA  ,2023-02-10,2024-03-15,258.33,4133,1117,5250
1802,TSLA  ,2023-02-10,2024-03-15,260.0,370,96,466
1803,TSLA  ,2023-02-10,2024-03-15,266.67,4459,810,5269
1804,TSLA  ,2023-02-10,2024-03-15,270.0,296,2,298
1805,TSLA  ,2023-02-10,2024-03-15,275.0,8961,1006,9967
1806,TSLA  ,2023-02-10,2024-03-15,280.0,109,55,164
1807,TSLA  ,2023-02-10,2024-03-15,283.33,1166,710,1876
1808,TSLA  ,2023-02-10,2024-03-15,290.0,13,2,15
1809,TSLA  ,2023-02-10,2024-03-15,291.67,1289,129,1418
1810,TSLA  ,2023-02-10,2024-03-15,300.0,4882,643,5525
1811,TSLA  ,2023-02-10,2024-03-15,308.33,407,39,446
1812,TSLA  ,2023-02-10,2024-03-15,316.67,936,389,1325
1813,TSLA  ,2023-02-10,2024-03-15,325.0,1505,16,1521
1814,TSLA  ,2023-02-10,2024-03-15,333.33,870,24,894
1815,TSLA  ,2023-02-10,2024-03-15,341.67,286,24,310
1816,TSLA  ,2023-02-10,2024-03-15,350.0,907,44,951
1817,TSLA  ,2023-02-10,2024-03-15,358.33,428,68,496
1818,TSLA  ,2023-02-10,2024-03-15,366.67,536,161,697
1819,TSLA  ,2023-02-10,2024-03-15,375.0,656,2,658
1820,TSLA  ,2023-02-10,2024-03-15,383.33,206,1335,1541
1821,TSLA  ,2023-02-10,2024-03-15,391.67,319,8,327
1822,TSLA  ,2023-02-10,2024-03-15,400.0,1176,21,1197
1823,TSLA  ,2023-02-10,2024-03-15,408.33,626,3,629
1824,TSLA  ,2023-02-10,2024-03-15,416.67,372,316,688
1825,TSLA  ,2023-02-10,2024-03-15,425.0,890,8,898
1826,TSLA  ,2023-02-10,2024-03-15,433.33,589,0,589
1827,TSLA  ,2023-02-10,2024-03-15,441.67,170,0,170
1828,TSLA  ,2023-02-10,2024-03-15,450.0,1463,0,1463
1829,TSLA  ,2023-02-10,2024-03-15,458.33,243,0,243
1830,TSLA  ,2023-02-10,2024-03-15,466.67,799,0,799
1831,TSLA  ,2023-02-10,2024-03-15,475.0,431,0,431
1832,TSLA  ,2023-02-10,2024-03-15,483.33,486,0,486
1833,TSLA  ,2023-02-10,2024-03-15,491.67,319,0,319
1834,TSLA  ,2023-02-10,2024-03-15,500.0,2825,0,2825
1835,TSLA  ,2023-02-10,2024-03-15,508.33,228,0,228
1836,TSLA  ,2023-02-10,2024-03-15,516.67,714,0,714
1837,TSLA  ,2023-02-10,2024-03-15,525.0,118,0,118
1838,TSLA  ,2023-02-10,2024-03-15,533.33,232,0,232
1839,TSLA  ,2023-02-10,2024-03-15,541.67,165,0,165
1840,TSLA  ,2023-02-10,2024-03-15,550.0,438,0,438
1841,TSLA  ,2023-02-10,2024-03-15,558.33,265,0,265
1842,TSLA  ,2023-02-10,2024-03-15,566.67,393,0,393
1843,TSLA  ,2023-02-10,2024-03-15,575.0,666,0,666
1844,TSLA  ,2023-02-10,2024-03-15,583.33,476,0,476
1845,TSLA  ,2023-02-10,2024-03-15,600.0,4104,1,4105
1846,TSLA  ,2023-02-10,2024-06-21,1.67,630,16473,17103
1847,TSLA  ,2023-02-10,2024-06-21,3.33,149,3272,3421
1848,TSLA  ,2023-02-10,2024-06-21,5.0,20,1505,1525
1849,TSLA  ,2023-02-10,2024-06-21,6.67,219,1218,1437
1850,TSLA  ,2023-02-10,2024-06-21,8.33,121,368,489
1851,TSLA  ,2023-02-10,2024-06-21,10.0,275,1827,2102
1852,TSLA  ,2023-02-10,2024-06-21,11.67,540,334,874
1853,TSLA  ,2023-02-10,2024-06-21,13.33,39,219,258
1854,TSLA  ,2023-02-10,2024-06-21,16.67,1407,3528,4935
1855,TSLA  ,2023-02-10,2024-06-21,33.33,7802,5382,13184
1856,TSLA  ,2023-02-10,2024-06-21,50.0,1917,3770,5687
1857,TSLA  ,2023-02-10,2024-06-21,55.0,6,383,389
1858,TSLA  ,2023-02-10,2024-06-21,60.0,57,491,548
1859,TSLA  ,2023-02-10,2024-06-21,65.0,111,2103,2214
1860,TSLA  ,2023-02-10,2024-06-21,66.67,1877,4364,6241
1861,TSLA  ,2023-02-10,2024-06-21,70.0,49,250,299
1862,TSLA  ,2023-02-10,2024-06-21,75.0,70,194,264
1863,TSLA  ,2023-02-10,2024-06-21,80.0,111,1421,1532
1864,TSLA  ,2023-02-10,2024-06-21,83.33,30601,4208,34809
1865,TSLA  ,2023-02-10,2024-06-21,85.0,60,862,922
1866,TSLA  ,2023-02-10,2024-06-21,90.0,532,1148,1680
1867,TSLA  ,2023-02-10,2024-06-21,95.0,363,422,785
1868,TSLA  ,2023-02-10,2024-06-21,100.0,5346,9746,15092
1869,TSLA  ,2023-02-10,2024-06-21,105.0,798,804,1602
1870,TSLA  ,2023-02-10,2024-06-21,110.0,497,2206,2703
1871,TSLA  ,2023-02-10,2024-06-21,115.0,415,251,666
1872,TSLA  ,2023-02-10,2024-06-21,116.67,2477,1018,3495
1873,TSLA  ,2023-02-10,2024-06-21,120.0,559,1207,1766
1874,TSLA  ,2023-02-10,2024-06-21,123.33,643,3526,4169
1875,TSLA  ,2023-02-10,2024-06-21,125.0,166,2235,2401
1876,TSLA  ,2023-02-10,2024-06-21,126.67,689,1278,1967
1877,TSLA  ,2023-02-10,2024-06-21,130.0,837,1513,2350
1878,TSLA  ,2023-02-10,2024-06-21,133.33,1923,2859,4782
1879,TSLA  ,2023-02-10,2024-06-21,135.0,66,363,429
1880,TSLA  ,2023-02-10,2024-06-21,136.67,426,1886,2312
1881,TSLA  ,2023-02-10,2024-06-21,140.0,1493,2589,4082
1882,TSLA  ,2023-02-10,2024-06-21,143.33,1403,1686,3089
1883,TSLA  ,2023-02-10,2024-06-21,145.0,599,212,811
1884,TSLA  ,2023-02-10,2024-06-21,146.67,1640,564,2204
1885,TSLA  ,2023-02-10,2024-06-21,150.0,4378,9876,14254
1886,TSLA  ,2023-02-10,2024-06-21,153.33,289,815,1104
1887,TSLA  ,2023-02-10,2024-06-21,155.0,86,437,523
1888,TSLA  ,2023-02-10,2024-06-21,156.67,383,227,610
1889,TSLA  ,2023-02-10,2024-06-21,160.0,891,2713,3604
1890,TSLA  ,2023-02-10,2024-06-21,163.33,185,1409,1594
1891,TSLA  ,2023-02-10,2024-06-21,165.0,347,887,1234
1892,TSLA  ,2023-02-10,2024-06-21,166.67,1732,5505,7237
1893,TSLA  ,2023-02-10,2024-06-21,170.0,314,839,1153
1894,TSLA  ,2023-02-10,2024-06-21,173.33,596,5881,6477
1895,TSLA  ,2023-02-10,2024-06-21,175.0,936,358,1294
1896,TSLA  ,2023-02-10,2024-06-21,180.0,1391,6665,8056
1897,TSLA  ,2023-02-10,2024-06-21,183.33,931,3703,4634
1898,TSLA  ,2023-02-10,2024-06-21,185.0,299,231,530
1899,TSLA  ,2023-02-10,2024-06-21,186.67,1323,1657,2980
1900,TSLA  ,2023-02-10,2024-06-21,190.0,326,87,413
1901,TSLA  ,2023-02-10,2024-06-21,193.33,1014,4285,5299
1902,TSLA  ,2023-02-10,2024-06-21,195.0,258,850,1108
1903,TSLA  ,2023-02-10,2024-06-21,200.0,4585,9782,14367
1904,TSLA  ,2023-02-10,2024-06-21,206.67,975,2854,3829
1905,TSLA  ,2023-02-10,2024-06-21,210.0,400,101,501
1906,TSLA  ,2023-02-10,2024-06-21,213.33,791,1219,2010
1907,TSLA  ,2023-02-10,2024-06-21,216.67,1532,5267,6799
1908,TSLA  ,2023-02-10,2024-06-21,220.0,2216,2389,4605
1909,TSLA  ,2023-02-10,2024-06-21,226.67,2592,3402,5994
1910,TSLA  ,2023-02-10,2024-06-21,230.0,476,100,576
1911,TSLA  ,2023-02-10,2024-06-21,233.33,6587,7139,13726
1912,TSLA  ,2023-02-10,2024-06-21,240.0,1366,4866,6232
1913,TSLA  ,2023-02-10,2024-06-21,246.67,2254,1306,3560
1914,TSLA  ,2023-02-10,2024-06-21,250.0,5433,3513,8946
1915,TSLA  ,2023-02-10,2024-06-21,253.33,1300,851,2151
1916,TSLA  ,2023-02-10,2024-06-21,260.0,2074,953,3027
1917,TSLA  ,2023-02-10,2024-06-21,266.67,10099,3339,13438
1918,TSLA  ,2023-02-10,2024-06-21,270.0,1459,1818,3277
1919,TSLA  ,2023-02-10,2024-06-21,273.33,1227,793,2020
1920,TSLA  ,2023-02-10,2024-06-21,276.67,1011,795,1806
1921,TSLA  ,2023-02-10,2024-06-21,280.0,1206,1600,2806
1922,TSLA  ,2023-02-10,2024-06-21,283.33,3569,1362,4931
1923,TSLA  ,2023-02-10,2024-06-21,286.67,973,768,1741
1924,TSLA  ,2023-02-10,2024-06-21,290.0,2251,1161,3412
1925,TSLA  ,2023-02-10,2024-06-21,293.33,1097,968,2065
1926,TSLA  ,2023-02-10,2024-06-21,296.67,860,360,1220
1927,TSLA  ,2023-02-10,2024-06-21,300.0,9358,892,10250
1928,TSLA  ,2023-02-10,2024-06-21,303.33,1398,645,2043
1929,TSLA  ,2023-02-10,2024-06-21,306.67,1504,237,1741
1930,TSLA  ,2023-02-10,2024-06-21,310.0,1816,518,2334
1931,TSLA  ,2023-02-10,2024-06-21,313.33,1161,719,1880
1932,TSLA  ,2023-02-10,2024-06-21,316.67,2341,13,2354
1933,TSLA  ,2023-02-10,2024-06-21,320.0,691,691,1382
1934,TSLA  ,2023-02-10,2024-06-21,323.33,432,308,740
1935,TSLA  ,2023-02-10,2024-06-21,326.67,582,274,856
1936,TSLA  ,2023-02-10,2024-06-21,330.0,2700,123,2823
1937,TSLA  ,2023-02-10,2024-06-21,333.33,7561,1092,8653
1938,TSLA  ,2023-02-10,2024-06-21,336.67,2289,238,2527
1939,TSLA  ,2023-02-10,2024-06-21,340.0,773,30,803
1940,TSLA  ,2023-02-10,2024-06-21,343.33,1180,89,1269
1941,TSLA  ,2023-02-10,2024-06-21,346.67,400,45,445
1942,TSLA  ,2023-02-10,2024-06-21,350.0,3434,6,3440
1943,TSLA  ,2023-02-10,2024-06-21,353.33,199,69,268
1944,TSLA  ,2023-02-10,2024-06-21,356.67,493,0,493
1945,TSLA  ,2023-02-10,2024-06-21,360.0,2620,12,2632
1946,TSLA  ,2023-02-10,2024-06-21,363.33,357,0,357
1947,TSLA  ,2023-02-10,2024-06-21,366.67,4712,0,4712
1948,TSLA  ,2023-02-10,2024-06-21,370.0,3054,9,3063
1949,TSLA  ,2023-02-10,2024-06-21,373.33,539,0,539
1950,TSLA  ,2023-02-10,2024-06-21,376.67,816,0,816
1951,TSLA  ,2023-02-10,2024-06-21,380.0,687,1,688
1952,TSLA  ,2023-02-10,2024-06-21,383.33,1027,11,1038
1953,TSLA  ,2023-02-10,2024-06-21,386.67,307,5,312
1954,TSLA  ,2023-02-10,2024-06-21,390.0,459,1,460
1955,TSLA  ,2023-02-10,2024-06-21,393.33,884,1,885
1956,TSLA  ,2023-02-10,2024-06-21,396.67,720,0,720
1957,TSLA  ,2023-02-10,2024-06-21,400.0,38877,35,38912
1958,TSLA  ,2023-02-10,2024-06-21,416.67,3255,1,3256
1959,TSLA  ,2023-02-10,2024-06-21,433.33,3247,0,3247
1960,TSLA  ,2023-02-10,2024-06-21,450.0,3102,0,3102
1961,TSLA  ,2023-02-10,2024-06-21,466.67,5387,0,5387
1962,TSLA  ,2023-02-10,2024-06-21,483.33,1102,0,1102
1963,TSLA  ,2023-02-10,2024-06-21,500.0,10878,0,10878
1964,TSLA  ,2023-02-10,2024-06-21,516.67,2089,0,2089
1965,TSLA  ,2023-02-10,2024-06-21,533.33,3105,0,3105
1966,TSLA  ,2023-02-10,2024-06-21,550.0,2603,0,2603
1967,TSLA  ,2023-02-10,2024-06-21,566.67,1007,0,1007
1968,TSLA  ,2023-02-10,2024-06-21,583.33,1038,0,1038
1969,TSLA  ,2023-02-10,2024-06-21,600.0,17173,0,17173
1970,TSLA  ,2023-02-10,2024-06-21,616.67,14018,0,14018
1971,TSLA  ,2023-02-10,2024-06-21,633.33,4540,0,4540
1972,TSLA  ,2023-02-10,2024-06-21,650.0,605,0,605
1973,TSLA  ,2023-02-10,2024-06-21,666.67,6561,0,6561
1974,TSLA  ,2023-02-10,2024-06-21,683.33,1688,0,1688
1975,TSLA  ,2023-02-10,2024-06-21,700.0,3772,0,3772
1976,TSLA  ,2023-02-10,2024-06-21,716.67,889,0,889
1977,TSLA  ,2023-02-10,2024-06-21,733.33,2079,0,2079
1978,TSLA  ,2023-02-10,2024-06-21,750.0,6115,1,6116
1979,TSLA  ,2023-02-10,2024-06-21,758.33,13726,0,13726
1980,TSLA  ,2023-02-10,2024-09-20,50.0,44,908,952
1981,TSLA  ,2023-02-10,2024-09-20,55.0,29,54,83
1982,TSLA  ,2023-02-10,2024-09-20,60.0,10,155,165
1983,TSLA  ,2023-02-10,2024-09-20,65.0,32,69,101
1984,TSLA  ,2023-02-10,2024-09-20,70.0,11,134,145
1985,TSLA  ,2023-02-10,2024-09-20,75.0,10,2322,2332
1986,TSLA  ,2023-02-10,2024-09-20,80.0,63,152,215
1987,TSLA  ,2023-02-10,2024-09-20,85.0,987,454,1441
1988,TSLA  ,2023-02-10,2024-09-20,90.0,47,187,234
1989,TSLA  ,2023-02-10,2024-09-20,95.0,22,443,465
1990,TSLA  ,2023-02-10,2024-09-20,100.0,377,2199,2576
1991,TSLA  ,2023-02-10,2024-09-20,105.0,188,718,906
1992,TSLA  ,2023-02-10,2024-09-20,110.0,169,1025,1194
1993,TSLA  ,2023-02-10,2024-09-20,115.0,564,603,1167
1994,TSLA  ,2023-02-10,2024-09-20,120.0,738,551,1289
1995,TSLA  ,2023-02-10,2024-09-20,125.0,323,1198,1521
1996,TSLA  ,2023-02-10,2024-09-20,130.0,625,847,1472
1997,TSLA  ,2023-02-10,2024-09-20,135.0,598,271,869
1998,TSLA  ,2023-02-10,2024-09-20,140.0,1093,362,1455
1999,TSLA  ,2023-02-10,2024-09-20,145.0,1284,346,1630
2000,TSLA  ,2023-02-10,2024-09-20,150.0,1425,2726,4151
2001,TSLA  ,2023-02-10,2024-09-20,155.0,526,302,828
2002,TSLA  ,2023-02-10,2024-09-20,160.0,407,824,1231
2003,TSLA  ,2023-02-10,2024-09-20,165.0,257,109,366
2004,TSLA  ,2023-02-10,2024-09-20,170.0,189,268,457
2005,TSLA  ,2023-02-10,2024-09-20,175.0,210,126,336
2006,TSLA  ,2023-02-10,2024-09-20,180.0,741,84,825
2007,TSLA  ,2023-02-10,2024-09-20,185.0,831,957,1788
2008,TSLA  ,2023-02-10,2024-09-20,190.0,1486,93,1579
2009,TSLA  ,2023-02-10,2024-09-20,195.0,1405,118,1523
2010,TSLA  ,2023-02-10,2024-09-20,200.0,1718,1416,3134
2011,TSLA  ,2023-02-10,2024-09-20,210.0,741,266,1007
2012,TSLA  ,2023-02-10,2024-09-20,220.0,1463,411,1874
2013,TSLA  ,2023-02-10,2024-09-20,230.0,569,116,685
2014,TSLA  ,2023-02-10,2024-09-20,240.0,381,300,681
2015,TSLA  ,2023-02-10,2024-09-20,250.0,840,366,1206
2016,TSLA  ,2023-02-10,2024-09-20,260.0,907,70,977
2017,TSLA  ,2023-02-10,2024-09-20,270.0,518,534,1052
2018,TSLA  ,2023-02-10,2024-09-20,280.0,327,576,903
2019,TSLA  ,2023-02-10,2024-09-20,290.0,466,2808,3274
2020,TSLA  ,2023-02-10,2024-09-20,300.0,1051,1146,2197
2021,TSLA  ,2023-02-10,2024-09-20,310.0,176,725,901
2022,TSLA  ,2023-02-10,2024-09-20,320.0,111,256,367
2023,TSLA  ,2023-02-10,2024-09-20,330.0,93,117,210
2024,TSLA  ,2023-02-10,2024-09-20,340.0,705,110,815
2025,TSLA  ,2023-02-10,2024-09-20,350.0,1418,109,1527
2026,TSLA  ,2023-02-10,2024-09-20,360.0,52,63,115
2027,TSLA  ,2023-02-10,2024-09-20,370.0,11,3,14
2028,TSLA  ,2023-02-10,2024-09-20,380.0,65,2,67
2029,TSLA  ,2023-02-10,2024-09-20,390.0,24,16,40
2030,TSLA  ,2023-02-10,2025-01-17,5.0,669,11198,11867
2031,TSLA  ,2023-02-10,2025-01-17,10.0,138,828,966
2032,TSLA  ,2023-02-10,2025-01-17,15.0,29,861,890
2033,TSLA  ,2023-02-10,2025-01-17,20.0,386,5772,6158
2034,TSLA  ,2023-02-10,2025-01-17,25.0,103,2464,2567
2035,TSLA  ,2023-02-10,2025-01-17,30.0,13816,16537,30353
2036,TSLA  ,2023-02-10,2025-01-17,35.0,266,1103,1369
2037,TSLA  ,2023-02-10,2025-01-17,40.0,14712,15780,30492
2038,TSLA  ,2023-02-10,2025-01-17,45.0,2979,3195,6174
2039,TSLA  ,2023-02-10,2025-01-17,50.0,2742,8690,11432
2040,TSLA  ,2023-02-10,2025-01-17,55.0,2004,4212,6216
2041,TSLA  ,2023-02-10,2025-01-17,60.0,592,2008,2600
2042,TSLA  ,2023-02-10,2025-01-17,65.0,1652,1571,3223
2043,TSLA  ,2023-02-10,2025-01-17,70.0,2486,2156,4642
2044,TSLA  ,2023-02-10,2025-01-17,75.0,184,4386,4570
2045,TSLA  ,2023-02-10,2025-01-17,80.0,1309,1846,3155
2046,TSLA  ,2023-02-10,2025-01-17,85.0,1827,1607,3434
2047,TSLA  ,2023-02-10,2025-01-17,90.0,1140,5535,6675
2048,TSLA  ,2023-02-10,2025-01-17,95.0,138,490,628
2049,TSLA  ,2023-02-10,2025-01-17,100.0,5431,17653,23084
2050,TSLA  ,2023-02-10,2025-01-17,105.0,318,1675,1993
2051,TSLA  ,2023-02-10,2025-01-17,110.0,5443,7152,12595
2052,TSLA  ,2023-02-10,2025-01-17,115.0,3618,3631,7249
2053,TSLA  ,2023-02-10,2025-01-17,120.0,8442,6145,14587
2054,TSLA  ,2023-02-10,2025-01-17,125.0,2154,1164,3318
2055,TSLA  ,2023-02-10,2025-01-17,130.0,5670,7171,12841
2056,TSLA  ,2023-02-10,2025-01-17,135.0,5699,669,6368
2057,TSLA  ,2023-02-10,2025-01-17,140.0,8525,4608,13133
2058,TSLA  ,2023-02-10,2025-01-17,145.0,765,688,1453
2059,TSLA  ,2023-02-10,2025-01-17,150.0,11444,11838,23282
2060,TSLA  ,2023-02-10,2025-01-17,155.0,228,469,697
2061,TSLA  ,2023-02-10,2025-01-17,160.0,4610,5561,10171
2062,TSLA  ,2023-02-10,2025-01-17,165.0,251,858,1109
2063,TSLA  ,2023-02-10,2025-01-17,170.0,35451,9694,45145
2064,TSLA  ,2023-02-10,2025-01-17,175.0,33489,4496,37985
2065,TSLA  ,2023-02-10,2025-01-17,180.0,3733,8241,11974
2066,TSLA  ,2023-02-10,2025-01-17,185.0,1326,4495,5821
2067,TSLA  ,2023-02-10,2025-01-17,190.0,5671,4821,10492
2068,TSLA  ,2023-02-10,2025-01-17,195.0,3218,1730,4948
2069,TSLA  ,2023-02-10,2025-01-17,200.0,28163,12455,40618
2070,TSLA  ,2023-02-10,2025-01-17,210.0,5024,2652,7676
2071,TSLA  ,2023-02-10,2025-01-17,220.0,3136,4082,7218
2072,TSLA  ,2023-02-10,2025-01-17,230.0,4104,3263,7367
2073,TSLA  ,2023-02-10,2025-01-17,240.0,4649,4386,9035
2074,TSLA  ,2023-02-10,2025-01-17,250.0,11644,5111,16755
2075,TSLA  ,2023-02-10,2025-01-17,260.0,5655,1806,7461
2076,TSLA  ,2023-02-10,2025-01-17,270.0,3039,1282,4321
2077,TSLA  ,2023-02-10,2025-01-17,280.0,2250,3336,5586
2078,TSLA  ,2023-02-10,2025-01-17,290.0,3431,2807,6238
2079,TSLA  ,2023-02-10,2025-01-17,300.0,30698,3075,33773
2080,TSLA  ,2023-02-10,2025-01-17,310.0,4371,694,5065
2081,TSLA  ,2023-02-10,2025-01-17,320.0,2064,791,2855
2082,TSLA  ,2023-02-10,2025-01-17,330.0,2399,949,3348
2083,TSLA  ,2023-02-10,2025-01-17,340.0,1309,411,1720
2084,TSLA  ,2023-02-10,2025-01-17,350.0,6981,668,7649
2085,TSLA  ,2023-02-10,2025-01-17,360.0,1980,178,2158
2086,TSLA  ,2023-02-10,2025-01-17,370.0,2064,288,2352
2087,TSLA  ,2023-02-10,2025-01-17,380.0,1451,46,1497
2088,TSLA  ,2023-02-10,2025-01-17,390.0,2077,64,2141
2089,TSLA  ,2023-02-10,2025-01-17,400.0,19094,116,19210
2090,TSLA  ,2023-02-10,2025-01-17,410.0,4200,2,4202
2091,TSLA  ,2023-02-10,2025-01-17,420.0,2960,8,2968
2092,TSLA  ,2023-02-10,2025-01-17,430.0,577,2,579
2093,TSLA  ,2023-02-10,2025-01-17,440.0,646,7,653
2094,TSLA  ,2023-02-10,2025-01-17,450.0,3609,4,3613
2095,TSLA  ,2023-02-10,2025-01-17,460.0,896,4,900
2096,TSLA  ,2023-02-10,2025-01-17,470.0,1554,6,1560
2097,TSLA  ,2023-02-10,2025-01-17,480.0,1242,1,1243
2098,TSLA  ,2023-02-10,2025-01-17,490.0,702,0,702
2099,TSLA  ,2023-02-10,2025-01-17,500.0,10688,3,10691
2100,TSLA  ,2023-02-10,2025-01-17,510.0,960,1,961
2101,TSLA  ,2023-02-10,2025-01-17,520.0,8340,1,8341
2102,TSLA  ,2023-02-10,2025-01-17,530.0,643,0,643
2103,TSLA  ,2023-02-10,2025-01-17,540.0,614,0,614
2104,TSLA  ,2023-02-10,2025-01-17,550.0,3138,0,3138
2105,TSLA  ,2023-02-10,2025-01-17,560.0,629,0,629
2106,TSLA  ,2023-02-10,2025-01-17,570.0,671,2,673
2107,TSLA  ,2023-02-10,2025-01-17,580.0,846,0,846
2108,TSLA  ,2023-02-10,2025-01-17,590.0,804,0,804
2109,TSLA  ,2023-02-10,2025-01-17,600.0,15034,5,15039
2110,TSLA  ,2023-02-10,2025-01-17,610.0,17226,0,17226
2111,TSLA  ,2023-02-10,2025-06-20,5.0,204,870,1074
2112,TSLA  ,2023-02-10,2025-06-20,10.0,3,85,88
2113,TSLA  ,2023-02-10,2025-06-20,15.0,7,5808,5815
2114,TSLA  ,2023-02-10,2025-06-20,20.0,51,410,461
2115,TSLA  ,2023-02-10,2025-06-20,25.0,9,123,132
2116,TSLA  ,2023-02-10,2025-06-20,30.0,83,236,319
2117,TSLA  ,2023-02-10,2025-06-20,35.0,11,178,189
2118,TSLA  ,2023-02-10,2025-06-20,40.0,9,288,297
2119,TSLA  ,2023-02-10,2025-06-20,45.0,16,52,68
2120,TSLA  ,2023-02-10,2025-06-20,50.0,146,710,856
2121,TSLA  ,2023-02-10,2025-06-20,55.0,10,54,64
2122,TSLA  ,2023-02-10,2025-06-20,60.0,16,617,633
2123,TSLA  ,2023-02-10,2025-06-20,65.0,19,575,594
2124,TSLA  ,2023-02-10,2025-06-20,70.0,163,124,287
2125,TSLA  ,2023-02-10,2025-06-20,75.0,121,1283,1404
2126,TSLA  ,2023-02-10,2025-06-20,80.0,802,434,1236
2127,TSLA  ,2023-02-10,2025-06-20,85.0,348,243,591
2128,TSLA  ,2023-02-10,2025-06-20,90.0,10298,429,10727
2129,TSLA  ,2023-02-10,2025-06-20,95.0,46411,532,46943
2130,TSLA  ,2023-02-10,2025-06-20,100.0,913,5280,6193
2131,TSLA  ,2023-02-10,2025-06-20,105.0,158,434,592
2132,TSLA  ,2023-02-10,2025-06-20,110.0,350,1607,1957
2133,TSLA  ,2023-02-10,2025-06-20,115.0,436,278,714
2134,TSLA  ,2023-02-10,2025-06-20,120.0,502,956,1458
2135,TSLA  ,2023-02-10,2025-06-20,125.0,513,362,875
2136,TSLA  ,2023-02-10,2025-06-20,130.0,2622,2036,4658
2137,TSLA  ,2023-02-10,2025-06-20,135.0,4714,165,4879
2138,TSLA  ,2023-02-10,2025-06-20,140.0,981,2305,3286
2139,TSLA  ,2023-02-10,2025-06-20,145.0,397,481,878
2140,TSLA  ,2023-02-10,2025-06-20,150.0,1342,1300,2642
2141,TSLA  ,2023-02-10,2025-06-20,155.0,412,124,536
2142,TSLA  ,2023-02-10,2025-06-20,160.0,2165,1128,3293
2143,TSLA  ,2023-02-10,2025-06-20,165.0,921,330,1251
2144,TSLA  ,2023-02-10,2025-06-20,170.0,2833,1429,4262
2145,TSLA  ,2023-02-10,2025-06-20,175.0,730,1149,1879
2146,TSLA  ,2023-02-10,2025-06-20,180.0,623,1108,1731
2147,TSLA  ,2023-02-10,2025-06-20,185.0,2461,167,2628
2148,TSLA  ,2023-02-10,2025-06-20,190.0,477,238,715
2149,TSLA  ,2023-02-10,2025-06-20,195.0,292,365,657
2150,TSLA  ,2023-02-10,2025-06-20,200.0,3853,3199,7052
2151,TSLA  ,2023-02-10,2025-06-20,205.0,201,212,413
2152,TSLA  ,2023-02-10,2025-06-20,210.0,352,111,463
2153,TSLA  ,2023-02-10,2025-06-20,215.0,105,37,142
2154,TSLA  ,2023-02-10,2025-06-20,220.0,672,89,761
2155,TSLA  ,2023-02-10,2025-06-20,225.0,432,190,622
2156,TSLA  ,2023-02-10,2025-06-20,230.0,445,44,489
2157,TSLA  ,2023-02-10,2025-06-20,235.0,324,253,577
2158,TSLA  ,2023-02-10,2025-06-20,240.0,4360,325,4685
2159,TSLA  ,2023-02-10,2025-06-20,250.0,1363,521,1884
2160,TSLA  ,2023-02-10,2025-06-20,260.0,447,324,771
2161,TSLA  ,2023-02-10,2025-06-20,270.0,484,102,586
2162,TSLA  ,2023-02-10,2025-06-20,280.0,227,225,452
2163,TSLA  ,2023-02-10,2025-06-20,290.0,222,288,510
2164,TSLA  ,2023-02-10,2025-06-20,300.0,2660,586,3246
2165,TSLA  ,2023-02-10,2025-06-20,310.0,179,179,358
2166,TSLA  ,2023-02-10,2025-06-20,320.0,935,284,1219
2167,TSLA  ,2023-02-10,2025-06-20,330.0,191,186,377
2168,TSLA  ,2023-02-10,2025-06-20,340.0,317,243,560
2169,TSLA  ,2023-02-10,2025-06-20,350.0,1998,193,2191
2170,TSLA  ,2023-02-10,2025-06-20,360.0,658,197,855
2171,TSLA  ,2023-02-10,2025-06-20,370.0,65,153,218
2172,TSLA  ,2023-02-10,2025-06-20,380.0,72,12,84
2173,TSLA  ,2023-02-10,2025-06-20,390.0,1497,63,1560
