index,ProductSymbol,DateGen,ExpDate,Strike,Call,Put,TotalOI
0,TSLA  ,2023-02-22,2023-02-24,15.0,24,16,40
1,TSLA  ,2023-02-22,2023-02-24,20.0,9,1,10
2,TSLA  ,2023-02-22,2023-02-24,25.0,13,3,16
3,TSLA  ,2023-02-22,2023-02-24,30.0,3,748,751
4,TSLA  ,2023-02-22,2023-02-24,35.0,0,25,25
5,TSLA  ,2023-02-22,2023-02-24,40.0,0,439,439
6,TSLA  ,2023-02-22,2023-02-24,45.0,0,2046,2046
7,TSLA  ,2023-02-22,2023-02-24,50.0,103,1898,2001
8,TSLA  ,2023-02-22,2023-02-24,55.0,3,806,809
9,TSLA  ,2023-02-22,2023-02-24,60.0,11,1451,1462
10,TSLA  ,2023-02-22,2023-02-24,65.0,6,701,707
11,TSLA  ,2023-02-22,2023-02-24,70.0,6,599,605
12,TSLA  ,2023-02-22,2023-02-24,75.0,1,852,853
13,TSLA  ,2023-02-22,2023-02-24,80.0,6,1122,1128
14,TSLA  ,2023-02-22,2023-02-24,85.0,1,638,639
15,TSLA  ,2023-02-22,2023-02-24,90.0,85,1507,1592
16,TSLA  ,2023-02-22,2023-02-24,95.0,18,1936,1954
17,TSLA  ,2023-02-22,2023-02-24,98.0,14,975,989
18,TSLA  ,2023-02-22,2023-02-24,99.0,17,636,653
19,TSLA  ,2023-02-22,2023-02-24,100.0,82,2492,2574
20,TSLA  ,2023-02-22,2023-02-24,101.0,19,475,494
21,TSLA  ,2023-02-22,2023-02-24,102.0,12,244,256
22,TSLA  ,2023-02-22,2023-02-24,103.0,8,314,322
23,TSLA  ,2023-02-22,2023-02-24,104.0,15,423,438
24,TSLA  ,2023-02-22,2023-02-24,105.0,110,2223,2333
25,TSLA  ,2023-02-22,2023-02-24,106.0,12,682,694
26,TSLA  ,2023-02-22,2023-02-24,107.0,13,1529,1542
27,TSLA  ,2023-02-22,2023-02-24,108.0,37,718,755
28,TSLA  ,2023-02-22,2023-02-24,109.0,42,1058,1100
29,TSLA  ,2023-02-22,2023-02-24,110.0,354,1884,2238
30,TSLA  ,2023-02-22,2023-02-24,111.0,75,497,572
31,TSLA  ,2023-02-22,2023-02-24,112.0,53,599,652
32,TSLA  ,2023-02-22,2023-02-24,113.0,45,1553,1598
33,TSLA  ,2023-02-22,2023-02-24,114.0,352,1057,1409
34,TSLA  ,2023-02-22,2023-02-24,115.0,371,2137,2508
35,TSLA  ,2023-02-22,2023-02-24,116.0,328,2438,2766
36,TSLA  ,2023-02-22,2023-02-24,117.0,263,1247,1510
37,TSLA  ,2023-02-22,2023-02-24,118.0,215,1088,1303
38,TSLA  ,2023-02-22,2023-02-24,119.0,220,792,1012
39,TSLA  ,2023-02-22,2023-02-24,120.0,459,2978,3437
40,TSLA  ,2023-02-22,2023-02-24,121.0,317,819,1136
41,TSLA  ,2023-02-22,2023-02-24,122.0,291,2727,3018
42,TSLA  ,2023-02-22,2023-02-24,123.0,428,579,1007
43,TSLA  ,2023-02-22,2023-02-24,124.0,164,848,1012
44,TSLA  ,2023-02-22,2023-02-24,125.0,675,4648,5323
45,TSLA  ,2023-02-22,2023-02-24,126.0,206,712,918
46,TSLA  ,2023-02-22,2023-02-24,127.0,115,1265,1380
47,TSLA  ,2023-02-22,2023-02-24,128.0,168,1323,1491
48,TSLA  ,2023-02-22,2023-02-24,129.0,223,1499,1722
49,TSLA  ,2023-02-22,2023-02-24,130.0,2692,3323,6015
50,TSLA  ,2023-02-22,2023-02-24,131.0,428,1033,1461
51,TSLA  ,2023-02-22,2023-02-24,132.0,254,1525,1779
52,TSLA  ,2023-02-22,2023-02-24,133.0,146,734,880
53,TSLA  ,2023-02-22,2023-02-24,134.0,268,934,1202
54,TSLA  ,2023-02-22,2023-02-24,135.0,1927,3226,5153
55,TSLA  ,2023-02-22,2023-02-24,136.0,108,669,777
56,TSLA  ,2023-02-22,2023-02-24,137.0,139,1740,1879
57,TSLA  ,2023-02-22,2023-02-24,138.0,256,966,1222
58,TSLA  ,2023-02-22,2023-02-24,139.0,535,762,1297
59,TSLA  ,2023-02-22,2023-02-24,140.0,1548,7568,9116
60,TSLA  ,2023-02-22,2023-02-24,141.0,336,1855,2191
61,TSLA  ,2023-02-22,2023-02-24,142.0,477,1477,1954
62,TSLA  ,2023-02-22,2023-02-24,143.0,72,864,936
63,TSLA  ,2023-02-22,2023-02-24,144.0,102,3105,3207
64,TSLA  ,2023-02-22,2023-02-24,145.0,2013,6839,8852
65,TSLA  ,2023-02-22,2023-02-24,146.0,90,3006,3096
66,TSLA  ,2023-02-22,2023-02-24,147.0,97,845,942
67,TSLA  ,2023-02-22,2023-02-24,148.0,163,3223,3386
68,TSLA  ,2023-02-22,2023-02-24,149.0,119,3261,3380
69,TSLA  ,2023-02-22,2023-02-24,150.0,3172,10377,13549
70,TSLA  ,2023-02-22,2023-02-24,152.5,69,2901,2970
71,TSLA  ,2023-02-22,2023-02-24,155.0,2762,9415,12177
72,TSLA  ,2023-02-22,2023-02-24,157.5,1169,7164,8333
73,TSLA  ,2023-02-22,2023-02-24,160.0,3937,10381,14318
74,TSLA  ,2023-02-22,2023-02-24,162.5,473,3809,4282
75,TSLA  ,2023-02-22,2023-02-24,165.0,2680,8236,10916
76,TSLA  ,2023-02-22,2023-02-24,167.5,1084,5184,6268
77,TSLA  ,2023-02-22,2023-02-24,170.0,9367,14290,23657
78,TSLA  ,2023-02-22,2023-02-24,172.5,782,3406,4188
79,TSLA  ,2023-02-22,2023-02-24,175.0,4275,12971,17246
80,TSLA  ,2023-02-22,2023-02-24,177.5,431,7826,8257
81,TSLA  ,2023-02-22,2023-02-24,180.0,5442,24790,30232
82,TSLA  ,2023-02-22,2023-02-24,182.5,625,11961,12586
83,TSLA  ,2023-02-22,2023-02-24,185.0,2183,15806,17989
84,TSLA  ,2023-02-22,2023-02-24,187.5,1256,9224,10480
85,TSLA  ,2023-02-22,2023-02-24,190.0,13043,27241,40284
86,TSLA  ,2023-02-22,2023-02-24,192.5,1483,8621,10104
87,TSLA  ,2023-02-22,2023-02-24,195.0,5226,10762,15988
88,TSLA  ,2023-02-22,2023-02-24,197.5,2498,6095,8593
89,TSLA  ,2023-02-22,2023-02-24,200.0,20030,18831,38861
90,TSLA  ,2023-02-22,2023-02-24,202.5,10593,5298,15891
91,TSLA  ,2023-02-22,2023-02-24,205.0,20630,9399,30029
92,TSLA  ,2023-02-22,2023-02-24,207.5,10393,3962,14355
93,TSLA  ,2023-02-22,2023-02-24,210.0,42153,7351,49504
94,TSLA  ,2023-02-22,2023-02-24,212.5,8169,3445,11614
95,TSLA  ,2023-02-22,2023-02-24,215.0,22914,6758,29672
96,TSLA  ,2023-02-22,2023-02-24,217.5,6248,1905,8153
97,TSLA  ,2023-02-22,2023-02-24,220.0,34873,2721,37594
98,TSLA  ,2023-02-22,2023-02-24,222.5,7678,853,8531
99,TSLA  ,2023-02-22,2023-02-24,225.0,24164,1380,25544
100,TSLA  ,2023-02-22,2023-02-24,227.5,7202,514,7716
101,TSLA  ,2023-02-22,2023-02-24,230.0,24667,2964,27631
102,TSLA  ,2023-02-22,2023-02-24,232.5,4711,600,5311
103,TSLA  ,2023-02-22,2023-02-24,235.0,6851,1584,8435
104,TSLA  ,2023-02-22,2023-02-24,237.5,3171,729,3900
105,TSLA  ,2023-02-22,2023-02-24,240.0,19594,2630,22224
106,TSLA  ,2023-02-22,2023-02-24,242.5,3113,336,3449
107,TSLA  ,2023-02-22,2023-02-24,245.0,6819,375,7194
108,TSLA  ,2023-02-22,2023-02-24,247.5,3822,145,3967
109,TSLA  ,2023-02-22,2023-02-24,250.0,12815,552,13367
110,TSLA  ,2023-02-22,2023-02-24,252.5,1680,27,1707
111,TSLA  ,2023-02-22,2023-02-24,255.0,5650,42,5692
112,TSLA  ,2023-02-22,2023-02-24,257.5,4128,58,4186
113,TSLA  ,2023-02-22,2023-02-24,260.0,12219,8,12227
114,TSLA  ,2023-02-22,2023-02-24,262.5,2716,22,2738
115,TSLA  ,2023-02-22,2023-02-24,265.0,5742,14,5756
116,TSLA  ,2023-02-22,2023-02-24,267.5,3688,4,3692
117,TSLA  ,2023-02-22,2023-02-24,270.0,6252,9,6261
118,TSLA  ,2023-02-22,2023-02-24,272.5,735,0,735
119,TSLA  ,2023-02-22,2023-02-24,275.0,10148,9,10157
120,TSLA  ,2023-02-22,2023-02-24,277.5,704,0,704
121,TSLA  ,2023-02-22,2023-02-24,280.0,4763,0,4763
122,TSLA  ,2023-02-22,2023-02-24,282.5,302,4,306
123,TSLA  ,2023-02-22,2023-02-24,285.0,6666,0,6666
124,TSLA  ,2023-02-22,2023-02-24,290.0,3576,1,3577
125,TSLA  ,2023-02-22,2023-02-24,295.0,6304,0,6304
126,TSLA  ,2023-02-22,2023-02-24,300.0,5104,13,5117
127,TSLA  ,2023-02-22,2023-02-24,310.0,2663,0,2663
128,TSLA  ,2023-02-22,2023-02-24,320.0,1679,0,1679
129,TSLA  ,2023-02-22,2023-02-24,330.0,1458,0,1458
130,TSLA  ,2023-02-22,2023-02-24,340.0,1516,0,1516
131,TSLA  ,2023-02-22,2023-02-24,350.0,3035,0,3035
132,TSLA  ,2023-02-22,2023-02-24,360.0,10120,0,10120
133,TSLA  ,2023-02-22,2023-03-03,15.0,11,367,378
134,TSLA  ,2023-02-22,2023-03-03,20.0,1,0,1
135,TSLA  ,2023-02-22,2023-03-03,25.0,4,52,56
136,TSLA  ,2023-02-22,2023-03-03,30.0,5,340,345
137,TSLA  ,2023-02-22,2023-03-03,35.0,3,1,4
138,TSLA  ,2023-02-22,2023-03-03,40.0,0,10,10
139,TSLA  ,2023-02-22,2023-03-03,45.0,0,2457,2457
140,TSLA  ,2023-02-22,2023-03-03,50.0,7,895,902
141,TSLA  ,2023-02-22,2023-03-03,55.0,0,165,165
142,TSLA  ,2023-02-22,2023-03-03,60.0,2,1118,1120
143,TSLA  ,2023-02-22,2023-03-03,65.0,1,102,103
144,TSLA  ,2023-02-22,2023-03-03,70.0,2,996,998
145,TSLA  ,2023-02-22,2023-03-03,75.0,1,316,317
146,TSLA  ,2023-02-22,2023-03-03,80.0,112,2291,2403
147,TSLA  ,2023-02-22,2023-03-03,85.0,4,583,587
148,TSLA  ,2023-02-22,2023-03-03,90.0,7,1413,1420
149,TSLA  ,2023-02-22,2023-03-03,95.0,6,2004,2010
150,TSLA  ,2023-02-22,2023-03-03,100.0,108,2231,2339
151,TSLA  ,2023-02-22,2023-03-03,105.0,19,1071,1090
152,TSLA  ,2023-02-22,2023-03-03,108.0,52,967,1019
153,TSLA  ,2023-02-22,2023-03-03,109.0,34,725,759
154,TSLA  ,2023-02-22,2023-03-03,110.0,88,4013,4101
155,TSLA  ,2023-02-22,2023-03-03,111.0,21,611,632
156,TSLA  ,2023-02-22,2023-03-03,112.0,49,646,695
157,TSLA  ,2023-02-22,2023-03-03,113.0,33,834,867
158,TSLA  ,2023-02-22,2023-03-03,114.0,154,638,792
159,TSLA  ,2023-02-22,2023-03-03,115.0,211,879,1090
160,TSLA  ,2023-02-22,2023-03-03,116.0,189,609,798
161,TSLA  ,2023-02-22,2023-03-03,117.0,484,804,1288
162,TSLA  ,2023-02-22,2023-03-03,118.0,315,807,1122
163,TSLA  ,2023-02-22,2023-03-03,119.0,325,690,1015
164,TSLA  ,2023-02-22,2023-03-03,120.0,942,2996,3938
165,TSLA  ,2023-02-22,2023-03-03,121.0,93,764,857
166,TSLA  ,2023-02-22,2023-03-03,122.0,123,1251,1374
167,TSLA  ,2023-02-22,2023-03-03,123.0,254,1754,2008
168,TSLA  ,2023-02-22,2023-03-03,124.0,458,1540,1998
169,TSLA  ,2023-02-22,2023-03-03,125.0,328,2770,3098
170,TSLA  ,2023-02-22,2023-03-03,126.0,663,627,1290
171,TSLA  ,2023-02-22,2023-03-03,127.0,434,347,781
172,TSLA  ,2023-02-22,2023-03-03,128.0,463,814,1277
173,TSLA  ,2023-02-22,2023-03-03,129.0,653,1557,2210
174,TSLA  ,2023-02-22,2023-03-03,130.0,695,4275,4970
175,TSLA  ,2023-02-22,2023-03-03,131.0,325,811,1136
176,TSLA  ,2023-02-22,2023-03-03,132.0,797,777,1574
177,TSLA  ,2023-02-22,2023-03-03,133.0,574,1301,1875
178,TSLA  ,2023-02-22,2023-03-03,134.0,609,1280,1889
179,TSLA  ,2023-02-22,2023-03-03,135.0,889,2423,3312
180,TSLA  ,2023-02-22,2023-03-03,136.0,114,142,256
181,TSLA  ,2023-02-22,2023-03-03,137.0,99,644,743
182,TSLA  ,2023-02-22,2023-03-03,138.0,141,1427,1568
183,TSLA  ,2023-02-22,2023-03-03,139.0,115,387,502
184,TSLA  ,2023-02-22,2023-03-03,140.0,689,3532,4221
185,TSLA  ,2023-02-22,2023-03-03,141.0,81,700,781
186,TSLA  ,2023-02-22,2023-03-03,142.0,305,408,713
187,TSLA  ,2023-02-22,2023-03-03,143.0,74,216,290
188,TSLA  ,2023-02-22,2023-03-03,144.0,28,3170,3198
189,TSLA  ,2023-02-22,2023-03-03,145.0,716,3016,3732
190,TSLA  ,2023-02-22,2023-03-03,146.0,66,1560,1626
191,TSLA  ,2023-02-22,2023-03-03,147.0,44,293,337
192,TSLA  ,2023-02-22,2023-03-03,148.0,58,539,597
193,TSLA  ,2023-02-22,2023-03-03,149.0,324,1897,2221
194,TSLA  ,2023-02-22,2023-03-03,150.0,1109,12437,13546
195,TSLA  ,2023-02-22,2023-03-03,152.5,190,2177,2367
196,TSLA  ,2023-02-22,2023-03-03,155.0,1831,1598,3429
197,TSLA  ,2023-02-22,2023-03-03,157.5,202,1736,1938
198,TSLA  ,2023-02-22,2023-03-03,160.0,1412,11080,12492
199,TSLA  ,2023-02-22,2023-03-03,162.5,416,2813,3229
200,TSLA  ,2023-02-22,2023-03-03,165.0,1921,3422,5343
201,TSLA  ,2023-02-22,2023-03-03,167.5,277,2104,2381
202,TSLA  ,2023-02-22,2023-03-03,170.0,2867,6538,9405
203,TSLA  ,2023-02-22,2023-03-03,172.5,1361,1444,2805
204,TSLA  ,2023-02-22,2023-03-03,175.0,1412,4225,5637
205,TSLA  ,2023-02-22,2023-03-03,177.5,641,848,1489
206,TSLA  ,2023-02-22,2023-03-03,180.0,3053,5397,8450
207,TSLA  ,2023-02-22,2023-03-03,182.5,445,1449,1894
208,TSLA  ,2023-02-22,2023-03-03,185.0,2124,4757,6881
209,TSLA  ,2023-02-22,2023-03-03,187.5,1560,1062,2622
210,TSLA  ,2023-02-22,2023-03-03,190.0,3500,7617,11117
211,TSLA  ,2023-02-22,2023-03-03,192.5,1334,1703,3037
212,TSLA  ,2023-02-22,2023-03-03,195.0,3224,3356,6580
213,TSLA  ,2023-02-22,2023-03-03,197.5,2428,1890,4318
214,TSLA  ,2023-02-22,2023-03-03,200.0,22423,6290,28713
215,TSLA  ,2023-02-22,2023-03-03,202.5,5048,1962,7010
216,TSLA  ,2023-02-22,2023-03-03,205.0,6438,2310,8748
217,TSLA  ,2023-02-22,2023-03-03,207.5,2933,1842,4775
218,TSLA  ,2023-02-22,2023-03-03,210.0,16392,5841,22233
219,TSLA  ,2023-02-22,2023-03-03,212.5,2259,1098,3357
220,TSLA  ,2023-02-22,2023-03-03,215.0,6005,1377,7382
221,TSLA  ,2023-02-22,2023-03-03,217.5,2089,953,3042
222,TSLA  ,2023-02-22,2023-03-03,220.0,27314,1347,28661
223,TSLA  ,2023-02-22,2023-03-03,222.5,1745,209,1954
224,TSLA  ,2023-02-22,2023-03-03,225.0,7948,229,8177
225,TSLA  ,2023-02-22,2023-03-03,227.5,1112,105,1217
226,TSLA  ,2023-02-22,2023-03-03,230.0,9460,482,9942
227,TSLA  ,2023-02-22,2023-03-03,232.5,852,233,1085
228,TSLA  ,2023-02-22,2023-03-03,235.0,2936,552,3488
229,TSLA  ,2023-02-22,2023-03-03,237.5,715,157,872
230,TSLA  ,2023-02-22,2023-03-03,240.0,7181,861,8042
231,TSLA  ,2023-02-22,2023-03-03,242.5,389,70,459
232,TSLA  ,2023-02-22,2023-03-03,245.0,4515,265,4780
233,TSLA  ,2023-02-22,2023-03-03,247.5,471,69,540
234,TSLA  ,2023-02-22,2023-03-03,250.0,9666,239,9905
235,TSLA  ,2023-02-22,2023-03-03,252.5,279,60,339
236,TSLA  ,2023-02-22,2023-03-03,255.0,4237,55,4292
237,TSLA  ,2023-02-22,2023-03-03,257.5,172,52,224
238,TSLA  ,2023-02-22,2023-03-03,260.0,3066,132,3198
239,TSLA  ,2023-02-22,2023-03-03,262.5,290,93,383
240,TSLA  ,2023-02-22,2023-03-03,265.0,4141,176,4317
241,TSLA  ,2023-02-22,2023-03-03,267.5,161,199,360
242,TSLA  ,2023-02-22,2023-03-03,270.0,4430,361,4791
243,TSLA  ,2023-02-22,2023-03-03,275.0,4353,354,4707
244,TSLA  ,2023-02-22,2023-03-03,280.0,2502,147,2649
245,TSLA  ,2023-02-22,2023-03-03,285.0,2412,75,2487
246,TSLA  ,2023-02-22,2023-03-03,290.0,3209,8,3217
247,TSLA  ,2023-02-22,2023-03-03,295.0,2256,1,2257
248,TSLA  ,2023-02-22,2023-03-03,300.0,9417,27,9444
249,TSLA  ,2023-02-22,2023-03-03,305.0,1092,0,1092
250,TSLA  ,2023-02-22,2023-03-03,310.0,1484,0,1484
251,TSLA  ,2023-02-22,2023-03-03,315.0,2090,0,2090
252,TSLA  ,2023-02-22,2023-03-03,320.0,4941,5,4946
253,TSLA  ,2023-02-22,2023-03-03,325.0,3098,0,3098
254,TSLA  ,2023-02-22,2023-03-03,330.0,3396,0,3396
255,TSLA  ,2023-02-22,2023-03-03,335.0,1061,0,1061
256,TSLA  ,2023-02-22,2023-03-03,340.0,7038,0,7038
257,TSLA  ,2023-02-22,2023-03-03,345.0,99,0,99
258,TSLA  ,2023-02-22,2023-03-03,350.0,1068,1,1069
259,TSLA  ,2023-02-22,2023-03-03,360.0,3472,0,3472
260,TSLA  ,2023-02-22,2023-03-10,15.0,3,100,103
261,TSLA  ,2023-02-22,2023-03-10,20.0,3,25,28
262,TSLA  ,2023-02-22,2023-03-10,25.0,0,0,0
263,TSLA  ,2023-02-22,2023-03-10,30.0,3,2,5
264,TSLA  ,2023-02-22,2023-03-10,35.0,0,0,0
265,TSLA  ,2023-02-22,2023-03-10,40.0,0,10,10
266,TSLA  ,2023-02-22,2023-03-10,45.0,0,65,65
267,TSLA  ,2023-02-22,2023-03-10,50.0,5,927,932
268,TSLA  ,2023-02-22,2023-03-10,55.0,1,1209,1210
269,TSLA  ,2023-02-22,2023-03-10,60.0,0,42,42
270,TSLA  ,2023-02-22,2023-03-10,65.0,50,23,73
271,TSLA  ,2023-02-22,2023-03-10,70.0,0,129,129
272,TSLA  ,2023-02-22,2023-03-10,75.0,0,510,510
273,TSLA  ,2023-02-22,2023-03-10,80.0,0,338,338
274,TSLA  ,2023-02-22,2023-03-10,85.0,0,96,96
275,TSLA  ,2023-02-22,2023-03-10,90.0,0,316,316
276,TSLA  ,2023-02-22,2023-03-10,95.0,11,588,599
277,TSLA  ,2023-02-22,2023-03-10,100.0,23,812,835
278,TSLA  ,2023-02-22,2023-03-10,105.0,6,487,493
279,TSLA  ,2023-02-22,2023-03-10,110.0,22,928,950
280,TSLA  ,2023-02-22,2023-03-10,115.0,24,695,719
281,TSLA  ,2023-02-22,2023-03-10,120.0,51,1598,1649
282,TSLA  ,2023-02-22,2023-03-10,125.0,20,878,898
283,TSLA  ,2023-02-22,2023-03-10,130.0,90,707,797
284,TSLA  ,2023-02-22,2023-03-10,134.0,25,195,220
285,TSLA  ,2023-02-22,2023-03-10,135.0,40,657,697
286,TSLA  ,2023-02-22,2023-03-10,136.0,55,199,254
287,TSLA  ,2023-02-22,2023-03-10,137.0,8,93,101
288,TSLA  ,2023-02-22,2023-03-10,138.0,16,110,126
289,TSLA  ,2023-02-22,2023-03-10,139.0,4,134,138
290,TSLA  ,2023-02-22,2023-03-10,140.0,73,1269,1342
291,TSLA  ,2023-02-22,2023-03-10,141.0,143,458,601
292,TSLA  ,2023-02-22,2023-03-10,142.0,27,240,267
293,TSLA  ,2023-02-22,2023-03-10,143.0,21,320,341
294,TSLA  ,2023-02-22,2023-03-10,144.0,17,75,92
295,TSLA  ,2023-02-22,2023-03-10,145.0,107,448,555
296,TSLA  ,2023-02-22,2023-03-10,146.0,45,146,191
297,TSLA  ,2023-02-22,2023-03-10,147.0,99,153,252
298,TSLA  ,2023-02-22,2023-03-10,148.0,98,799,897
299,TSLA  ,2023-02-22,2023-03-10,149.0,22,248,270
300,TSLA  ,2023-02-22,2023-03-10,150.0,258,1620,1878
301,TSLA  ,2023-02-22,2023-03-10,152.5,145,425,570
302,TSLA  ,2023-02-22,2023-03-10,155.0,627,765,1392
303,TSLA  ,2023-02-22,2023-03-10,157.5,114,429,543
304,TSLA  ,2023-02-22,2023-03-10,160.0,272,1296,1568
305,TSLA  ,2023-02-22,2023-03-10,162.5,147,572,719
306,TSLA  ,2023-02-22,2023-03-10,165.0,304,1837,2141
307,TSLA  ,2023-02-22,2023-03-10,167.5,568,564,1132
308,TSLA  ,2023-02-22,2023-03-10,170.0,455,2530,2985
309,TSLA  ,2023-02-22,2023-03-10,172.5,289,602,891
310,TSLA  ,2023-02-22,2023-03-10,175.0,384,1302,1686
311,TSLA  ,2023-02-22,2023-03-10,177.5,1889,875,2764
312,TSLA  ,2023-02-22,2023-03-10,180.0,764,3237,4001
313,TSLA  ,2023-02-22,2023-03-10,182.5,243,490,733
314,TSLA  ,2023-02-22,2023-03-10,185.0,619,1232,1851
315,TSLA  ,2023-02-22,2023-03-10,187.5,1286,351,1637
316,TSLA  ,2023-02-22,2023-03-10,190.0,1665,2400,4065
317,TSLA  ,2023-02-22,2023-03-10,192.5,810,615,1425
318,TSLA  ,2023-02-22,2023-03-10,195.0,1124,5450,6574
319,TSLA  ,2023-02-22,2023-03-10,197.5,612,1061,1673
320,TSLA  ,2023-02-22,2023-03-10,200.0,2395,1781,4176
321,TSLA  ,2023-02-22,2023-03-10,202.5,1554,1105,2659
322,TSLA  ,2023-02-22,2023-03-10,205.0,1561,1844,3405
323,TSLA  ,2023-02-22,2023-03-10,207.5,912,749,1661
324,TSLA  ,2023-02-22,2023-03-10,210.0,2972,1085,4057
325,TSLA  ,2023-02-22,2023-03-10,212.5,1088,599,1687
326,TSLA  ,2023-02-22,2023-03-10,215.0,1996,2083,4079
327,TSLA  ,2023-02-22,2023-03-10,217.5,444,214,658
328,TSLA  ,2023-02-22,2023-03-10,220.0,2869,209,3078
329,TSLA  ,2023-02-22,2023-03-10,222.5,484,119,603
330,TSLA  ,2023-02-22,2023-03-10,225.0,1475,143,1618
331,TSLA  ,2023-02-22,2023-03-10,227.5,53,0,53
332,TSLA  ,2023-02-22,2023-03-10,230.0,1965,139,2104
333,TSLA  ,2023-02-22,2023-03-10,235.0,944,43,987
334,TSLA  ,2023-02-22,2023-03-10,240.0,1439,16,1455
335,TSLA  ,2023-02-22,2023-03-10,245.0,834,58,892
336,TSLA  ,2023-02-22,2023-03-10,250.0,3737,225,3962
337,TSLA  ,2023-02-22,2023-03-10,255.0,514,4,518
338,TSLA  ,2023-02-22,2023-03-10,260.0,1494,65,1559
339,TSLA  ,2023-02-22,2023-03-10,265.0,3828,3,3831
340,TSLA  ,2023-02-22,2023-03-10,270.0,810,5,815
341,TSLA  ,2023-02-22,2023-03-10,275.0,679,5,684
342,TSLA  ,2023-02-22,2023-03-10,280.0,2052,7,2059
343,TSLA  ,2023-02-22,2023-03-10,285.0,824,0,824
344,TSLA  ,2023-02-22,2023-03-10,290.0,635,3,638
345,TSLA  ,2023-02-22,2023-03-10,295.0,546,1,547
346,TSLA  ,2023-02-22,2023-03-10,300.0,2940,1,2941
347,TSLA  ,2023-02-22,2023-03-10,310.0,2727,5,2732
348,TSLA  ,2023-02-22,2023-03-10,320.0,2696,1,2697
349,TSLA  ,2023-02-22,2023-03-10,330.0,478,0,478
350,TSLA  ,2023-02-22,2023-03-10,340.0,502,0,502
351,TSLA  ,2023-02-22,2023-03-10,350.0,832,0,832
352,TSLA  ,2023-02-22,2023-03-10,360.0,1215,0,1215
353,TSLA  ,2023-02-22,2023-03-17,1.67,50,24731,24781
354,TSLA  ,2023-02-22,2023-03-17,3.33,29,6941,6970
355,TSLA  ,2023-02-22,2023-03-17,5.0,2,8008,8010
356,TSLA  ,2023-02-22,2023-03-17,6.67,58,4669,4727
357,TSLA  ,2023-02-22,2023-03-17,8.33,3,1379,1382
358,TSLA  ,2023-02-22,2023-03-17,10.0,838,4105,4943
359,TSLA  ,2023-02-22,2023-03-17,11.67,1692,5414,7106
360,TSLA  ,2023-02-22,2023-03-17,13.33,1657,2125,3782
361,TSLA  ,2023-02-22,2023-03-17,15.0,987,5169,6156
362,TSLA  ,2023-02-22,2023-03-17,16.67,863,15329,16192
363,TSLA  ,2023-02-22,2023-03-17,18.33,466,12017,12483
364,TSLA  ,2023-02-22,2023-03-17,33.33,454,33619,34073
365,TSLA  ,2023-02-22,2023-03-17,50.0,742,25142,25884
366,TSLA  ,2023-02-22,2023-03-17,55.0,34,10792,10826
367,TSLA  ,2023-02-22,2023-03-17,60.0,182,9795,9977
368,TSLA  ,2023-02-22,2023-03-17,65.0,25,3841,3866
369,TSLA  ,2023-02-22,2023-03-17,66.67,883,18642,19525
370,TSLA  ,2023-02-22,2023-03-17,70.0,49,8151,8200
371,TSLA  ,2023-02-22,2023-03-17,75.0,54,5399,5453
372,TSLA  ,2023-02-22,2023-03-17,80.0,208,11823,12031
373,TSLA  ,2023-02-22,2023-03-17,83.33,886,5179,6065
374,TSLA  ,2023-02-22,2023-03-17,85.0,90,3602,3692
375,TSLA  ,2023-02-22,2023-03-17,90.0,663,15985,16648
376,TSLA  ,2023-02-22,2023-03-17,95.0,337,3285,3622
377,TSLA  ,2023-02-22,2023-03-17,100.0,1827,38928,40755
378,TSLA  ,2023-02-22,2023-03-17,105.0,1403,4591,5994
379,TSLA  ,2023-02-22,2023-03-17,110.0,2708,13978,16686
380,TSLA  ,2023-02-22,2023-03-17,115.0,3392,9692,13084
381,TSLA  ,2023-02-22,2023-03-17,116.67,1371,10953,12324
382,TSLA  ,2023-02-22,2023-03-17,120.0,12419,25952,38371
383,TSLA  ,2023-02-22,2023-03-17,123.33,2747,6732,9479
384,TSLA  ,2023-02-22,2023-03-17,125.0,3562,12219,15781
385,TSLA  ,2023-02-22,2023-03-17,126.67,1686,6005,7691
386,TSLA  ,2023-02-22,2023-03-17,130.0,7382,11244,18626
387,TSLA  ,2023-02-22,2023-03-17,133.33,3431,9745,13176
388,TSLA  ,2023-02-22,2023-03-17,135.0,27621,34198,61819
389,TSLA  ,2023-02-22,2023-03-17,136.67,3043,3650,6693
390,TSLA  ,2023-02-22,2023-03-17,140.0,6998,28774,35772
391,TSLA  ,2023-02-22,2023-03-17,143.33,2428,4730,7158
392,TSLA  ,2023-02-22,2023-03-17,145.0,3815,8226,12041
393,TSLA  ,2023-02-22,2023-03-17,146.67,1891,4267,6158
394,TSLA  ,2023-02-22,2023-03-17,150.0,13087,28689,41776
395,TSLA  ,2023-02-22,2023-03-17,153.33,1680,2873,4553
396,TSLA  ,2023-02-22,2023-03-17,155.0,4902,6224,11126
397,TSLA  ,2023-02-22,2023-03-17,156.67,2242,3513,5755
398,TSLA  ,2023-02-22,2023-03-17,160.0,7791,26614,34405
399,TSLA  ,2023-02-22,2023-03-17,163.33,3070,5869,8939
400,TSLA  ,2023-02-22,2023-03-17,165.0,7013,7285,14298
401,TSLA  ,2023-02-22,2023-03-17,166.67,6293,12029,18322
402,TSLA  ,2023-02-22,2023-03-17,170.0,11733,23345,35078
403,TSLA  ,2023-02-22,2023-03-17,172.5,5,122,127
404,TSLA  ,2023-02-22,2023-03-17,173.33,3216,12402,15618
405,TSLA  ,2023-02-22,2023-03-17,175.0,4886,9998,14884
406,TSLA  ,2023-02-22,2023-03-17,176.67,5206,3584,8790
407,TSLA  ,2023-02-22,2023-03-17,177.5,8,63,71
408,TSLA  ,2023-02-22,2023-03-17,180.0,20216,25194,45410
409,TSLA  ,2023-02-22,2023-03-17,182.5,6,37,43
410,TSLA  ,2023-02-22,2023-03-17,183.33,3362,8214,11576
411,TSLA  ,2023-02-22,2023-03-17,185.0,3346,6609,9955
412,TSLA  ,2023-02-22,2023-03-17,186.67,2721,4623,7344
413,TSLA  ,2023-02-22,2023-03-17,187.5,3,293,296
414,TSLA  ,2023-02-22,2023-03-17,190.0,17019,24123,41142
415,TSLA  ,2023-02-22,2023-03-17,192.5,67,100,167
416,TSLA  ,2023-02-22,2023-03-17,193.33,1953,2605,4558
417,TSLA  ,2023-02-22,2023-03-17,195.0,13760,13717,27477
418,TSLA  ,2023-02-22,2023-03-17,196.67,2771,3455,6226
419,TSLA  ,2023-02-22,2023-03-17,197.5,131,334,465
420,TSLA  ,2023-02-22,2023-03-17,198.33,4001,3019,7020
421,TSLA  ,2023-02-22,2023-03-17,200.0,44783,40359,85142
422,TSLA  ,2023-02-22,2023-03-17,201.67,4837,2603,7440
423,TSLA  ,2023-02-22,2023-03-17,202.5,631,181,812
424,TSLA  ,2023-02-22,2023-03-17,203.33,3210,3076,6286
425,TSLA  ,2023-02-22,2023-03-17,205.0,4567,4392,8959
426,TSLA  ,2023-02-22,2023-03-17,206.67,2975,2987,5962
427,TSLA  ,2023-02-22,2023-03-17,207.5,223,97,320
428,TSLA  ,2023-02-22,2023-03-17,208.33,2803,1466,4269
429,TSLA  ,2023-02-22,2023-03-17,210.0,12424,6171,18595
430,TSLA  ,2023-02-22,2023-03-17,211.67,2308,868,3176
431,TSLA  ,2023-02-22,2023-03-17,212.5,80,93,173
432,TSLA  ,2023-02-22,2023-03-17,213.33,2115,1158,3273
433,TSLA  ,2023-02-22,2023-03-17,215.0,14523,6659,21182
434,TSLA  ,2023-02-22,2023-03-17,216.67,4870,2907,7777
435,TSLA  ,2023-02-22,2023-03-17,217.5,106,14,120
436,TSLA  ,2023-02-22,2023-03-17,218.33,1767,4886,6653
437,TSLA  ,2023-02-22,2023-03-17,220.0,17648,1968,19616
438,TSLA  ,2023-02-22,2023-03-17,221.67,1692,369,2061
439,TSLA  ,2023-02-22,2023-03-17,222.5,261,8,269
440,TSLA  ,2023-02-22,2023-03-17,223.33,1405,388,1793
441,TSLA  ,2023-02-22,2023-03-17,225.0,5433,1785,7218
442,TSLA  ,2023-02-22,2023-03-17,226.67,2624,233,2857
443,TSLA  ,2023-02-22,2023-03-17,227.5,46,8,54
444,TSLA  ,2023-02-22,2023-03-17,228.33,5139,89,5228
445,TSLA  ,2023-02-22,2023-03-17,230.0,9935,1866,11801
446,TSLA  ,2023-02-22,2023-03-17,231.67,1521,110,1631
447,TSLA  ,2023-02-22,2023-03-17,233.33,6835,438,7273
448,TSLA  ,2023-02-22,2023-03-17,235.0,9514,123,9637
449,TSLA  ,2023-02-22,2023-03-17,236.67,1315,88,1403
450,TSLA  ,2023-02-22,2023-03-17,238.33,1139,113,1252
451,TSLA  ,2023-02-22,2023-03-17,240.0,8787,381,9168
452,TSLA  ,2023-02-22,2023-03-17,241.67,1188,66,1254
453,TSLA  ,2023-02-22,2023-03-17,243.33,1531,415,1946
454,TSLA  ,2023-02-22,2023-03-17,245.0,2578,43,2621
455,TSLA  ,2023-02-22,2023-03-17,246.67,1326,32,1358
456,TSLA  ,2023-02-22,2023-03-17,248.33,1289,35,1324
457,TSLA  ,2023-02-22,2023-03-17,250.0,26176,2099,28275
458,TSLA  ,2023-02-22,2023-03-17,251.67,1508,65,1573
459,TSLA  ,2023-02-22,2023-03-17,253.33,784,55,839
460,TSLA  ,2023-02-22,2023-03-17,255.0,5081,81,5162
461,TSLA  ,2023-02-22,2023-03-17,256.67,785,21,806
462,TSLA  ,2023-02-22,2023-03-17,258.33,1008,27,1035
463,TSLA  ,2023-02-22,2023-03-17,260.0,10337,1410,11747
464,TSLA  ,2023-02-22,2023-03-17,261.67,1621,12,1633
465,TSLA  ,2023-02-22,2023-03-17,263.33,1105,66,1171
466,TSLA  ,2023-02-22,2023-03-17,265.0,2950,33,2983
467,TSLA  ,2023-02-22,2023-03-17,266.67,10975,392,11367
468,TSLA  ,2023-02-22,2023-03-17,270.0,5574,44,5618
469,TSLA  ,2023-02-22,2023-03-17,273.33,3866,84,3950
470,TSLA  ,2023-02-22,2023-03-17,275.0,1027,15,1042
471,TSLA  ,2023-02-22,2023-03-17,276.67,1580,42,1622
472,TSLA  ,2023-02-22,2023-03-17,280.0,4048,142,4190
473,TSLA  ,2023-02-22,2023-03-17,283.33,6762,53,6815
474,TSLA  ,2023-02-22,2023-03-17,285.0,1189,20,1209
475,TSLA  ,2023-02-22,2023-03-17,286.67,2060,46,2106
476,TSLA  ,2023-02-22,2023-03-17,290.0,3678,75,3753
477,TSLA  ,2023-02-22,2023-03-17,293.33,7352,353,7705
478,TSLA  ,2023-02-22,2023-03-17,295.0,2934,16,2950
479,TSLA  ,2023-02-22,2023-03-17,296.67,959,24,983
480,TSLA  ,2023-02-22,2023-03-17,298.33,1120,29,1149
481,TSLA  ,2023-02-22,2023-03-17,300.0,73699,470,74169
482,TSLA  ,2023-02-22,2023-03-17,301.67,1622,39,1661
483,TSLA  ,2023-02-22,2023-03-17,303.33,1464,11,1475
484,TSLA  ,2023-02-22,2023-03-17,305.0,2656,38,2694
485,TSLA  ,2023-02-22,2023-03-17,306.67,2007,36,2043
486,TSLA  ,2023-02-22,2023-03-17,308.33,3530,20,3550
487,TSLA  ,2023-02-22,2023-03-17,310.0,4399,44,4443
488,TSLA  ,2023-02-22,2023-03-17,311.67,2110,12,2122
489,TSLA  ,2023-02-22,2023-03-17,313.33,2557,21,2578
490,TSLA  ,2023-02-22,2023-03-17,316.67,29639,32,29671
491,TSLA  ,2023-02-22,2023-03-17,320.0,15211,216,15427
492,TSLA  ,2023-02-22,2023-03-17,323.33,458,5,463
493,TSLA  ,2023-02-22,2023-03-17,326.67,585,0,585
494,TSLA  ,2023-02-22,2023-03-17,330.0,3382,1,3383
495,TSLA  ,2023-02-22,2023-03-17,333.33,20494,25,20519
496,TSLA  ,2023-02-22,2023-03-17,336.67,827,0,827
497,TSLA  ,2023-02-22,2023-03-17,340.0,5889,0,5889
498,TSLA  ,2023-02-22,2023-03-17,343.33,1928,0,1928
499,TSLA  ,2023-02-22,2023-03-17,346.67,626,0,626
500,TSLA  ,2023-02-22,2023-03-17,350.0,11407,3,11410
501,TSLA  ,2023-02-22,2023-03-17,353.33,1458,0,1458
502,TSLA  ,2023-02-22,2023-03-17,356.67,745,0,745
503,TSLA  ,2023-02-22,2023-03-17,360.0,18779,0,18779
504,TSLA  ,2023-02-22,2023-03-17,363.33,568,0,568
505,TSLA  ,2023-02-22,2023-03-17,366.67,7749,0,7749
506,TSLA  ,2023-02-22,2023-03-17,370.0,1425,0,1425
507,TSLA  ,2023-02-22,2023-03-17,373.33,688,0,688
508,TSLA  ,2023-02-22,2023-03-17,383.33,12775,0,12775
509,TSLA  ,2023-02-22,2023-03-17,400.0,36863,0,36863
510,TSLA  ,2023-02-22,2023-03-17,416.67,13204,0,13204
511,TSLA  ,2023-02-22,2023-03-17,433.33,19822,0,19822
512,TSLA  ,2023-02-22,2023-03-17,441.67,2040,0,2040
513,TSLA  ,2023-02-22,2023-03-17,450.0,5845,0,5845
514,TSLA  ,2023-02-22,2023-03-17,458.33,2544,0,2544
515,TSLA  ,2023-02-22,2023-03-17,466.67,2897,4,2901
516,TSLA  ,2023-02-22,2023-03-17,475.0,3846,0,3846
517,TSLA  ,2023-02-22,2023-03-17,483.33,1983,0,1983
518,TSLA  ,2023-02-22,2023-03-17,491.67,2507,0,2507
519,TSLA  ,2023-02-22,2023-03-17,500.0,14188,6,14194
520,TSLA  ,2023-02-22,2023-03-17,508.33,3637,0,3637
521,TSLA  ,2023-02-22,2023-03-17,516.67,1230,0,1230
522,TSLA  ,2023-02-22,2023-03-17,525.0,4894,0,4894
523,TSLA  ,2023-02-22,2023-03-17,533.33,4743,0,4743
524,TSLA  ,2023-02-22,2023-03-17,541.67,1102,0,1102
525,TSLA  ,2023-02-22,2023-03-17,550.0,5040,0,5040
526,TSLA  ,2023-02-22,2023-03-17,558.33,3801,0,3801
527,TSLA  ,2023-02-22,2023-03-17,566.67,7724,0,7724
528,TSLA  ,2023-02-22,2023-03-17,575.0,11867,0,11867
529,TSLA  ,2023-02-22,2023-03-17,583.33,2663,0,2663
530,TSLA  ,2023-02-22,2023-03-17,591.67,1109,0,1109
531,TSLA  ,2023-02-22,2023-03-17,600.0,5758,0,5758
532,TSLA  ,2023-02-22,2023-03-17,608.33,581,0,581
533,TSLA  ,2023-02-22,2023-03-17,616.67,3998,0,3998
534,TSLA  ,2023-02-22,2023-03-17,625.0,1050,0,1050
535,TSLA  ,2023-02-22,2023-03-17,633.33,2372,0,2372
536,TSLA  ,2023-02-22,2023-03-17,641.67,1634,0,1634
537,TSLA  ,2023-02-22,2023-03-17,650.0,9133,0,9133
538,TSLA  ,2023-02-22,2023-03-17,666.67,70958,0,70958
539,TSLA  ,2023-02-22,2023-03-17,675.0,21633,0,21633
540,TSLA  ,2023-02-22,2023-03-17,683.33,4041,0,4041
541,TSLA  ,2023-02-22,2023-03-17,691.67,1388,0,1388
542,TSLA  ,2023-02-22,2023-03-17,700.0,4724,0,4724
543,TSLA  ,2023-02-22,2023-03-17,708.33,602,0,602
544,TSLA  ,2023-02-22,2023-03-17,716.67,783,0,783
545,TSLA  ,2023-02-22,2023-03-17,725.0,1042,0,1042
546,TSLA  ,2023-02-22,2023-03-17,733.33,1614,0,1614
547,TSLA  ,2023-02-22,2023-03-17,741.67,756,0,756
548,TSLA  ,2023-02-22,2023-03-17,750.0,754,0,754
549,TSLA  ,2023-02-22,2023-03-17,758.33,1235,0,1235
550,TSLA  ,2023-02-22,2023-03-17,766.67,1260,0,1260
551,TSLA  ,2023-02-22,2023-03-17,775.0,849,0,849
552,TSLA  ,2023-02-22,2023-03-17,783.33,1306,0,1306
553,TSLA  ,2023-02-22,2023-03-17,791.67,1448,0,1448
554,TSLA  ,2023-02-22,2023-03-17,800.0,5380,0,5380
555,TSLA  ,2023-02-22,2023-03-17,808.33,1842,0,1842
556,TSLA  ,2023-02-22,2023-03-17,816.67,2608,0,2608
557,TSLA  ,2023-02-22,2023-03-17,825.0,60250,0,60250
558,TSLA  ,2023-02-22,2023-03-24,20.0,6,122,128
559,TSLA  ,2023-02-22,2023-03-24,25.0,0,0,0
560,TSLA  ,2023-02-22,2023-03-24,30.0,0,10,10
561,TSLA  ,2023-02-22,2023-03-24,35.0,0,0,0
562,TSLA  ,2023-02-22,2023-03-24,40.0,0,0,0
563,TSLA  ,2023-02-22,2023-03-24,45.0,0,1,1
564,TSLA  ,2023-02-22,2023-03-24,50.0,21,1543,1564
565,TSLA  ,2023-02-22,2023-03-24,55.0,3,0,3
566,TSLA  ,2023-02-22,2023-03-24,60.0,0,29,29
567,TSLA  ,2023-02-22,2023-03-24,65.0,0,15,15
568,TSLA  ,2023-02-22,2023-03-24,70.0,0,26,26
569,TSLA  ,2023-02-22,2023-03-24,75.0,0,46,46
570,TSLA  ,2023-02-22,2023-03-24,80.0,0,80,80
571,TSLA  ,2023-02-22,2023-03-24,85.0,1,29,30
572,TSLA  ,2023-02-22,2023-03-24,90.0,0,34,34
573,TSLA  ,2023-02-22,2023-03-24,95.0,0,82,82
574,TSLA  ,2023-02-22,2023-03-24,100.0,12,391,403
575,TSLA  ,2023-02-22,2023-03-24,105.0,10,151,161
576,TSLA  ,2023-02-22,2023-03-24,110.0,6,147,153
577,TSLA  ,2023-02-22,2023-03-24,115.0,2,128,130
578,TSLA  ,2023-02-22,2023-03-24,120.0,2,743,745
579,TSLA  ,2023-02-22,2023-03-24,125.0,8,1184,1192
580,TSLA  ,2023-02-22,2023-03-24,130.0,174,400,574
581,TSLA  ,2023-02-22,2023-03-24,135.0,38,514,552
582,TSLA  ,2023-02-22,2023-03-24,140.0,28,1020,1048
583,TSLA  ,2023-02-22,2023-03-24,145.0,54,415,469
584,TSLA  ,2023-02-22,2023-03-24,146.0,11,53,64
585,TSLA  ,2023-02-22,2023-03-24,147.0,88,44,132
586,TSLA  ,2023-02-22,2023-03-24,148.0,77,98,175
587,TSLA  ,2023-02-22,2023-03-24,149.0,62,87,149
588,TSLA  ,2023-02-22,2023-03-24,150.0,73,911,984
589,TSLA  ,2023-02-22,2023-03-24,152.5,26,173,199
590,TSLA  ,2023-02-22,2023-03-24,155.0,486,687,1173
591,TSLA  ,2023-02-22,2023-03-24,157.5,73,441,514
592,TSLA  ,2023-02-22,2023-03-24,160.0,107,674,781
593,TSLA  ,2023-02-22,2023-03-24,162.5,43,143,186
594,TSLA  ,2023-02-22,2023-03-24,165.0,103,718,821
595,TSLA  ,2023-02-22,2023-03-24,167.5,17,533,550
596,TSLA  ,2023-02-22,2023-03-24,170.0,194,1148,1342
597,TSLA  ,2023-02-22,2023-03-24,172.5,61,312,373
598,TSLA  ,2023-02-22,2023-03-24,175.0,159,1487,1646
599,TSLA  ,2023-02-22,2023-03-24,177.5,81,484,565
600,TSLA  ,2023-02-22,2023-03-24,180.0,300,1072,1372
601,TSLA  ,2023-02-22,2023-03-24,182.5,38,166,204
602,TSLA  ,2023-02-22,2023-03-24,185.0,110,639,749
603,TSLA  ,2023-02-22,2023-03-24,187.5,143,137,280
604,TSLA  ,2023-02-22,2023-03-24,190.0,695,946,1641
605,TSLA  ,2023-02-22,2023-03-24,192.5,85,223,308
606,TSLA  ,2023-02-22,2023-03-24,195.0,523,499,1022
607,TSLA  ,2023-02-22,2023-03-24,197.5,1161,190,1351
608,TSLA  ,2023-02-22,2023-03-24,200.0,2679,1969,4648
609,TSLA  ,2023-02-22,2023-03-24,202.5,928,162,1090
610,TSLA  ,2023-02-22,2023-03-24,205.0,1505,243,1748
611,TSLA  ,2023-02-22,2023-03-24,207.5,399,146,545
612,TSLA  ,2023-02-22,2023-03-24,210.0,2745,438,3183
613,TSLA  ,2023-02-22,2023-03-24,212.5,588,936,1524
614,TSLA  ,2023-02-22,2023-03-24,215.0,1210,524,1734
615,TSLA  ,2023-02-22,2023-03-24,217.5,257,60,317
616,TSLA  ,2023-02-22,2023-03-24,220.0,2129,853,2982
617,TSLA  ,2023-02-22,2023-03-24,222.5,311,80,391
618,TSLA  ,2023-02-22,2023-03-24,225.0,589,112,701
619,TSLA  ,2023-02-22,2023-03-24,230.0,978,225,1203
620,TSLA  ,2023-02-22,2023-03-24,235.0,624,114,738
621,TSLA  ,2023-02-22,2023-03-24,240.0,270,141,411
622,TSLA  ,2023-02-22,2023-03-24,245.0,576,20,596
623,TSLA  ,2023-02-22,2023-03-24,250.0,1497,51,1548
624,TSLA  ,2023-02-22,2023-03-24,255.0,354,21,375
625,TSLA  ,2023-02-22,2023-03-24,260.0,876,16,892
626,TSLA  ,2023-02-22,2023-03-24,265.0,407,1,408
627,TSLA  ,2023-02-22,2023-03-24,270.0,649,4,653
628,TSLA  ,2023-02-22,2023-03-24,275.0,309,3,312
629,TSLA  ,2023-02-22,2023-03-24,280.0,374,0,374
630,TSLA  ,2023-02-22,2023-03-24,285.0,324,0,324
631,TSLA  ,2023-02-22,2023-03-24,290.0,294,0,294
632,TSLA  ,2023-02-22,2023-03-24,295.0,97,0,97
633,TSLA  ,2023-02-22,2023-03-24,300.0,849,7,856
634,TSLA  ,2023-02-22,2023-03-24,310.0,281,0,281
635,TSLA  ,2023-02-22,2023-03-24,320.0,348,1,349
636,TSLA  ,2023-02-22,2023-03-24,330.0,161,1,162
637,TSLA  ,2023-02-22,2023-03-24,340.0,356,0,356
638,TSLA  ,2023-02-22,2023-03-24,350.0,469,0,469
639,TSLA  ,2023-02-22,2023-03-24,360.0,755,0,755
640,TSLA  ,2023-02-22,2023-03-31,25.0,3,0,3
641,TSLA  ,2023-02-22,2023-03-31,30.0,0,0,0
642,TSLA  ,2023-02-22,2023-03-31,35.0,0,1,1
643,TSLA  ,2023-02-22,2023-03-31,40.0,0,5,5
644,TSLA  ,2023-02-22,2023-03-31,45.0,0,2,2
645,TSLA  ,2023-02-22,2023-03-31,50.0,0,6,6
646,TSLA  ,2023-02-22,2023-03-31,55.0,0,0,0
647,TSLA  ,2023-02-22,2023-03-31,60.0,0,26,26
648,TSLA  ,2023-02-22,2023-03-31,65.0,0,9,9
649,TSLA  ,2023-02-22,2023-03-31,70.0,0,20,20
650,TSLA  ,2023-02-22,2023-03-31,75.0,0,13,13
651,TSLA  ,2023-02-22,2023-03-31,80.0,4,49,53
652,TSLA  ,2023-02-22,2023-03-31,85.0,37,8,45
653,TSLA  ,2023-02-22,2023-03-31,90.0,0,61,61
654,TSLA  ,2023-02-22,2023-03-31,95.0,0,186,186
655,TSLA  ,2023-02-22,2023-03-31,100.0,2,456,458
656,TSLA  ,2023-02-22,2023-03-31,105.0,2,182,184
657,TSLA  ,2023-02-22,2023-03-31,110.0,1,279,280
658,TSLA  ,2023-02-22,2023-03-31,115.0,7,340,347
659,TSLA  ,2023-02-22,2023-03-31,120.0,26,202,228
660,TSLA  ,2023-02-22,2023-03-31,125.0,51,151,202
661,TSLA  ,2023-02-22,2023-03-31,130.0,15,226,241
662,TSLA  ,2023-02-22,2023-03-31,135.0,11,305,316
663,TSLA  ,2023-02-22,2023-03-31,140.0,44,389,433
664,TSLA  ,2023-02-22,2023-03-31,145.0,54,365,419
665,TSLA  ,2023-02-22,2023-03-31,150.0,161,794,955
666,TSLA  ,2023-02-22,2023-03-31,155.0,341,175,516
667,TSLA  ,2023-02-22,2023-03-31,160.0,80,528,608
668,TSLA  ,2023-02-22,2023-03-31,165.0,57,397,454
669,TSLA  ,2023-02-22,2023-03-31,170.0,45,1026,1071
670,TSLA  ,2023-02-22,2023-03-31,172.5,13,791,804
671,TSLA  ,2023-02-22,2023-03-31,175.0,49,547,596
672,TSLA  ,2023-02-22,2023-03-31,177.5,214,102,316
673,TSLA  ,2023-02-22,2023-03-31,180.0,420,828,1248
674,TSLA  ,2023-02-22,2023-03-31,182.5,14,182,196
675,TSLA  ,2023-02-22,2023-03-31,185.0,53,156,209
676,TSLA  ,2023-02-22,2023-03-31,187.5,80,91,171
677,TSLA  ,2023-02-22,2023-03-31,190.0,221,894,1115
678,TSLA  ,2023-02-22,2023-03-31,192.5,106,101,207
679,TSLA  ,2023-02-22,2023-03-31,195.0,175,5249,5424
680,TSLA  ,2023-02-22,2023-03-31,197.5,125,224,349
681,TSLA  ,2023-02-22,2023-03-31,200.0,549,745,1294
682,TSLA  ,2023-02-22,2023-03-31,202.5,1928,421,2349
683,TSLA  ,2023-02-22,2023-03-31,205.0,712,936,1648
684,TSLA  ,2023-02-22,2023-03-31,207.5,391,170,561
685,TSLA  ,2023-02-22,2023-03-31,210.0,1471,417,1888
686,TSLA  ,2023-02-22,2023-03-31,212.5,393,107,500
687,TSLA  ,2023-02-22,2023-03-31,215.0,610,166,776
688,TSLA  ,2023-02-22,2023-03-31,217.5,265,67,332
689,TSLA  ,2023-02-22,2023-03-31,220.0,1223,76,1299
690,TSLA  ,2023-02-22,2023-03-31,222.5,114,14,128
691,TSLA  ,2023-02-22,2023-03-31,225.0,612,10,622
692,TSLA  ,2023-02-22,2023-03-31,230.0,1349,24,1373
693,TSLA  ,2023-02-22,2023-03-31,235.0,414,23,437
694,TSLA  ,2023-02-22,2023-03-31,240.0,961,2,963
695,TSLA  ,2023-02-22,2023-03-31,245.0,361,30,391
696,TSLA  ,2023-02-22,2023-03-31,250.0,1217,3,1220
697,TSLA  ,2023-02-22,2023-03-31,255.0,308,2,310
698,TSLA  ,2023-02-22,2023-03-31,260.0,415,13,428
699,TSLA  ,2023-02-22,2023-03-31,265.0,182,10,192
700,TSLA  ,2023-02-22,2023-03-31,270.0,370,13,383
701,TSLA  ,2023-02-22,2023-03-31,275.0,459,3,462
702,TSLA  ,2023-02-22,2023-03-31,280.0,599,2,601
703,TSLA  ,2023-02-22,2023-03-31,285.0,346,0,346
704,TSLA  ,2023-02-22,2023-03-31,290.0,266,0,266
705,TSLA  ,2023-02-22,2023-03-31,295.0,188,25,213
706,TSLA  ,2023-02-22,2023-03-31,300.0,757,25,782
707,TSLA  ,2023-02-22,2023-03-31,310.0,302,1,303
708,TSLA  ,2023-02-22,2023-03-31,320.0,93,4,97
709,TSLA  ,2023-02-22,2023-03-31,330.0,137,0,137
710,TSLA  ,2023-02-22,2023-03-31,340.0,127,0,127
711,TSLA  ,2023-02-22,2023-03-31,350.0,132,0,132
712,TSLA  ,2023-02-22,2023-03-31,360.0,463,0,463
713,TSLA  ,2023-02-22,2023-04-21,5.0,14,101,115
714,TSLA  ,2023-02-22,2023-04-21,10.0,0,8,8
715,TSLA  ,2023-02-22,2023-04-21,15.0,0,41,41
716,TSLA  ,2023-02-22,2023-04-21,20.0,4,345,349
717,TSLA  ,2023-02-22,2023-04-21,25.0,7,2494,2501
718,TSLA  ,2023-02-22,2023-04-21,30.0,0,4807,4807
719,TSLA  ,2023-02-22,2023-04-21,35.0,5,974,979
720,TSLA  ,2023-02-22,2023-04-21,40.0,7,580,587
721,TSLA  ,2023-02-22,2023-04-21,45.0,2,858,860
722,TSLA  ,2023-02-22,2023-04-21,50.0,133,5114,5247
723,TSLA  ,2023-02-22,2023-04-21,55.0,15,2778,2793
724,TSLA  ,2023-02-22,2023-04-21,60.0,18,2020,2038
725,TSLA  ,2023-02-22,2023-04-21,65.0,65,5215,5280
726,TSLA  ,2023-02-22,2023-04-21,70.0,63,4477,4540
727,TSLA  ,2023-02-22,2023-04-21,75.0,124,13318,13442
728,TSLA  ,2023-02-22,2023-04-21,80.0,25226,4571,29797
729,TSLA  ,2023-02-22,2023-04-21,85.0,90,3321,3411
730,TSLA  ,2023-02-22,2023-04-21,90.0,271,2286,2557
731,TSLA  ,2023-02-22,2023-04-21,95.0,152,6111,6263
732,TSLA  ,2023-02-22,2023-04-21,100.0,1568,28181,29749
733,TSLA  ,2023-02-22,2023-04-21,105.0,362,3000,3362
734,TSLA  ,2023-02-22,2023-04-21,108.33,898,4944,5842
735,TSLA  ,2023-02-22,2023-04-21,110.0,1075,7445,8520
736,TSLA  ,2023-02-22,2023-04-21,115.0,1423,3556,4979
737,TSLA  ,2023-02-22,2023-04-21,116.67,2544,9428,11972
738,TSLA  ,2023-02-22,2023-04-21,120.0,7416,11954,19370
739,TSLA  ,2023-02-22,2023-04-21,125.0,10826,13233,24059
740,TSLA  ,2023-02-22,2023-04-21,130.0,1790,7483,9273
741,TSLA  ,2023-02-22,2023-04-21,133.33,4582,3690,8272
742,TSLA  ,2023-02-22,2023-04-21,135.0,1486,2726,4212
743,TSLA  ,2023-02-22,2023-04-21,140.0,2970,7477,10447
744,TSLA  ,2023-02-22,2023-04-21,141.67,6291,3499,9790
745,TSLA  ,2023-02-22,2023-04-21,145.0,1997,2973,4970
746,TSLA  ,2023-02-22,2023-04-21,150.0,7826,18865,26691
747,TSLA  ,2023-02-22,2023-04-21,155.0,1422,2268,3690
748,TSLA  ,2023-02-22,2023-04-21,158.33,2993,4154,7147
749,TSLA  ,2023-02-22,2023-04-21,160.0,3495,6036,9531
750,TSLA  ,2023-02-22,2023-04-21,165.0,1670,2899,4569
751,TSLA  ,2023-02-22,2023-04-21,166.67,2667,5447,8114
752,TSLA  ,2023-02-22,2023-04-21,170.0,1963,4154,6117
753,TSLA  ,2023-02-22,2023-04-21,175.0,10784,8378,19162
754,TSLA  ,2023-02-22,2023-04-21,180.0,2997,5128,8125
755,TSLA  ,2023-02-22,2023-04-21,183.33,2755,4140,6895
756,TSLA  ,2023-02-22,2023-04-21,185.0,2451,3559,6010
757,TSLA  ,2023-02-22,2023-04-21,190.0,2671,7684,10355
758,TSLA  ,2023-02-22,2023-04-21,191.67,3041,14213,17254
759,TSLA  ,2023-02-22,2023-04-21,195.0,3260,2636,5896
760,TSLA  ,2023-02-22,2023-04-21,200.0,13895,10170,24065
761,TSLA  ,2023-02-22,2023-04-21,205.0,3571,2796,6367
762,TSLA  ,2023-02-22,2023-04-21,208.33,6176,2846,9022
763,TSLA  ,2023-02-22,2023-04-21,210.0,5530,3500,9030
764,TSLA  ,2023-02-22,2023-04-21,215.0,3119,1698,4817
765,TSLA  ,2023-02-22,2023-04-21,216.67,2173,3150,5323
766,TSLA  ,2023-02-22,2023-04-21,220.0,7783,1261,9044
767,TSLA  ,2023-02-22,2023-04-21,225.0,8731,2248,10979
768,TSLA  ,2023-02-22,2023-04-21,230.0,2374,686,3060
769,TSLA  ,2023-02-22,2023-04-21,233.33,1740,835,2575
770,TSLA  ,2023-02-22,2023-04-21,235.0,1415,371,1786
771,TSLA  ,2023-02-22,2023-04-21,240.0,7907,542,8449
772,TSLA  ,2023-02-22,2023-04-21,241.67,1135,102,1237
773,TSLA  ,2023-02-22,2023-04-21,243.33,1350,53,1403
774,TSLA  ,2023-02-22,2023-04-21,245.0,1528,177,1705
775,TSLA  ,2023-02-22,2023-04-21,246.67,1438,87,1525
776,TSLA  ,2023-02-22,2023-04-21,248.33,857,329,1186
777,TSLA  ,2023-02-22,2023-04-21,250.0,9670,881,10551
778,TSLA  ,2023-02-22,2023-04-21,251.67,1940,82,2022
779,TSLA  ,2023-02-22,2023-04-21,253.33,1371,43,1414
780,TSLA  ,2023-02-22,2023-04-21,255.0,1815,48,1863
781,TSLA  ,2023-02-22,2023-04-21,258.33,1162,895,2057
782,TSLA  ,2023-02-22,2023-04-21,260.0,2335,6,2341
783,TSLA  ,2023-02-22,2023-04-21,265.0,1308,6,1314
784,TSLA  ,2023-02-22,2023-04-21,266.67,1656,199,1855
785,TSLA  ,2023-02-22,2023-04-21,270.0,1056,2,1058
786,TSLA  ,2023-02-22,2023-04-21,275.0,2203,112,2315
787,TSLA  ,2023-02-22,2023-04-21,280.0,2161,206,2367
788,TSLA  ,2023-02-22,2023-04-21,283.33,1351,215,1566
789,TSLA  ,2023-02-22,2023-04-21,285.0,311,30,341
790,TSLA  ,2023-02-22,2023-04-21,290.0,493,0,493
791,TSLA  ,2023-02-22,2023-04-21,291.67,3102,30,3132
792,TSLA  ,2023-02-22,2023-04-21,295.0,102,0,102
793,TSLA  ,2023-02-22,2023-04-21,300.0,9570,41,9611
794,TSLA  ,2023-02-22,2023-04-21,305.0,231,0,231
795,TSLA  ,2023-02-22,2023-04-21,308.33,4103,26,4129
796,TSLA  ,2023-02-22,2023-04-21,310.0,1031,0,1031
797,TSLA  ,2023-02-22,2023-04-21,316.67,21978,2,21980
798,TSLA  ,2023-02-22,2023-04-21,320.0,124,0,124
799,TSLA  ,2023-02-22,2023-04-21,325.0,2782,11,2793
800,TSLA  ,2023-02-22,2023-04-21,330.0,46,0,46
801,TSLA  ,2023-02-22,2023-04-21,333.33,6381,0,6381
802,TSLA  ,2023-02-22,2023-04-21,340.0,7,0,7
803,TSLA  ,2023-02-22,2023-04-21,341.67,817,8,825
804,TSLA  ,2023-02-22,2023-04-21,350.0,3550,7,3557
805,TSLA  ,2023-02-22,2023-04-21,358.33,949,0,949
806,TSLA  ,2023-02-22,2023-04-21,360.0,40,0,40
807,TSLA  ,2023-02-22,2023-04-21,366.67,1189,3,1192
808,TSLA  ,2023-02-22,2023-04-21,370.0,30,0,30
809,TSLA  ,2023-02-22,2023-04-21,375.0,1628,12,1640
810,TSLA  ,2023-02-22,2023-04-21,383.33,753,0,753
811,TSLA  ,2023-02-22,2023-04-21,391.67,409,0,409
812,TSLA  ,2023-02-22,2023-04-21,400.0,3410,0,3410
813,TSLA  ,2023-02-22,2023-04-21,408.33,437,0,437
814,TSLA  ,2023-02-22,2023-04-21,416.67,1133,0,1133
815,TSLA  ,2023-02-22,2023-04-21,425.0,4961,0,4961
816,TSLA  ,2023-02-22,2023-04-21,433.33,12434,0,12434
817,TSLA  ,2023-02-22,2023-04-21,441.67,750,0,750
818,TSLA  ,2023-02-22,2023-04-21,450.0,1359,0,1359
819,TSLA  ,2023-02-22,2023-04-21,458.33,3255,0,3255
820,TSLA  ,2023-02-22,2023-04-21,466.67,409,0,409
821,TSLA  ,2023-02-22,2023-04-21,475.0,960,0,960
822,TSLA  ,2023-02-22,2023-04-21,483.33,826,0,826
823,TSLA  ,2023-02-22,2023-04-21,491.67,195,0,195
824,TSLA  ,2023-02-22,2023-04-21,500.0,3634,0,3634
825,TSLA  ,2023-02-22,2023-04-21,508.33,900,0,900
826,TSLA  ,2023-02-22,2023-04-21,516.67,508,0,508
827,TSLA  ,2023-02-22,2023-04-21,525.0,485,0,485
828,TSLA  ,2023-02-22,2023-04-21,533.33,502,0,502
829,TSLA  ,2023-02-22,2023-04-21,541.67,599,0,599
830,TSLA  ,2023-02-22,2023-04-21,550.0,11286,0,11286
831,TSLA  ,2023-02-22,2023-04-21,558.33,269,0,269
832,TSLA  ,2023-02-22,2023-04-21,566.67,631,0,631
833,TSLA  ,2023-02-22,2023-04-21,575.0,1712,0,1712
834,TSLA  ,2023-02-22,2023-04-21,583.33,1047,0,1047
835,TSLA  ,2023-02-22,2023-04-21,600.0,21693,0,21693
836,TSLA  ,2023-02-22,2023-05-19,50.0,62,3285,3347
837,TSLA  ,2023-02-22,2023-05-19,55.0,51,602,653
838,TSLA  ,2023-02-22,2023-05-19,60.0,159,949,1108
839,TSLA  ,2023-02-22,2023-05-19,65.0,64,451,515
840,TSLA  ,2023-02-22,2023-05-19,70.0,178,1451,1629
841,TSLA  ,2023-02-22,2023-05-19,75.0,135,1649,1784
842,TSLA  ,2023-02-22,2023-05-19,80.0,84,1603,1687
843,TSLA  ,2023-02-22,2023-05-19,85.0,62,1767,1829
844,TSLA  ,2023-02-22,2023-05-19,90.0,243,2792,3035
845,TSLA  ,2023-02-22,2023-05-19,95.0,134,1862,1996
846,TSLA  ,2023-02-22,2023-05-19,100.0,1090,19718,20808
847,TSLA  ,2023-02-22,2023-05-19,105.0,285,6181,6466
848,TSLA  ,2023-02-22,2023-05-19,110.0,985,7297,8282
849,TSLA  ,2023-02-22,2023-05-19,115.0,1337,1954,3291
850,TSLA  ,2023-02-22,2023-05-19,120.0,2153,8119,10272
851,TSLA  ,2023-02-22,2023-05-19,125.0,3742,2583,6325
852,TSLA  ,2023-02-22,2023-05-19,130.0,2704,5043,7747
853,TSLA  ,2023-02-22,2023-05-19,135.0,2068,2216,4284
854,TSLA  ,2023-02-22,2023-05-19,140.0,1889,11474,13363
855,TSLA  ,2023-02-22,2023-05-19,145.0,2383,2106,4489
856,TSLA  ,2023-02-22,2023-05-19,150.0,3954,4879,8833
857,TSLA  ,2023-02-22,2023-05-19,155.0,1380,1663,3043
858,TSLA  ,2023-02-22,2023-05-19,160.0,3187,4811,7998
859,TSLA  ,2023-02-22,2023-05-19,165.0,1379,1514,2893
860,TSLA  ,2023-02-22,2023-05-19,170.0,2786,4913,7699
861,TSLA  ,2023-02-22,2023-05-19,175.0,2155,1942,4097
862,TSLA  ,2023-02-22,2023-05-19,180.0,7974,4034,12008
863,TSLA  ,2023-02-22,2023-05-19,185.0,1915,1501,3416
864,TSLA  ,2023-02-22,2023-05-19,190.0,2733,3582,6315
865,TSLA  ,2023-02-22,2023-05-19,195.0,3186,2303,5489
866,TSLA  ,2023-02-22,2023-05-19,200.0,8496,3448,11944
867,TSLA  ,2023-02-22,2023-05-19,205.0,4125,4827,8952
868,TSLA  ,2023-02-22,2023-05-19,210.0,10548,2909,13457
869,TSLA  ,2023-02-22,2023-05-19,215.0,25994,1928,27922
870,TSLA  ,2023-02-22,2023-05-19,220.0,7484,1694,9178
871,TSLA  ,2023-02-22,2023-05-19,225.0,3204,924,4128
872,TSLA  ,2023-02-22,2023-05-19,230.0,2359,679,3038
873,TSLA  ,2023-02-22,2023-05-19,235.0,1841,296,2137
874,TSLA  ,2023-02-22,2023-05-19,240.0,2913,103,3016
875,TSLA  ,2023-02-22,2023-05-19,245.0,1118,149,1267
876,TSLA  ,2023-02-22,2023-05-19,250.0,3457,77,3534
877,TSLA  ,2023-02-22,2023-05-19,260.0,1353,135,1488
878,TSLA  ,2023-02-22,2023-05-19,270.0,3513,130,3643
879,TSLA  ,2023-02-22,2023-05-19,280.0,800,28,828
880,TSLA  ,2023-02-22,2023-05-19,290.0,429,367,796
881,TSLA  ,2023-02-22,2023-05-19,300.0,1810,544,2354
882,TSLA  ,2023-02-22,2023-05-19,310.0,548,5249,5797
883,TSLA  ,2023-02-22,2023-05-19,320.0,1002,1168,2170
884,TSLA  ,2023-02-22,2023-05-19,330.0,612,26,638
885,TSLA  ,2023-02-22,2023-05-19,340.0,566,3,569
886,TSLA  ,2023-02-22,2023-05-19,350.0,344,5,349
887,TSLA  ,2023-02-22,2023-05-19,360.0,765,1,766
888,TSLA  ,2023-02-22,2023-05-19,370.0,233,0,233
889,TSLA  ,2023-02-22,2023-05-19,380.0,313,0,313
890,TSLA  ,2023-02-22,2023-05-19,390.0,1123,1,1124
891,TSLA  ,2023-02-22,2023-05-19,400.0,21,0,21
892,TSLA  ,2023-02-22,2023-05-19,410.0,21,0,21
893,TSLA  ,2023-02-22,2023-06-16,1.67,103,41939,42042
894,TSLA  ,2023-02-22,2023-06-16,3.33,399,5010,5409
895,TSLA  ,2023-02-22,2023-06-16,5.0,108,1684,1792
896,TSLA  ,2023-02-22,2023-06-16,6.67,75,1309,1384
897,TSLA  ,2023-02-22,2023-06-16,8.33,425,2371,2796
898,TSLA  ,2023-02-22,2023-06-16,10.0,3235,3746,6981
899,TSLA  ,2023-02-22,2023-06-16,11.67,155,8573,8728
900,TSLA  ,2023-02-22,2023-06-16,13.33,1234,5646,6880
901,TSLA  ,2023-02-22,2023-06-16,15.0,168,4104,4272
902,TSLA  ,2023-02-22,2023-06-16,16.67,489,9830,10319
903,TSLA  ,2023-02-22,2023-06-16,18.33,88,5228,5316
904,TSLA  ,2023-02-22,2023-06-16,33.33,862,16916,17778
905,TSLA  ,2023-02-22,2023-06-16,50.0,1111,17809,18920
906,TSLA  ,2023-02-22,2023-06-16,55.0,31,7369,7400
907,TSLA  ,2023-02-22,2023-06-16,60.0,15,2243,2258
908,TSLA  ,2023-02-22,2023-06-16,65.0,4,636,640
909,TSLA  ,2023-02-22,2023-06-16,66.67,1011,14231,15242
910,TSLA  ,2023-02-22,2023-06-16,70.0,49,4060,4109
911,TSLA  ,2023-02-22,2023-06-16,75.0,84,6707,6791
912,TSLA  ,2023-02-22,2023-06-16,80.0,184,3850,4034
913,TSLA  ,2023-02-22,2023-06-16,83.33,704,5070,5774
914,TSLA  ,2023-02-22,2023-06-16,85.0,86,4490,4576
915,TSLA  ,2023-02-22,2023-06-16,90.0,206,4155,4361
916,TSLA  ,2023-02-22,2023-06-16,95.0,123,1631,1754
917,TSLA  ,2023-02-22,2023-06-16,100.0,3474,30020,33494
918,TSLA  ,2023-02-22,2023-06-16,105.0,362,5347,5709
919,TSLA  ,2023-02-22,2023-06-16,110.0,1201,5631,6832
920,TSLA  ,2023-02-22,2023-06-16,115.0,596,2921,3517
921,TSLA  ,2023-02-22,2023-06-16,116.67,1787,5248,7035
922,TSLA  ,2023-02-22,2023-06-16,120.0,3426,10011,13437
923,TSLA  ,2023-02-22,2023-06-16,123.33,459,1129,1588
924,TSLA  ,2023-02-22,2023-06-16,125.0,4148,8566,12714
925,TSLA  ,2023-02-22,2023-06-16,126.67,912,1343,2255
926,TSLA  ,2023-02-22,2023-06-16,130.0,3664,9304,12968
927,TSLA  ,2023-02-22,2023-06-16,133.33,2526,8772,11298
928,TSLA  ,2023-02-22,2023-06-16,135.0,2736,2647,5383
929,TSLA  ,2023-02-22,2023-06-16,136.67,1082,2575,3657
930,TSLA  ,2023-02-22,2023-06-16,140.0,7606,6899,14505
931,TSLA  ,2023-02-22,2023-06-16,143.33,1231,3229,4460
932,TSLA  ,2023-02-22,2023-06-16,145.0,2171,3735,5906
933,TSLA  ,2023-02-22,2023-06-16,146.67,1581,1971,3552
934,TSLA  ,2023-02-22,2023-06-16,150.0,12522,14540,27062
935,TSLA  ,2023-02-22,2023-06-16,153.33,2438,3159,5597
936,TSLA  ,2023-02-22,2023-06-16,155.0,1172,3174,4346
937,TSLA  ,2023-02-22,2023-06-16,156.67,1638,786,2424
938,TSLA  ,2023-02-22,2023-06-16,160.0,6528,7063,13591
939,TSLA  ,2023-02-22,2023-06-16,163.33,971,1209,2180
940,TSLA  ,2023-02-22,2023-06-16,165.0,1753,2901,4654
941,TSLA  ,2023-02-22,2023-06-16,166.67,3620,13086,16706
942,TSLA  ,2023-02-22,2023-06-16,170.0,2595,4772,7367
943,TSLA  ,2023-02-22,2023-06-16,173.33,1452,6340,7792
944,TSLA  ,2023-02-22,2023-06-16,175.0,2637,5503,8140
945,TSLA  ,2023-02-22,2023-06-16,180.0,9878,8699,18577
946,TSLA  ,2023-02-22,2023-06-16,183.33,9414,10227,19641
947,TSLA  ,2023-02-22,2023-06-16,185.0,7911,7098,15009
948,TSLA  ,2023-02-22,2023-06-16,186.67,957,1990,2947
949,TSLA  ,2023-02-22,2023-06-16,190.0,5722,4852,10574
950,TSLA  ,2023-02-22,2023-06-16,193.33,1847,7836,9683
951,TSLA  ,2023-02-22,2023-06-16,195.0,2831,2828,5659
952,TSLA  ,2023-02-22,2023-06-16,200.0,25727,24664,50391
953,TSLA  ,2023-02-22,2023-06-16,205.0,2937,1353,4290
954,TSLA  ,2023-02-22,2023-06-16,206.67,2520,2910,5430
955,TSLA  ,2023-02-22,2023-06-16,210.0,5648,4280,9928
956,TSLA  ,2023-02-22,2023-06-16,213.33,2329,2656,4985
957,TSLA  ,2023-02-22,2023-06-16,215.0,3816,1155,4971
958,TSLA  ,2023-02-22,2023-06-16,216.67,6787,6191,12978
959,TSLA  ,2023-02-22,2023-06-16,220.0,8347,7063,15410
960,TSLA  ,2023-02-22,2023-06-16,225.0,2368,1473,3841
961,TSLA  ,2023-02-22,2023-06-16,226.67,2754,2274,5028
962,TSLA  ,2023-02-22,2023-06-16,230.0,7203,3110,10313
963,TSLA  ,2023-02-22,2023-06-16,233.33,11516,8001,19517
964,TSLA  ,2023-02-22,2023-06-16,235.0,3767,872,4639
965,TSLA  ,2023-02-22,2023-06-16,240.0,8029,3115,11144
966,TSLA  ,2023-02-22,2023-06-16,243.33,1332,1697,3029
967,TSLA  ,2023-02-22,2023-06-16,245.0,1920,75,1995
968,TSLA  ,2023-02-22,2023-06-16,246.67,3069,95,3164
969,TSLA  ,2023-02-22,2023-06-16,250.0,15689,3469,19158
970,TSLA  ,2023-02-22,2023-06-16,253.33,1502,195,1697
971,TSLA  ,2023-02-22,2023-06-16,255.0,1228,73,1301
972,TSLA  ,2023-02-22,2023-06-16,260.0,5177,81,5258
973,TSLA  ,2023-02-22,2023-06-16,265.0,2455,84,2539
974,TSLA  ,2023-02-22,2023-06-16,266.67,7297,408,7705
975,TSLA  ,2023-02-22,2023-06-16,270.0,1478,6,1484
976,TSLA  ,2023-02-22,2023-06-16,273.33,1401,1051,2452
977,TSLA  ,2023-02-22,2023-06-16,275.0,2172,9,2181
978,TSLA  ,2023-02-22,2023-06-16,280.0,4252,70,4322
979,TSLA  ,2023-02-22,2023-06-16,283.33,4649,51,4700
980,TSLA  ,2023-02-22,2023-06-16,285.0,1018,2,1020
981,TSLA  ,2023-02-22,2023-06-16,286.67,749,50,799
982,TSLA  ,2023-02-22,2023-06-16,290.0,1492,826,2318
983,TSLA  ,2023-02-22,2023-06-16,293.33,1623,62,1685
984,TSLA  ,2023-02-22,2023-06-16,295.0,325,258,583
985,TSLA  ,2023-02-22,2023-06-16,300.0,18243,196,18439
986,TSLA  ,2023-02-22,2023-06-16,305.0,948,5,953
987,TSLA  ,2023-02-22,2023-06-16,306.67,1439,30,1469
988,TSLA  ,2023-02-22,2023-06-16,310.0,1686,44,1730
989,TSLA  ,2023-02-22,2023-06-16,313.33,542,33,575
990,TSLA  ,2023-02-22,2023-06-16,315.0,337,82,419
991,TSLA  ,2023-02-22,2023-06-16,316.67,7182,241,7423
992,TSLA  ,2023-02-22,2023-06-16,320.0,2473,3,2476
993,TSLA  ,2023-02-22,2023-06-16,326.67,9731,8,9739
994,TSLA  ,2023-02-22,2023-06-16,330.0,2541,51,2592
995,TSLA  ,2023-02-22,2023-06-16,333.33,33257,231,33488
996,TSLA  ,2023-02-22,2023-06-16,340.0,1706,3,1709
997,TSLA  ,2023-02-22,2023-06-16,346.67,1316,0,1316
998,TSLA  ,2023-02-22,2023-06-16,350.0,8598,334,8932
999,TSLA  ,2023-02-22,2023-06-16,353.33,970,0,970
1000,TSLA  ,2023-02-22,2023-06-16,360.0,1836,3,1839
1001,TSLA  ,2023-02-22,2023-06-16,366.67,10964,450,11414
1002,TSLA  ,2023-02-22,2023-06-16,370.0,985,0,985
1003,TSLA  ,2023-02-22,2023-06-16,383.33,10840,0,10840
1004,TSLA  ,2023-02-22,2023-06-16,400.0,18151,919,19070
1005,TSLA  ,2023-02-22,2023-06-16,416.67,3564,0,3564
1006,TSLA  ,2023-02-22,2023-06-16,433.33,9711,0,9711
1007,TSLA  ,2023-02-22,2023-06-16,450.0,8226,0,8226
1008,TSLA  ,2023-02-22,2023-06-16,466.67,20915,0,20915
1009,TSLA  ,2023-02-22,2023-06-16,483.33,8234,0,8234
1010,TSLA  ,2023-02-22,2023-06-16,500.0,22506,0,22506
1011,TSLA  ,2023-02-22,2023-06-16,516.67,2664,0,2664
1012,TSLA  ,2023-02-22,2023-06-16,533.33,4870,0,4870
1013,TSLA  ,2023-02-22,2023-06-16,550.0,6098,0,6098
1014,TSLA  ,2023-02-22,2023-06-16,558.33,1603,0,1603
1015,TSLA  ,2023-02-22,2023-06-16,566.67,1275,0,1275
1016,TSLA  ,2023-02-22,2023-06-16,575.0,719,0,719
1017,TSLA  ,2023-02-22,2023-06-16,583.33,1203,0,1203
1018,TSLA  ,2023-02-22,2023-06-16,591.67,398,0,398
1019,TSLA  ,2023-02-22,2023-06-16,600.0,6637,0,6637
1020,TSLA  ,2023-02-22,2023-06-16,608.33,1106,0,1106
1021,TSLA  ,2023-02-22,2023-06-16,616.67,550,0,550
1022,TSLA  ,2023-02-22,2023-06-16,625.0,2139,0,2139
1023,TSLA  ,2023-02-22,2023-06-16,633.33,5398,0,5398
1024,TSLA  ,2023-02-22,2023-06-16,641.67,450,0,450
1025,TSLA  ,2023-02-22,2023-06-16,650.0,584,0,584
1026,TSLA  ,2023-02-22,2023-06-16,666.67,18139,0,18139
1027,TSLA  ,2023-02-22,2023-06-16,675.0,935,0,935
1028,TSLA  ,2023-02-22,2023-06-16,683.33,607,0,607
1029,TSLA  ,2023-02-22,2023-06-16,691.67,894,0,894
1030,TSLA  ,2023-02-22,2023-06-16,700.0,2787,0,2787
1031,TSLA  ,2023-02-22,2023-06-16,708.33,547,0,547
1032,TSLA  ,2023-02-22,2023-06-16,716.67,705,0,705
1033,TSLA  ,2023-02-22,2023-06-16,725.0,1184,0,1184
1034,TSLA  ,2023-02-22,2023-06-16,733.33,2256,0,2256
1035,TSLA  ,2023-02-22,2023-06-16,741.67,767,0,767
1036,TSLA  ,2023-02-22,2023-06-16,750.0,11730,0,11730
1037,TSLA  ,2023-02-22,2023-06-16,758.33,1299,0,1299
1038,TSLA  ,2023-02-22,2023-06-16,766.67,1263,0,1263
1039,TSLA  ,2023-02-22,2023-06-16,775.0,1167,0,1167
1040,TSLA  ,2023-02-22,2023-06-16,783.33,2229,0,2229
1041,TSLA  ,2023-02-22,2023-06-16,791.67,1890,0,1890
1042,TSLA  ,2023-02-22,2023-06-16,800.0,10194,0,10194
1043,TSLA  ,2023-02-22,2023-06-16,808.33,1277,0,1277
1044,TSLA  ,2023-02-22,2023-06-16,816.67,1910,0,1910
1045,TSLA  ,2023-02-22,2023-06-16,825.0,43457,0,43457
1046,TSLA  ,2023-02-22,2023-07-21,5.0,32,723,755
1047,TSLA  ,2023-02-22,2023-07-21,10.0,5,907,912
1048,TSLA  ,2023-02-22,2023-07-21,15.0,4,644,648
1049,TSLA  ,2023-02-22,2023-07-21,20.0,17,1214,1231
1050,TSLA  ,2023-02-22,2023-07-21,25.0,25,1025,1050
1051,TSLA  ,2023-02-22,2023-07-21,30.0,111,1445,1556
1052,TSLA  ,2023-02-22,2023-07-21,35.0,42,838,880
1053,TSLA  ,2023-02-22,2023-07-21,40.0,21,1188,1209
1054,TSLA  ,2023-02-22,2023-07-21,45.0,38,630,668
1055,TSLA  ,2023-02-22,2023-07-21,50.0,70,5157,5227
1056,TSLA  ,2023-02-22,2023-07-21,55.0,86,1857,1943
1057,TSLA  ,2023-02-22,2023-07-21,60.0,94,3689,3783
1058,TSLA  ,2023-02-22,2023-07-21,65.0,89,404,493
1059,TSLA  ,2023-02-22,2023-07-21,70.0,25,2204,2229
1060,TSLA  ,2023-02-22,2023-07-21,75.0,63,4253,4316
1061,TSLA  ,2023-02-22,2023-07-21,80.0,79,3674,3753
1062,TSLA  ,2023-02-22,2023-07-21,85.0,54,1389,1443
1063,TSLA  ,2023-02-22,2023-07-21,90.0,121,3482,3603
1064,TSLA  ,2023-02-22,2023-07-21,95.0,68,1627,1695
1065,TSLA  ,2023-02-22,2023-07-21,100.0,336,5843,6179
1066,TSLA  ,2023-02-22,2023-07-21,105.0,373,2540,2913
1067,TSLA  ,2023-02-22,2023-07-21,110.0,1123,3790,4913
1068,TSLA  ,2023-02-22,2023-07-21,115.0,455,1020,1475
1069,TSLA  ,2023-02-22,2023-07-21,120.0,1252,4593,5845
1070,TSLA  ,2023-02-22,2023-07-21,125.0,1407,2200,3607
1071,TSLA  ,2023-02-22,2023-07-21,130.0,1500,2163,3663
1072,TSLA  ,2023-02-22,2023-07-21,135.0,1143,2725,3868
1073,TSLA  ,2023-02-22,2023-07-21,140.0,1474,4200,5674
1074,TSLA  ,2023-02-22,2023-07-21,145.0,1064,2290,3354
1075,TSLA  ,2023-02-22,2023-07-21,150.0,3181,3910,7091
1076,TSLA  ,2023-02-22,2023-07-21,155.0,1684,2877,4561
1077,TSLA  ,2023-02-22,2023-07-21,160.0,1761,1709,3470
1078,TSLA  ,2023-02-22,2023-07-21,165.0,676,1506,2182
1079,TSLA  ,2023-02-22,2023-07-21,170.0,1828,2849,4677
1080,TSLA  ,2023-02-22,2023-07-21,175.0,1640,1504,3144
1081,TSLA  ,2023-02-22,2023-07-21,180.0,2085,1924,4009
1082,TSLA  ,2023-02-22,2023-07-21,185.0,3944,13350,17294
1083,TSLA  ,2023-02-22,2023-07-21,190.0,2364,2332,4696
1084,TSLA  ,2023-02-22,2023-07-21,195.0,2867,1844,4711
1085,TSLA  ,2023-02-22,2023-07-21,200.0,8810,3746,12556
1086,TSLA  ,2023-02-22,2023-07-21,205.0,3757,2282,6039
1087,TSLA  ,2023-02-22,2023-07-21,210.0,4675,2291,6966
1088,TSLA  ,2023-02-22,2023-07-21,215.0,3431,1503,4934
1089,TSLA  ,2023-02-22,2023-07-21,220.0,2922,1628,4550
1090,TSLA  ,2023-02-22,2023-07-21,225.0,5215,2125,7340
1091,TSLA  ,2023-02-22,2023-07-21,230.0,1953,1273,3226
1092,TSLA  ,2023-02-22,2023-07-21,235.0,1697,697,2394
1093,TSLA  ,2023-02-22,2023-07-21,240.0,2496,1749,4245
1094,TSLA  ,2023-02-22,2023-07-21,245.0,2472,723,3195
1095,TSLA  ,2023-02-22,2023-07-21,250.0,24452,1576,26028
1096,TSLA  ,2023-02-22,2023-07-21,255.0,1008,681,1689
1097,TSLA  ,2023-02-22,2023-07-21,260.0,1607,119,1726
1098,TSLA  ,2023-02-22,2023-07-21,265.0,679,9,688
1099,TSLA  ,2023-02-22,2023-07-21,270.0,784,125,909
1100,TSLA  ,2023-02-22,2023-07-21,275.0,557,82,639
1101,TSLA  ,2023-02-22,2023-07-21,280.0,1143,147,1290
1102,TSLA  ,2023-02-22,2023-07-21,285.0,1048,147,1195
1103,TSLA  ,2023-02-22,2023-07-21,290.0,379,35,414
1104,TSLA  ,2023-02-22,2023-07-21,295.0,434,11,445
1105,TSLA  ,2023-02-22,2023-07-21,300.0,2622,78,2700
1106,TSLA  ,2023-02-22,2023-07-21,305.0,242,6,248
1107,TSLA  ,2023-02-22,2023-07-21,310.0,1391,6,1397
1108,TSLA  ,2023-02-22,2023-07-21,315.0,389,1,390
1109,TSLA  ,2023-02-22,2023-07-21,320.0,973,2,975
1110,TSLA  ,2023-02-22,2023-07-21,325.0,670,2,672
1111,TSLA  ,2023-02-22,2023-07-21,330.0,435,25,460
1112,TSLA  ,2023-02-22,2023-07-21,335.0,168,7,175
1113,TSLA  ,2023-02-22,2023-07-21,340.0,438,16,454
1114,TSLA  ,2023-02-22,2023-07-21,345.0,213,0,213
1115,TSLA  ,2023-02-22,2023-07-21,350.0,819,1,820
1116,TSLA  ,2023-02-22,2023-07-21,355.0,278,1,279
1117,TSLA  ,2023-02-22,2023-07-21,360.0,562,3,565
1118,TSLA  ,2023-02-22,2023-07-21,365.0,876,0,876
1119,TSLA  ,2023-02-22,2023-07-21,370.0,1054,0,1054
1120,TSLA  ,2023-02-22,2023-07-21,375.0,3143,0,3143
1121,TSLA  ,2023-02-22,2023-07-21,380.0,193,0,193
1122,TSLA  ,2023-02-22,2023-07-21,390.0,637,0,637
1123,TSLA  ,2023-02-22,2023-07-21,400.0,55,0,55
1124,TSLA  ,2023-02-22,2023-07-21,410.0,180,0,180
1125,TSLA  ,2023-02-22,2023-09-15,1.67,861,20044,20905
1126,TSLA  ,2023-02-22,2023-09-15,3.33,1085,2849,3934
1127,TSLA  ,2023-02-22,2023-09-15,5.0,34,942,976
1128,TSLA  ,2023-02-22,2023-09-15,6.67,29,3368,3397
1129,TSLA  ,2023-02-22,2023-09-15,8.33,32,1181,1213
1130,TSLA  ,2023-02-22,2023-09-15,10.0,26,2774,2800
1131,TSLA  ,2023-02-22,2023-09-15,11.67,49,619,668
1132,TSLA  ,2023-02-22,2023-09-15,13.33,83,230,313
1133,TSLA  ,2023-02-22,2023-09-15,15.0,0,138,138
1134,TSLA  ,2023-02-22,2023-09-15,16.67,143,4213,4356
1135,TSLA  ,2023-02-22,2023-09-15,30.0,0,309,309
1136,TSLA  ,2023-02-22,2023-09-15,33.33,3118,11301,14419
1137,TSLA  ,2023-02-22,2023-09-15,35.0,5,528,533
1138,TSLA  ,2023-02-22,2023-09-15,40.0,9,282,291
1139,TSLA  ,2023-02-22,2023-09-15,45.0,9,49,58
1140,TSLA  ,2023-02-22,2023-09-15,50.0,418,7874,8292
1141,TSLA  ,2023-02-22,2023-09-15,55.0,23,2373,2396
1142,TSLA  ,2023-02-22,2023-09-15,60.0,30,4762,4792
1143,TSLA  ,2023-02-22,2023-09-15,65.0,4,2216,2220
1144,TSLA  ,2023-02-22,2023-09-15,66.67,434,5690,6124
1145,TSLA  ,2023-02-22,2023-09-15,70.0,86,614,700
1146,TSLA  ,2023-02-22,2023-09-15,75.0,26,637,663
1147,TSLA  ,2023-02-22,2023-09-15,80.0,260,913,1173
1148,TSLA  ,2023-02-22,2023-09-15,83.33,407,4460,4867
1149,TSLA  ,2023-02-22,2023-09-15,85.0,52,338,390
1150,TSLA  ,2023-02-22,2023-09-15,90.0,485,2740,3225
1151,TSLA  ,2023-02-22,2023-09-15,95.0,70,2435,2505
1152,TSLA  ,2023-02-22,2023-09-15,100.0,2489,12136,14625
1153,TSLA  ,2023-02-22,2023-09-15,105.0,88,2165,2253
1154,TSLA  ,2023-02-22,2023-09-15,108.33,397,2143,2540
1155,TSLA  ,2023-02-22,2023-09-15,110.0,1198,1533,2731
1156,TSLA  ,2023-02-22,2023-09-15,115.0,260,2826,3086
1157,TSLA  ,2023-02-22,2023-09-15,116.67,569,12232,12801
1158,TSLA  ,2023-02-22,2023-09-15,120.0,854,2046,2900
1159,TSLA  ,2023-02-22,2023-09-15,123.33,523,1352,1875
1160,TSLA  ,2023-02-22,2023-09-15,125.0,1733,8141,9874
1161,TSLA  ,2023-02-22,2023-09-15,126.67,130,1069,1199
1162,TSLA  ,2023-02-22,2023-09-15,130.0,1400,5002,6402
1163,TSLA  ,2023-02-22,2023-09-15,133.33,220,2368,2588
1164,TSLA  ,2023-02-22,2023-09-15,135.0,231,1235,1466
1165,TSLA  ,2023-02-22,2023-09-15,136.67,287,957,1244
1166,TSLA  ,2023-02-22,2023-09-15,140.0,1733,2727,4460
1167,TSLA  ,2023-02-22,2023-09-15,141.67,763,1683,2446
1168,TSLA  ,2023-02-22,2023-09-15,143.33,283,1539,1822
1169,TSLA  ,2023-02-22,2023-09-15,145.0,347,2628,2975
1170,TSLA  ,2023-02-22,2023-09-15,146.67,1372,1093,2465
1171,TSLA  ,2023-02-22,2023-09-15,150.0,33704,8983,42687
1172,TSLA  ,2023-02-22,2023-09-15,153.33,30476,1822,32298
1173,TSLA  ,2023-02-22,2023-09-15,155.0,423,396,819
1174,TSLA  ,2023-02-22,2023-09-15,156.67,394,778,1172
1175,TSLA  ,2023-02-22,2023-09-15,158.33,313,603,916
1176,TSLA  ,2023-02-22,2023-09-15,160.0,3712,7210,10922
1177,TSLA  ,2023-02-22,2023-09-15,163.33,396,1504,1900
1178,TSLA  ,2023-02-22,2023-09-15,165.0,1247,860,2107
1179,TSLA  ,2023-02-22,2023-09-15,166.67,1391,3252,4643
1180,TSLA  ,2023-02-22,2023-09-15,170.0,633,790,1423
1181,TSLA  ,2023-02-22,2023-09-15,173.33,10304,3049,13353
1182,TSLA  ,2023-02-22,2023-09-15,175.0,10895,7919,18814
1183,TSLA  ,2023-02-22,2023-09-15,180.0,33701,6995,40696
1184,TSLA  ,2023-02-22,2023-09-15,183.33,32271,4815,37086
1185,TSLA  ,2023-02-22,2023-09-15,185.0,335,835,1170
1186,TSLA  ,2023-02-22,2023-09-15,186.67,521,3490,4011
1187,TSLA  ,2023-02-22,2023-09-15,190.0,729,3528,4257
1188,TSLA  ,2023-02-22,2023-09-15,191.67,491,1212,1703
1189,TSLA  ,2023-02-22,2023-09-15,193.33,897,3054,3951
1190,TSLA  ,2023-02-22,2023-09-15,195.0,475,1024,1499
1191,TSLA  ,2023-02-22,2023-09-15,200.0,11834,17325,29159
1192,TSLA  ,2023-02-22,2023-09-15,205.0,622,656,1278
1193,TSLA  ,2023-02-22,2023-09-15,206.67,1159,687,1846
1194,TSLA  ,2023-02-22,2023-09-15,208.33,602,1984,2586
1195,TSLA  ,2023-02-22,2023-09-15,210.0,2417,444,2861
1196,TSLA  ,2023-02-22,2023-09-15,213.33,973,1232,2205
1197,TSLA  ,2023-02-22,2023-09-15,215.0,1180,324,1504
1198,TSLA  ,2023-02-22,2023-09-15,216.67,2026,4087,6113
1199,TSLA  ,2023-02-22,2023-09-15,220.0,8869,4196,13065
1200,TSLA  ,2023-02-22,2023-09-15,225.0,2950,3410,6360
1201,TSLA  ,2023-02-22,2023-09-15,226.67,2274,1554,3828
1202,TSLA  ,2023-02-22,2023-09-15,230.0,3392,1007,4399
1203,TSLA  ,2023-02-22,2023-09-15,233.33,2795,3527,6322
1204,TSLA  ,2023-02-22,2023-09-15,235.0,782,985,1767
1205,TSLA  ,2023-02-22,2023-09-15,240.0,1899,1885,3784
1206,TSLA  ,2023-02-22,2023-09-15,241.67,1366,1004,2370
1207,TSLA  ,2023-02-22,2023-09-15,245.0,227,370,597
1208,TSLA  ,2023-02-22,2023-09-15,246.67,511,957,1468
1209,TSLA  ,2023-02-22,2023-09-15,250.0,10879,5798,16677
1210,TSLA  ,2023-02-22,2023-09-15,253.33,800,705,1505
1211,TSLA  ,2023-02-22,2023-09-15,255.0,343,156,499
1212,TSLA  ,2023-02-22,2023-09-15,258.33,944,2412,3356
1213,TSLA  ,2023-02-22,2023-09-15,260.0,11850,1418,13268
1214,TSLA  ,2023-02-22,2023-09-15,265.0,393,151,544
1215,TSLA  ,2023-02-22,2023-09-15,266.67,2375,324,2699
1216,TSLA  ,2023-02-22,2023-09-15,270.0,376,162,538
1217,TSLA  ,2023-02-22,2023-09-15,273.33,677,383,1060
1218,TSLA  ,2023-02-22,2023-09-15,275.0,2891,3223,6114
1219,TSLA  ,2023-02-22,2023-09-15,280.0,2460,576,3036
1220,TSLA  ,2023-02-22,2023-09-15,283.33,1233,316,1549
1221,TSLA  ,2023-02-22,2023-09-15,286.67,603,97,700
1222,TSLA  ,2023-02-22,2023-09-15,290.0,1456,65,1521
1223,TSLA  ,2023-02-22,2023-09-15,291.67,958,386,1344
1224,TSLA  ,2023-02-22,2023-09-15,293.33,1345,460,1805
1225,TSLA  ,2023-02-22,2023-09-15,300.0,8009,967,8976
1226,TSLA  ,2023-02-22,2023-09-15,306.67,2721,327,3048
1227,TSLA  ,2023-02-22,2023-09-15,308.33,868,335,1203
1228,TSLA  ,2023-02-22,2023-09-15,310.0,102,0,102
1229,TSLA  ,2023-02-22,2023-09-15,313.33,804,287,1091
1230,TSLA  ,2023-02-22,2023-09-15,316.67,1622,162,1784
1231,TSLA  ,2023-02-22,2023-09-15,320.0,2524,169,2693
1232,TSLA  ,2023-02-22,2023-09-15,325.0,2805,75,2880
1233,TSLA  ,2023-02-22,2023-09-15,326.67,1067,5,1072
1234,TSLA  ,2023-02-22,2023-09-15,333.33,6457,83,6540
1235,TSLA  ,2023-02-22,2023-09-15,340.0,23363,148,23511
1236,TSLA  ,2023-02-22,2023-09-15,341.67,181,187,368
1237,TSLA  ,2023-02-22,2023-09-15,346.67,549,137,686
1238,TSLA  ,2023-02-22,2023-09-15,350.0,20884,328,21212
1239,TSLA  ,2023-02-22,2023-09-15,353.33,22637,149,22786
1240,TSLA  ,2023-02-22,2023-09-15,358.33,467,287,754
1241,TSLA  ,2023-02-22,2023-09-15,360.0,3425,307,3732
1242,TSLA  ,2023-02-22,2023-09-15,366.67,2807,561,3368
1243,TSLA  ,2023-02-22,2023-09-15,375.0,3292,160,3452
1244,TSLA  ,2023-02-22,2023-09-15,383.33,4642,47,4689
1245,TSLA  ,2023-02-22,2023-09-15,391.67,843,14,857
1246,TSLA  ,2023-02-22,2023-09-15,400.0,5820,69,5889
1247,TSLA  ,2023-02-22,2023-09-15,408.33,1613,1,1614
1248,TSLA  ,2023-02-22,2023-09-15,416.67,1109,0,1109
1249,TSLA  ,2023-02-22,2023-09-15,425.0,3327,0,3327
1250,TSLA  ,2023-02-22,2023-09-15,433.33,4935,15,4950
1251,TSLA  ,2023-02-22,2023-09-15,441.67,1060,0,1060
1252,TSLA  ,2023-02-22,2023-09-15,450.0,2539,0,2539
1253,TSLA  ,2023-02-22,2023-09-15,458.33,402,0,402
1254,TSLA  ,2023-02-22,2023-09-15,466.67,2696,0,2696
1255,TSLA  ,2023-02-22,2023-09-15,475.0,328,0,328
1256,TSLA  ,2023-02-22,2023-09-15,483.33,669,0,669
1257,TSLA  ,2023-02-22,2023-09-15,491.67,1117,0,1117
1258,TSLA  ,2023-02-22,2023-09-15,500.0,5715,0,5715
1259,TSLA  ,2023-02-22,2023-09-15,508.33,812,0,812
1260,TSLA  ,2023-02-22,2023-09-15,516.67,1270,0,1270
1261,TSLA  ,2023-02-22,2023-09-15,525.0,1191,0,1191
1262,TSLA  ,2023-02-22,2023-09-15,533.33,1597,0,1597
1263,TSLA  ,2023-02-22,2023-09-15,541.67,1167,0,1167
1264,TSLA  ,2023-02-22,2023-09-15,550.0,11723,0,11723
1265,TSLA  ,2023-02-22,2023-09-15,558.33,188,0,188
1266,TSLA  ,2023-02-22,2023-09-15,566.67,4046,0,4046
1267,TSLA  ,2023-02-22,2023-09-15,575.0,414,0,414
1268,TSLA  ,2023-02-22,2023-09-15,583.33,516,0,516
1269,TSLA  ,2023-02-22,2023-09-15,591.67,2112,0,2112
1270,TSLA  ,2023-02-22,2023-09-15,600.0,8750,0,8750
1271,TSLA  ,2023-02-22,2023-09-15,608.33,671,0,671
1272,TSLA  ,2023-02-22,2023-09-15,616.67,1021,0,1021
1273,TSLA  ,2023-02-22,2023-09-15,625.0,1068,0,1068
1274,TSLA  ,2023-02-22,2023-09-15,633.33,716,0,716
1275,TSLA  ,2023-02-22,2023-09-15,641.67,425,0,425
1276,TSLA  ,2023-02-22,2023-09-15,650.0,27723,0,27723
1277,TSLA  ,2023-02-22,2023-09-15,658.33,1206,0,1206
1278,TSLA  ,2023-02-22,2023-09-15,666.67,1349,0,1349
1279,TSLA  ,2023-02-22,2023-09-15,675.0,466,0,466
1280,TSLA  ,2023-02-22,2023-09-15,683.33,459,0,459
1281,TSLA  ,2023-02-22,2023-09-15,700.0,1534,0,1534
1282,TSLA  ,2023-02-22,2023-09-15,716.67,1042,0,1042
1283,TSLA  ,2023-02-22,2023-09-15,733.33,2322,0,2322
1284,TSLA  ,2023-02-22,2023-09-15,750.0,8211,0,8211
1285,TSLA  ,2023-02-22,2023-09-15,758.33,71900,0,71900
1286,TSLA  ,2023-02-22,2023-12-15,50.0,1399,14197,15596
1287,TSLA  ,2023-02-22,2023-12-15,55.0,222,1193,1415
1288,TSLA  ,2023-02-22,2023-12-15,60.0,40,1346,1386
1289,TSLA  ,2023-02-22,2023-12-15,65.0,4,383,387
1290,TSLA  ,2023-02-22,2023-12-15,70.0,27,3880,3907
1291,TSLA  ,2023-02-22,2023-12-15,75.0,19,4131,4150
1292,TSLA  ,2023-02-22,2023-12-15,80.0,156,961,1117
1293,TSLA  ,2023-02-22,2023-12-15,85.0,2574,2368,4942
1294,TSLA  ,2023-02-22,2023-12-15,90.0,1648,6022,7670
1295,TSLA  ,2023-02-22,2023-12-15,95.0,831,499,1330
1296,TSLA  ,2023-02-22,2023-12-15,100.0,3404,7087,10491
1297,TSLA  ,2023-02-22,2023-12-15,105.0,321,2275,2596
1298,TSLA  ,2023-02-22,2023-12-15,110.0,679,2233,2912
1299,TSLA  ,2023-02-22,2023-12-15,115.0,1711,966,2677
1300,TSLA  ,2023-02-22,2023-12-15,120.0,1025,1390,2415
1301,TSLA  ,2023-02-22,2023-12-15,125.0,526,1583,2109
1302,TSLA  ,2023-02-22,2023-12-15,130.0,769,11524,12293
1303,TSLA  ,2023-02-22,2023-12-15,135.0,789,6083,6872
1304,TSLA  ,2023-02-22,2023-12-15,140.0,947,1885,2832
1305,TSLA  ,2023-02-22,2023-12-15,145.0,623,960,1583
1306,TSLA  ,2023-02-22,2023-12-15,150.0,1503,12700,14203
1307,TSLA  ,2023-02-22,2023-12-15,155.0,393,1057,1450
1308,TSLA  ,2023-02-22,2023-12-15,160.0,2845,11040,13885
1309,TSLA  ,2023-02-22,2023-12-15,165.0,1440,530,1970
1310,TSLA  ,2023-02-22,2023-12-15,170.0,747,4539,5286
1311,TSLA  ,2023-02-22,2023-12-15,175.0,2080,452,2532
1312,TSLA  ,2023-02-22,2023-12-15,180.0,1600,1236,2836
1313,TSLA  ,2023-02-22,2023-12-15,185.0,562,660,1222
1314,TSLA  ,2023-02-22,2023-12-15,190.0,1094,561,1655
1315,TSLA  ,2023-02-22,2023-12-15,195.0,785,984,1769
1316,TSLA  ,2023-02-22,2023-12-15,200.0,8206,1584,9790
1317,TSLA  ,2023-02-22,2023-12-15,205.0,6591,815,7406
1318,TSLA  ,2023-02-22,2023-12-15,210.0,3256,749,4005
1319,TSLA  ,2023-02-22,2023-12-15,215.0,1294,656,1950
1320,TSLA  ,2023-02-22,2023-12-15,220.0,1626,1196,2822
1321,TSLA  ,2023-02-22,2023-12-15,225.0,1223,303,1526
1322,TSLA  ,2023-02-22,2023-12-15,230.0,2259,734,2993
1323,TSLA  ,2023-02-22,2023-12-15,235.0,512,448,960
1324,TSLA  ,2023-02-22,2023-12-15,240.0,5780,711,6491
1325,TSLA  ,2023-02-22,2023-12-15,245.0,2367,514,2881
1326,TSLA  ,2023-02-22,2023-12-15,250.0,15771,3668,19439
1327,TSLA  ,2023-02-22,2023-12-15,260.0,10257,1779,12036
1328,TSLA  ,2023-02-22,2023-12-15,270.0,4021,522,4543
1329,TSLA  ,2023-02-22,2023-12-15,280.0,1448,680,2128
1330,TSLA  ,2023-02-22,2023-12-15,290.0,522,493,1015
1331,TSLA  ,2023-02-22,2023-12-15,300.0,1768,1045,2813
1332,TSLA  ,2023-02-22,2023-12-15,310.0,763,621,1384
1333,TSLA  ,2023-02-22,2023-12-15,320.0,1155,537,1692
1334,TSLA  ,2023-02-22,2023-12-15,330.0,379,232,611
1335,TSLA  ,2023-02-22,2023-12-15,340.0,334,120,454
1336,TSLA  ,2023-02-22,2023-12-15,350.0,1108,183,1291
1337,TSLA  ,2023-02-22,2023-12-15,360.0,617,117,734
1338,TSLA  ,2023-02-22,2023-12-15,370.0,132,244,376
1339,TSLA  ,2023-02-22,2023-12-15,380.0,484,321,805
1340,TSLA  ,2023-02-22,2023-12-15,390.0,1521,147,1668
1341,TSLA  ,2023-02-22,2023-12-15,400.0,13,0,13
1342,TSLA  ,2023-02-22,2023-12-15,410.0,42,45,87
1343,TSLA  ,2023-02-22,2024-01-19,1.67,2502,29775,32277
1344,TSLA  ,2023-02-22,2024-01-19,3.33,968,6127,7095
1345,TSLA  ,2023-02-22,2024-01-19,5.0,259,10876,11135
1346,TSLA  ,2023-02-22,2024-01-19,6.67,76,3481,3557
1347,TSLA  ,2023-02-22,2024-01-19,8.33,3902,2868,6770
1348,TSLA  ,2023-02-22,2024-01-19,10.0,294,4570,4864
1349,TSLA  ,2023-02-22,2024-01-19,11.67,253,3721,3974
1350,TSLA  ,2023-02-22,2024-01-19,13.33,819,512,1331
1351,TSLA  ,2023-02-22,2024-01-19,15.0,279,2063,2342
1352,TSLA  ,2023-02-22,2024-01-19,16.67,486,4672,5158
1353,TSLA  ,2023-02-22,2024-01-19,18.33,393,6118,6511
1354,TSLA  ,2023-02-22,2024-01-19,20.0,258,7605,7863
1355,TSLA  ,2023-02-22,2024-01-19,21.67,118,849,967
1356,TSLA  ,2023-02-22,2024-01-19,23.33,382,3875,4257
1357,TSLA  ,2023-02-22,2024-01-19,25.0,369,3204,3573
1358,TSLA  ,2023-02-22,2024-01-19,26.67,833,1127,1960
1359,TSLA  ,2023-02-22,2024-01-19,28.33,341,747,1088
1360,TSLA  ,2023-02-22,2024-01-19,30.0,228,8862,9090
1361,TSLA  ,2023-02-22,2024-01-19,31.67,1326,1353,2679
1362,TSLA  ,2023-02-22,2024-01-19,33.33,4315,32825,37140
1363,TSLA  ,2023-02-22,2024-01-19,50.0,2166,31105,33271
1364,TSLA  ,2023-02-22,2024-01-19,55.0,80,1490,1570
1365,TSLA  ,2023-02-22,2024-01-19,60.0,249,2621,2870
1366,TSLA  ,2023-02-22,2024-01-19,65.0,266,750,1016
1367,TSLA  ,2023-02-22,2024-01-19,66.67,4703,14826,19529
1368,TSLA  ,2023-02-22,2024-01-19,70.0,155,820,975
1369,TSLA  ,2023-02-22,2024-01-19,75.0,91,1162,1253
1370,TSLA  ,2023-02-22,2024-01-19,80.0,405,2058,2463
1371,TSLA  ,2023-02-22,2024-01-19,83.33,1066,8128,9194
1372,TSLA  ,2023-02-22,2024-01-19,85.0,511,438,949
1373,TSLA  ,2023-02-22,2024-01-19,90.0,3548,1339,4887
1374,TSLA  ,2023-02-22,2024-01-19,95.0,2980,1535,4515
1375,TSLA  ,2023-02-22,2024-01-19,100.0,13992,40712,54704
1376,TSLA  ,2023-02-22,2024-01-19,105.0,1278,2118,3396
1377,TSLA  ,2023-02-22,2024-01-19,110.0,4800,7100,11900
1378,TSLA  ,2023-02-22,2024-01-19,115.0,4674,5604,10278
1379,TSLA  ,2023-02-22,2024-01-19,116.67,1928,8398,10326
1380,TSLA  ,2023-02-22,2024-01-19,120.0,3435,6486,9921
1381,TSLA  ,2023-02-22,2024-01-19,123.33,1962,2225,4187
1382,TSLA  ,2023-02-22,2024-01-19,125.0,2403,13688,16091
1383,TSLA  ,2023-02-22,2024-01-19,126.67,1743,6632,8375
1384,TSLA  ,2023-02-22,2024-01-19,130.0,5082,11787,16869
1385,TSLA  ,2023-02-22,2024-01-19,133.33,2435,11092,13527
1386,TSLA  ,2023-02-22,2024-01-19,135.0,1260,1310,2570
1387,TSLA  ,2023-02-22,2024-01-19,136.67,2432,2315,4747
1388,TSLA  ,2023-02-22,2024-01-19,140.0,5091,4278,9369
1389,TSLA  ,2023-02-22,2024-01-19,143.33,1673,2303,3976
1390,TSLA  ,2023-02-22,2024-01-19,145.0,782,872,1654
1391,TSLA  ,2023-02-22,2024-01-19,146.67,1043,1006,2049
1392,TSLA  ,2023-02-22,2024-01-19,150.0,17792,22398,40190
1393,TSLA  ,2023-02-22,2024-01-19,153.33,10512,1071,11583
1394,TSLA  ,2023-02-22,2024-01-19,155.0,562,1443,2005
1395,TSLA  ,2023-02-22,2024-01-19,156.67,1725,876,2601
1396,TSLA  ,2023-02-22,2024-01-19,160.0,3098,12504,15602
1397,TSLA  ,2023-02-22,2024-01-19,163.33,476,8272,8748
1398,TSLA  ,2023-02-22,2024-01-19,165.0,694,578,1272
1399,TSLA  ,2023-02-22,2024-01-19,166.67,6754,6888,13642
1400,TSLA  ,2023-02-22,2024-01-19,170.0,2798,6361,9159
1401,TSLA  ,2023-02-22,2024-01-19,173.33,854,2583,3437
1402,TSLA  ,2023-02-22,2024-01-19,175.0,1733,3966,5699
1403,TSLA  ,2023-02-22,2024-01-19,176.67,1021,1262,2283
1404,TSLA  ,2023-02-22,2024-01-19,180.0,39015,11069,50084
1405,TSLA  ,2023-02-22,2024-01-19,183.33,34445,7441,41886
1406,TSLA  ,2023-02-22,2024-01-19,185.0,1350,783,2133
1407,TSLA  ,2023-02-22,2024-01-19,186.67,1265,2295,3560
1408,TSLA  ,2023-02-22,2024-01-19,190.0,1650,748,2398
1409,TSLA  ,2023-02-22,2024-01-19,193.33,2291,9809,12100
1410,TSLA  ,2023-02-22,2024-01-19,195.0,715,1970,2685
1411,TSLA  ,2023-02-22,2024-01-19,200.0,33561,24239,57800
1412,TSLA  ,2023-02-22,2024-01-19,203.33,6322,2366,8688
1413,TSLA  ,2023-02-22,2024-01-19,206.67,1687,1282,2969
1414,TSLA  ,2023-02-22,2024-01-19,210.0,11305,6915,18220
1415,TSLA  ,2023-02-22,2024-01-19,213.33,1752,2696,4448
1416,TSLA  ,2023-02-22,2024-01-19,216.67,8598,6745,15343
1417,TSLA  ,2023-02-22,2024-01-19,220.0,6995,7211,14206
1418,TSLA  ,2023-02-22,2024-01-19,223.33,6080,1684,7764
1419,TSLA  ,2023-02-22,2024-01-19,226.67,20006,2995,23001
1420,TSLA  ,2023-02-22,2024-01-19,230.0,14562,18666,33228
1421,TSLA  ,2023-02-22,2024-01-19,233.33,36933,13573,50506
1422,TSLA  ,2023-02-22,2024-01-19,236.67,2009,1701,3710
1423,TSLA  ,2023-02-22,2024-01-19,240.0,4586,3780,8366
1424,TSLA  ,2023-02-22,2024-01-19,243.33,1284,2021,3305
1425,TSLA  ,2023-02-22,2024-01-19,246.67,1176,2109,3285
1426,TSLA  ,2023-02-22,2024-01-19,250.0,22317,5347,27664
1427,TSLA  ,2023-02-22,2024-01-19,253.33,2866,2090,4956
1428,TSLA  ,2023-02-22,2024-01-19,256.67,2827,1641,4468
1429,TSLA  ,2023-02-22,2024-01-19,260.0,7640,3240,10880
1430,TSLA  ,2023-02-22,2024-01-19,263.33,7760,2159,9919
1431,TSLA  ,2023-02-22,2024-01-19,266.67,10209,8799,19008
1432,TSLA  ,2023-02-22,2024-01-19,270.0,4644,5210,9854
1433,TSLA  ,2023-02-22,2024-01-19,273.33,3397,3092,6489
1434,TSLA  ,2023-02-22,2024-01-19,276.67,1972,1781,3753
1435,TSLA  ,2023-02-22,2024-01-19,280.0,9258,6511,15769
1436,TSLA  ,2023-02-22,2024-01-19,283.33,3144,3089,6233
1437,TSLA  ,2023-02-22,2024-01-19,286.67,2472,1509,3981
1438,TSLA  ,2023-02-22,2024-01-19,290.0,9075,577,9652
1439,TSLA  ,2023-02-22,2024-01-19,293.33,2902,1990,4892
1440,TSLA  ,2023-02-22,2024-01-19,296.67,2177,1688,3865
1441,TSLA  ,2023-02-22,2024-01-19,300.0,25697,6205,31902
1442,TSLA  ,2023-02-22,2024-01-19,303.33,3451,289,3740
1443,TSLA  ,2023-02-22,2024-01-19,306.67,6582,133,6715
1444,TSLA  ,2023-02-22,2024-01-19,310.0,3712,1038,4750
1445,TSLA  ,2023-02-22,2024-01-19,313.33,1200,27,1227
1446,TSLA  ,2023-02-22,2024-01-19,316.67,4149,306,4455
1447,TSLA  ,2023-02-22,2024-01-19,320.0,6238,326,6564
1448,TSLA  ,2023-02-22,2024-01-19,323.33,453,268,721
1449,TSLA  ,2023-02-22,2024-01-19,325.0,10243,135,10378
1450,TSLA  ,2023-02-22,2024-01-19,326.67,1376,630,2006
1451,TSLA  ,2023-02-22,2024-01-19,330.0,7460,11,7471
1452,TSLA  ,2023-02-22,2024-01-19,333.33,30441,1739,32180
1453,TSLA  ,2023-02-22,2024-01-19,336.67,1467,7,1474
1454,TSLA  ,2023-02-22,2024-01-19,340.0,3702,5,3707
1455,TSLA  ,2023-02-22,2024-01-19,341.67,865,10,875
1456,TSLA  ,2023-02-22,2024-01-19,343.33,552,0,552
1457,TSLA  ,2023-02-22,2024-01-19,346.67,2398,3,2401
1458,TSLA  ,2023-02-22,2024-01-19,350.0,15646,761,16407
1459,TSLA  ,2023-02-22,2024-01-19,353.33,1162,0,1162
1460,TSLA  ,2023-02-22,2024-01-19,356.67,902,0,902
1461,TSLA  ,2023-02-22,2024-01-19,358.33,1240,3,1243
1462,TSLA  ,2023-02-22,2024-01-19,360.0,9291,600,9891
1463,TSLA  ,2023-02-22,2024-01-19,363.33,517,7,524
1464,TSLA  ,2023-02-22,2024-01-19,366.67,38808,2807,41615
1465,TSLA  ,2023-02-22,2024-01-19,370.0,5981,4,5985
1466,TSLA  ,2023-02-22,2024-01-19,373.33,1058,12,1070
1467,TSLA  ,2023-02-22,2024-01-19,375.0,11422,8,11430
1468,TSLA  ,2023-02-22,2024-01-19,376.67,553,106,659
1469,TSLA  ,2023-02-22,2024-01-19,380.0,1101,2,1103
1470,TSLA  ,2023-02-22,2024-01-19,383.33,3090,3,3093
1471,TSLA  ,2023-02-22,2024-01-19,386.67,408,203,611
1472,TSLA  ,2023-02-22,2024-01-19,390.0,920,1,921
1473,TSLA  ,2023-02-22,2024-01-19,391.67,2333,1,2334
1474,TSLA  ,2023-02-22,2024-01-19,393.33,519,4,523
1475,TSLA  ,2023-02-22,2024-01-19,396.67,2706,0,2706
1476,TSLA  ,2023-02-22,2024-01-19,400.0,40275,1021,41296
1477,TSLA  ,2023-02-22,2024-01-19,408.33,5168,21,5189
1478,TSLA  ,2023-02-22,2024-01-19,416.67,4048,2172,6220
1479,TSLA  ,2023-02-22,2024-01-19,425.0,4526,18,4544
1480,TSLA  ,2023-02-22,2024-01-19,433.33,5781,3,5784
1481,TSLA  ,2023-02-22,2024-01-19,441.67,1302,0,1302
1482,TSLA  ,2023-02-22,2024-01-19,450.0,8081,2427,10508
1483,TSLA  ,2023-02-22,2024-01-19,458.33,2000,0,2000
1484,TSLA  ,2023-02-22,2024-01-19,466.67,27612,0,27612
1485,TSLA  ,2023-02-22,2024-01-19,475.0,5073,195,5268
1486,TSLA  ,2023-02-22,2024-01-19,483.33,1583,20,1603
1487,TSLA  ,2023-02-22,2024-01-19,491.67,2149,0,2149
1488,TSLA  ,2023-02-22,2024-01-19,500.0,36511,170,36681
1489,TSLA  ,2023-02-22,2024-01-19,516.67,4838,0,4838
1490,TSLA  ,2023-02-22,2024-01-19,533.33,20823,0,20823
1491,TSLA  ,2023-02-22,2024-01-19,550.0,16150,0,16150
1492,TSLA  ,2023-02-22,2024-01-19,558.33,1202,0,1202
1493,TSLA  ,2023-02-22,2024-01-19,566.67,11406,0,11406
1494,TSLA  ,2023-02-22,2024-01-19,575.0,13825,0,13825
1495,TSLA  ,2023-02-22,2024-01-19,583.33,13822,0,13822
1496,TSLA  ,2023-02-22,2024-01-19,591.67,2279,0,2279
1497,TSLA  ,2023-02-22,2024-01-19,600.0,18634,0,18634
1498,TSLA  ,2023-02-22,2024-01-19,608.33,2281,0,2281
1499,TSLA  ,2023-02-22,2024-01-19,616.67,11852,0,11852
1500,TSLA  ,2023-02-22,2024-01-19,625.0,2414,0,2414
1501,TSLA  ,2023-02-22,2024-01-19,633.33,5738,0,5738
1502,TSLA  ,2023-02-22,2024-01-19,641.67,929,0,929
1503,TSLA  ,2023-02-22,2024-01-19,650.0,3209,0,3209
1504,TSLA  ,2023-02-22,2024-01-19,666.67,40730,0,40730
1505,TSLA  ,2023-02-22,2024-01-19,675.0,4361,0,4361
1506,TSLA  ,2023-02-22,2024-01-19,683.33,7130,0,7130
1507,TSLA  ,2023-02-22,2024-01-19,691.67,1564,0,1564
1508,TSLA  ,2023-02-22,2024-01-19,700.0,5364,0,5364
1509,TSLA  ,2023-02-22,2024-01-19,708.33,761,0,761
1510,TSLA  ,2023-02-22,2024-01-19,716.67,6075,0,6075
1511,TSLA  ,2023-02-22,2024-01-19,725.0,2692,3,2695
1512,TSLA  ,2023-02-22,2024-01-19,733.33,3398,0,3398
1513,TSLA  ,2023-02-22,2024-01-19,741.67,805,0,805
1514,TSLA  ,2023-02-22,2024-01-19,750.0,2346,0,2346
1515,TSLA  ,2023-02-22,2024-01-19,758.33,932,0,932
1516,TSLA  ,2023-02-22,2024-01-19,766.67,2113,0,2113
1517,TSLA  ,2023-02-22,2024-01-19,775.0,2829,0,2829
1518,TSLA  ,2023-02-22,2024-01-19,783.33,694,0,694
1519,TSLA  ,2023-02-22,2024-01-19,791.67,3183,0,3183
1520,TSLA  ,2023-02-22,2024-01-19,800.0,13926,0,13926
1521,TSLA  ,2023-02-22,2024-01-19,808.33,3927,0,3927
1522,TSLA  ,2023-02-22,2024-01-19,816.67,5822,1,5823
1523,TSLA  ,2023-02-22,2024-01-19,825.0,77571,0,77571
1524,TSLA  ,2023-02-22,2024-03-15,1.67,106,1895,2001
1525,TSLA  ,2023-02-22,2024-03-15,3.33,22,779,801
1526,TSLA  ,2023-02-22,2024-03-15,5.0,64,896,960
1527,TSLA  ,2023-02-22,2024-03-15,6.67,6,93,99
1528,TSLA  ,2023-02-22,2024-03-15,8.33,16,42,58
1529,TSLA  ,2023-02-22,2024-03-15,10.0,17,336,353
1530,TSLA  ,2023-02-22,2024-03-15,11.67,11,420,431
1531,TSLA  ,2023-02-22,2024-03-15,13.33,21,55,76
1532,TSLA  ,2023-02-22,2024-03-15,15.0,24,423,447
1533,TSLA  ,2023-02-22,2024-03-15,16.67,124,233,357
1534,TSLA  ,2023-02-22,2024-03-15,33.33,809,2003,2812
1535,TSLA  ,2023-02-22,2024-03-15,50.0,452,5792,6244
1536,TSLA  ,2023-02-22,2024-03-15,55.0,30,303,333
1537,TSLA  ,2023-02-22,2024-03-15,60.0,45,858,903
1538,TSLA  ,2023-02-22,2024-03-15,65.0,31,828,859
1539,TSLA  ,2023-02-22,2024-03-15,66.67,2037,1010,3047
1540,TSLA  ,2023-02-22,2024-03-15,70.0,50,238,288
1541,TSLA  ,2023-02-22,2024-03-15,75.0,20,452,472
1542,TSLA  ,2023-02-22,2024-03-15,80.0,191,558,749
1543,TSLA  ,2023-02-22,2024-03-15,83.33,999,4510,5509
1544,TSLA  ,2023-02-22,2024-03-15,85.0,291,359,650
1545,TSLA  ,2023-02-22,2024-03-15,90.0,768,776,1544
1546,TSLA  ,2023-02-22,2024-03-15,95.0,1561,411,1972
1547,TSLA  ,2023-02-22,2024-03-15,100.0,3357,3186,6543
1548,TSLA  ,2023-02-22,2024-03-15,105.0,819,729,1548
1549,TSLA  ,2023-02-22,2024-03-15,110.0,913,2548,3461
1550,TSLA  ,2023-02-22,2024-03-15,115.0,2046,211,2257
1551,TSLA  ,2023-02-22,2024-03-15,116.67,609,1050,1659
1552,TSLA  ,2023-02-22,2024-03-15,120.0,327,686,1013
1553,TSLA  ,2023-02-22,2024-03-15,125.0,793,742,1535
1554,TSLA  ,2023-02-22,2024-03-15,130.0,1556,543,2099
1555,TSLA  ,2023-02-22,2024-03-15,133.33,590,5742,6332
1556,TSLA  ,2023-02-22,2024-03-15,135.0,206,307,513
1557,TSLA  ,2023-02-22,2024-03-15,140.0,223,276,499
1558,TSLA  ,2023-02-22,2024-03-15,141.67,567,334,901
1559,TSLA  ,2023-02-22,2024-03-15,145.0,300,384,684
1560,TSLA  ,2023-02-22,2024-03-15,150.0,1299,4452,5751
1561,TSLA  ,2023-02-22,2024-03-15,155.0,88,210,298
1562,TSLA  ,2023-02-22,2024-03-15,158.33,174,583,757
1563,TSLA  ,2023-02-22,2024-03-15,160.0,243,4374,4617
1564,TSLA  ,2023-02-22,2024-03-15,165.0,151,3893,4044
1565,TSLA  ,2023-02-22,2024-03-15,166.67,587,1181,1768
1566,TSLA  ,2023-02-22,2024-03-15,170.0,290,8894,9184
1567,TSLA  ,2023-02-22,2024-03-15,175.0,746,1943,2689
1568,TSLA  ,2023-02-22,2024-03-15,180.0,300,644,944
1569,TSLA  ,2023-02-22,2024-03-15,183.33,514,1196,1710
1570,TSLA  ,2023-02-22,2024-03-15,185.0,252,260,512
1571,TSLA  ,2023-02-22,2024-03-15,190.0,1208,273,1481
1572,TSLA  ,2023-02-22,2024-03-15,191.67,1475,1393,2868
1573,TSLA  ,2023-02-22,2024-03-15,195.0,550,134,684
1574,TSLA  ,2023-02-22,2024-03-15,200.0,5289,4700,9989
1575,TSLA  ,2023-02-22,2024-03-15,208.33,1199,725,1924
1576,TSLA  ,2023-02-22,2024-03-15,210.0,505,199,704
1577,TSLA  ,2023-02-22,2024-03-15,216.67,1509,841,2350
1578,TSLA  ,2023-02-22,2024-03-15,220.0,525,65,590
1579,TSLA  ,2023-02-22,2024-03-15,225.0,2073,2421,4494
1580,TSLA  ,2023-02-22,2024-03-15,230.0,282,82,364
1581,TSLA  ,2023-02-22,2024-03-15,233.33,1625,996,2621
1582,TSLA  ,2023-02-22,2024-03-15,240.0,182,51,233
1583,TSLA  ,2023-02-22,2024-03-15,241.67,1131,955,2086
1584,TSLA  ,2023-02-22,2024-03-15,250.0,2162,1406,3568
1585,TSLA  ,2023-02-22,2024-03-15,258.33,4133,1036,5169
1586,TSLA  ,2023-02-22,2024-03-15,260.0,586,95,681
1587,TSLA  ,2023-02-22,2024-03-15,266.67,4467,810,5277
1588,TSLA  ,2023-02-22,2024-03-15,270.0,309,3,312
1589,TSLA  ,2023-02-22,2024-03-15,275.0,8969,1011,9980
1590,TSLA  ,2023-02-22,2024-03-15,280.0,152,89,241
1591,TSLA  ,2023-02-22,2024-03-15,283.33,1140,709,1849
1592,TSLA  ,2023-02-22,2024-03-15,290.0,14,4,18
1593,TSLA  ,2023-02-22,2024-03-15,291.67,1289,129,1418
1594,TSLA  ,2023-02-22,2024-03-15,300.0,4867,706,5573
1595,TSLA  ,2023-02-22,2024-03-15,308.33,407,41,448
1596,TSLA  ,2023-02-22,2024-03-15,310.0,23,0,23
1597,TSLA  ,2023-02-22,2024-03-15,316.67,934,391,1325
1598,TSLA  ,2023-02-22,2024-03-15,325.0,1578,17,1595
1599,TSLA  ,2023-02-22,2024-03-15,333.33,1071,27,1098
1600,TSLA  ,2023-02-22,2024-03-15,341.67,294,45,339
1601,TSLA  ,2023-02-22,2024-03-15,350.0,887,82,969
1602,TSLA  ,2023-02-22,2024-03-15,358.33,464,69,533
1603,TSLA  ,2023-02-22,2024-03-15,366.67,535,250,785
1604,TSLA  ,2023-02-22,2024-03-15,375.0,827,2,829
1605,TSLA  ,2023-02-22,2024-03-15,383.33,194,1338,1532
1606,TSLA  ,2023-02-22,2024-03-15,391.67,316,8,324
1607,TSLA  ,2023-02-22,2024-03-15,400.0,1291,221,1512
1608,TSLA  ,2023-02-22,2024-03-15,408.33,636,53,689
1609,TSLA  ,2023-02-22,2024-03-15,416.67,367,366,733
1610,TSLA  ,2023-02-22,2024-03-15,425.0,891,48,939
1611,TSLA  ,2023-02-22,2024-03-15,433.33,566,0,566
1612,TSLA  ,2023-02-22,2024-03-15,441.67,171,0,171
1613,TSLA  ,2023-02-22,2024-03-15,450.0,1476,0,1476
1614,TSLA  ,2023-02-22,2024-03-15,458.33,245,2,247
1615,TSLA  ,2023-02-22,2024-03-15,466.67,823,0,823
1616,TSLA  ,2023-02-22,2024-03-15,475.0,432,0,432
1617,TSLA  ,2023-02-22,2024-03-15,483.33,488,0,488
1618,TSLA  ,2023-02-22,2024-03-15,491.67,321,0,321
1619,TSLA  ,2023-02-22,2024-03-15,500.0,2966,0,2966
1620,TSLA  ,2023-02-22,2024-03-15,508.33,227,0,227
1621,TSLA  ,2023-02-22,2024-03-15,516.67,690,0,690
1622,TSLA  ,2023-02-22,2024-03-15,525.0,118,0,118
1623,TSLA  ,2023-02-22,2024-03-15,533.33,221,0,221
1624,TSLA  ,2023-02-22,2024-03-15,541.67,165,0,165
1625,TSLA  ,2023-02-22,2024-03-15,550.0,540,0,540
1626,TSLA  ,2023-02-22,2024-03-15,558.33,264,0,264
1627,TSLA  ,2023-02-22,2024-03-15,566.67,386,0,386
1628,TSLA  ,2023-02-22,2024-03-15,575.0,671,0,671
1629,TSLA  ,2023-02-22,2024-03-15,583.33,491,0,491
1630,TSLA  ,2023-02-22,2024-03-15,600.0,3922,1,3923
1631,TSLA  ,2023-02-22,2024-06-21,1.67,629,16460,17089
1632,TSLA  ,2023-02-22,2024-06-21,3.33,149,3280,3429
1633,TSLA  ,2023-02-22,2024-06-21,5.0,20,1519,1539
1634,TSLA  ,2023-02-22,2024-06-21,6.67,219,1218,1437
1635,TSLA  ,2023-02-22,2024-06-21,8.33,121,368,489
1636,TSLA  ,2023-02-22,2024-06-21,10.0,275,1827,2102
1637,TSLA  ,2023-02-22,2024-06-21,11.67,540,336,876
1638,TSLA  ,2023-02-22,2024-06-21,13.33,36,217,253
1639,TSLA  ,2023-02-22,2024-06-21,16.67,1407,3649,5056
1640,TSLA  ,2023-02-22,2024-06-21,33.33,7801,5342,13143
1641,TSLA  ,2023-02-22,2024-06-21,50.0,1903,4845,6748
1642,TSLA  ,2023-02-22,2024-06-21,55.0,6,383,389
1643,TSLA  ,2023-02-22,2024-06-21,60.0,57,511,568
1644,TSLA  ,2023-02-22,2024-06-21,65.0,114,2124,2238
1645,TSLA  ,2023-02-22,2024-06-21,66.67,1877,4359,6236
1646,TSLA  ,2023-02-22,2024-06-21,70.0,48,270,318
1647,TSLA  ,2023-02-22,2024-06-21,75.0,74,196,270
1648,TSLA  ,2023-02-22,2024-06-21,80.0,113,1475,1588
1649,TSLA  ,2023-02-22,2024-06-21,83.33,30601,4178,34779
1650,TSLA  ,2023-02-22,2024-06-21,85.0,60,862,922
1651,TSLA  ,2023-02-22,2024-06-21,90.0,530,1185,1715
1652,TSLA  ,2023-02-22,2024-06-21,95.0,363,428,791
1653,TSLA  ,2023-02-22,2024-06-21,100.0,5365,9902,15267
1654,TSLA  ,2023-02-22,2024-06-21,105.0,798,912,1710
1655,TSLA  ,2023-02-22,2024-06-21,110.0,495,2231,2726
1656,TSLA  ,2023-02-22,2024-06-21,115.0,414,254,668
1657,TSLA  ,2023-02-22,2024-06-21,116.67,2471,1020,3491
1658,TSLA  ,2023-02-22,2024-06-21,120.0,573,1241,1814
1659,TSLA  ,2023-02-22,2024-06-21,123.33,643,3519,4162
1660,TSLA  ,2023-02-22,2024-06-21,125.0,166,2237,2403
1661,TSLA  ,2023-02-22,2024-06-21,126.67,668,1267,1935
1662,TSLA  ,2023-02-22,2024-06-21,130.0,840,1826,2666
1663,TSLA  ,2023-02-22,2024-06-21,133.33,1916,2857,4773
1664,TSLA  ,2023-02-22,2024-06-21,135.0,60,383,443
1665,TSLA  ,2023-02-22,2024-06-21,136.67,425,1837,2262
1666,TSLA  ,2023-02-22,2024-06-21,140.0,1502,2594,4096
1667,TSLA  ,2023-02-22,2024-06-21,143.33,1405,1654,3059
1668,TSLA  ,2023-02-22,2024-06-21,145.0,618,218,836
1669,TSLA  ,2023-02-22,2024-06-21,146.67,1653,563,2216
1670,TSLA  ,2023-02-22,2024-06-21,150.0,4380,9851,14231
1671,TSLA  ,2023-02-22,2024-06-21,153.33,296,853,1149
1672,TSLA  ,2023-02-22,2024-06-21,155.0,84,446,530
1673,TSLA  ,2023-02-22,2024-06-21,156.67,384,272,656
1674,TSLA  ,2023-02-22,2024-06-21,160.0,881,2743,3624
1675,TSLA  ,2023-02-22,2024-06-21,163.33,186,1441,1627
1676,TSLA  ,2023-02-22,2024-06-21,165.0,347,897,1244
1677,TSLA  ,2023-02-22,2024-06-21,166.67,1725,5526,7251
1678,TSLA  ,2023-02-22,2024-06-21,170.0,311,879,1190
1679,TSLA  ,2023-02-22,2024-06-21,173.33,594,5866,6460
1680,TSLA  ,2023-02-22,2024-06-21,175.0,939,397,1336
1681,TSLA  ,2023-02-22,2024-06-21,180.0,1364,6672,8036
1682,TSLA  ,2023-02-22,2024-06-21,183.33,931,3710,4641
1683,TSLA  ,2023-02-22,2024-06-21,185.0,296,239,535
1684,TSLA  ,2023-02-22,2024-06-21,186.67,1322,1656,2978
1685,TSLA  ,2023-02-22,2024-06-21,190.0,332,120,452
1686,TSLA  ,2023-02-22,2024-06-21,193.33,1020,4295,5315
1687,TSLA  ,2023-02-22,2024-06-21,195.0,233,914,1147
1688,TSLA  ,2023-02-22,2024-06-21,200.0,4783,9900,14683
1689,TSLA  ,2023-02-22,2024-06-21,206.67,1076,2902,3978
1690,TSLA  ,2023-02-22,2024-06-21,210.0,420,139,559
1691,TSLA  ,2023-02-22,2024-06-21,213.33,827,1202,2029
1692,TSLA  ,2023-02-22,2024-06-21,216.67,1658,5370,7028
1693,TSLA  ,2023-02-22,2024-06-21,220.0,2535,2408,4943
1694,TSLA  ,2023-02-22,2024-06-21,226.67,2601,3504,6105
1695,TSLA  ,2023-02-22,2024-06-21,230.0,538,148,686
1696,TSLA  ,2023-02-22,2024-06-21,233.33,6654,7245,13899
1697,TSLA  ,2023-02-22,2024-06-21,240.0,2140,4867,7007
1698,TSLA  ,2023-02-22,2024-06-21,246.67,2259,1234,3493
1699,TSLA  ,2023-02-22,2024-06-21,250.0,5544,3591,9135
1700,TSLA  ,2023-02-22,2024-06-21,253.33,1312,852,2164
1701,TSLA  ,2023-02-22,2024-06-21,260.0,2077,950,3027
1702,TSLA  ,2023-02-22,2024-06-21,266.67,10108,3339,13447
1703,TSLA  ,2023-02-22,2024-06-21,270.0,1455,1885,3340
1704,TSLA  ,2023-02-22,2024-06-21,273.33,1257,792,2049
1705,TSLA  ,2023-02-22,2024-06-21,276.67,1023,809,1832
1706,TSLA  ,2023-02-22,2024-06-21,280.0,1242,1601,2843
1707,TSLA  ,2023-02-22,2024-06-21,283.33,3609,1362,4971
1708,TSLA  ,2023-02-22,2024-06-21,286.67,1004,766,1770
1709,TSLA  ,2023-02-22,2024-06-21,290.0,2338,1161,3499
1710,TSLA  ,2023-02-22,2024-06-21,293.33,1112,970,2082
1711,TSLA  ,2023-02-22,2024-06-21,296.67,1020,361,1381
1712,TSLA  ,2023-02-22,2024-06-21,300.0,9303,840,10143
1713,TSLA  ,2023-02-22,2024-06-21,303.33,1422,687,2109
1714,TSLA  ,2023-02-22,2024-06-21,306.67,1514,269,1783
1715,TSLA  ,2023-02-22,2024-06-21,310.0,1824,519,2343
1716,TSLA  ,2023-02-22,2024-06-21,313.33,1249,722,1971
1717,TSLA  ,2023-02-22,2024-06-21,316.67,2377,59,2436
1718,TSLA  ,2023-02-22,2024-06-21,320.0,696,664,1360
1719,TSLA  ,2023-02-22,2024-06-21,323.33,457,309,766
1720,TSLA  ,2023-02-22,2024-06-21,326.67,573,315,888
1721,TSLA  ,2023-02-22,2024-06-21,330.0,2725,127,2852
1722,TSLA  ,2023-02-22,2024-06-21,333.33,7542,1108,8650
1723,TSLA  ,2023-02-22,2024-06-21,336.67,2328,248,2576
1724,TSLA  ,2023-02-22,2024-06-21,340.0,781,121,902
1725,TSLA  ,2023-02-22,2024-06-21,343.33,1222,146,1368
1726,TSLA  ,2023-02-22,2024-06-21,346.67,399,73,472
1727,TSLA  ,2023-02-22,2024-06-21,350.0,3458,12,3470
1728,TSLA  ,2023-02-22,2024-06-21,353.33,199,70,269
1729,TSLA  ,2023-02-22,2024-06-21,356.67,479,53,532
1730,TSLA  ,2023-02-22,2024-06-21,360.0,2634,33,2667
1731,TSLA  ,2023-02-22,2024-06-21,363.33,357,0,357
1732,TSLA  ,2023-02-22,2024-06-21,366.67,4711,11,4722
1733,TSLA  ,2023-02-22,2024-06-21,370.0,3066,9,3075
1734,TSLA  ,2023-02-22,2024-06-21,373.33,559,52,611
1735,TSLA  ,2023-02-22,2024-06-21,376.67,798,0,798
1736,TSLA  ,2023-02-22,2024-06-21,380.0,1033,15,1048
1737,TSLA  ,2023-02-22,2024-06-21,383.33,1014,12,1026
1738,TSLA  ,2023-02-22,2024-06-21,386.67,302,7,309
1739,TSLA  ,2023-02-22,2024-06-21,390.0,435,3,438
1740,TSLA  ,2023-02-22,2024-06-21,393.33,890,2,892
1741,TSLA  ,2023-02-22,2024-06-21,396.67,793,2,795
1742,TSLA  ,2023-02-22,2024-06-21,400.0,38693,35,38728
1743,TSLA  ,2023-02-22,2024-06-21,416.67,3082,1,3083
1744,TSLA  ,2023-02-22,2024-06-21,433.33,3267,0,3267
1745,TSLA  ,2023-02-22,2024-06-21,450.0,3059,0,3059
1746,TSLA  ,2023-02-22,2024-06-21,466.67,5444,0,5444
1747,TSLA  ,2023-02-22,2024-06-21,483.33,1179,0,1179
1748,TSLA  ,2023-02-22,2024-06-21,500.0,11155,0,11155
1749,TSLA  ,2023-02-22,2024-06-21,516.67,2092,0,2092
1750,TSLA  ,2023-02-22,2024-06-21,533.33,3103,0,3103
1751,TSLA  ,2023-02-22,2024-06-21,550.0,2631,0,2631
1752,TSLA  ,2023-02-22,2024-06-21,566.67,1007,0,1007
1753,TSLA  ,2023-02-22,2024-06-21,583.33,1038,0,1038
1754,TSLA  ,2023-02-22,2024-06-21,600.0,17204,0,17204
1755,TSLA  ,2023-02-22,2024-06-21,616.67,14009,0,14009
1756,TSLA  ,2023-02-22,2024-06-21,633.33,4532,0,4532
1757,TSLA  ,2023-02-22,2024-06-21,650.0,617,0,617
1758,TSLA  ,2023-02-22,2024-06-21,666.67,6402,0,6402
1759,TSLA  ,2023-02-22,2024-06-21,683.33,1687,0,1687
1760,TSLA  ,2023-02-22,2024-06-21,700.0,3974,0,3974
1761,TSLA  ,2023-02-22,2024-06-21,716.67,903,0,903
1762,TSLA  ,2023-02-22,2024-06-21,733.33,2191,0,2191
1763,TSLA  ,2023-02-22,2024-06-21,750.0,5796,1,5797
1764,TSLA  ,2023-02-22,2024-06-21,758.33,14350,0,14350
1765,TSLA  ,2023-02-22,2024-09-20,50.0,45,927,972
1766,TSLA  ,2023-02-22,2024-09-20,55.0,29,176,205
1767,TSLA  ,2023-02-22,2024-09-20,60.0,10,146,156
1768,TSLA  ,2023-02-22,2024-09-20,65.0,38,79,117
1769,TSLA  ,2023-02-22,2024-09-20,70.0,11,126,137
1770,TSLA  ,2023-02-22,2024-09-20,75.0,10,2323,2333
1771,TSLA  ,2023-02-22,2024-09-20,80.0,66,142,208
1772,TSLA  ,2023-02-22,2024-09-20,85.0,987,454,1441
1773,TSLA  ,2023-02-22,2024-09-20,90.0,47,196,243
1774,TSLA  ,2023-02-22,2024-09-20,95.0,24,442,466
1775,TSLA  ,2023-02-22,2024-09-20,100.0,387,2231,2618
1776,TSLA  ,2023-02-22,2024-09-20,105.0,188,725,913
1777,TSLA  ,2023-02-22,2024-09-20,110.0,162,1098,1260
1778,TSLA  ,2023-02-22,2024-09-20,115.0,563,604,1167
1779,TSLA  ,2023-02-22,2024-09-20,120.0,717,550,1267
1780,TSLA  ,2023-02-22,2024-09-20,125.0,321,1201,1522
1781,TSLA  ,2023-02-22,2024-09-20,130.0,636,840,1476
1782,TSLA  ,2023-02-22,2024-09-20,135.0,580,282,862
1783,TSLA  ,2023-02-22,2024-09-20,140.0,1094,354,1448
1784,TSLA  ,2023-02-22,2024-09-20,145.0,1292,357,1649
1785,TSLA  ,2023-02-22,2024-09-20,150.0,1448,2752,4200
1786,TSLA  ,2023-02-22,2024-09-20,155.0,529,309,838
1787,TSLA  ,2023-02-22,2024-09-20,160.0,432,818,1250
1788,TSLA  ,2023-02-22,2024-09-20,165.0,279,111,390
1789,TSLA  ,2023-02-22,2024-09-20,170.0,205,305,510
1790,TSLA  ,2023-02-22,2024-09-20,175.0,236,126,362
1791,TSLA  ,2023-02-22,2024-09-20,180.0,733,107,840
1792,TSLA  ,2023-02-22,2024-09-20,185.0,835,934,1769
1793,TSLA  ,2023-02-22,2024-09-20,190.0,1506,128,1634
1794,TSLA  ,2023-02-22,2024-09-20,195.0,1416,119,1535
1795,TSLA  ,2023-02-22,2024-09-20,200.0,1776,1447,3223
1796,TSLA  ,2023-02-22,2024-09-20,210.0,767,269,1036
1797,TSLA  ,2023-02-22,2024-09-20,220.0,1400,421,1821
1798,TSLA  ,2023-02-22,2024-09-20,230.0,729,121,850
1799,TSLA  ,2023-02-22,2024-09-20,240.0,483,306,789
1800,TSLA  ,2023-02-22,2024-09-20,250.0,888,366,1254
1801,TSLA  ,2023-02-22,2024-09-20,260.0,905,70,975
1802,TSLA  ,2023-02-22,2024-09-20,270.0,627,534,1161
1803,TSLA  ,2023-02-22,2024-09-20,280.0,328,579,907
1804,TSLA  ,2023-02-22,2024-09-20,290.0,469,2811,3280
1805,TSLA  ,2023-02-22,2024-09-20,300.0,1083,1250,2333
1806,TSLA  ,2023-02-22,2024-09-20,310.0,180,788,968
1807,TSLA  ,2023-02-22,2024-09-20,320.0,112,261,373
1808,TSLA  ,2023-02-22,2024-09-20,330.0,113,118,231
1809,TSLA  ,2023-02-22,2024-09-20,340.0,705,141,846
1810,TSLA  ,2023-02-22,2024-09-20,350.0,1447,161,1608
1811,TSLA  ,2023-02-22,2024-09-20,360.0,56,85,141
1812,TSLA  ,2023-02-22,2024-09-20,370.0,80,24,104
1813,TSLA  ,2023-02-22,2024-09-20,380.0,94,4,98
1814,TSLA  ,2023-02-22,2024-09-20,390.0,269,17,286
1815,TSLA  ,2023-02-22,2024-09-20,400.0,5,20,25
1816,TSLA  ,2023-02-22,2024-09-20,410.0,48,40,88
1817,TSLA  ,2023-02-22,2025-01-17,5.0,659,11643,12302
1818,TSLA  ,2023-02-22,2025-01-17,10.0,139,917,1056
1819,TSLA  ,2023-02-22,2025-01-17,15.0,29,867,896
1820,TSLA  ,2023-02-22,2025-01-17,20.0,385,5810,6195
1821,TSLA  ,2023-02-22,2025-01-17,25.0,103,2576,2679
1822,TSLA  ,2023-02-22,2025-01-17,30.0,13821,16564,30385
1823,TSLA  ,2023-02-22,2025-01-17,35.0,265,1156,1421
1824,TSLA  ,2023-02-22,2025-01-17,40.0,14708,15785,30493
1825,TSLA  ,2023-02-22,2025-01-17,45.0,2979,3202,6181
1826,TSLA  ,2023-02-22,2025-01-17,50.0,2719,8556,11275
1827,TSLA  ,2023-02-22,2025-01-17,55.0,2003,4257,6260
1828,TSLA  ,2023-02-22,2025-01-17,60.0,592,1963,2555
1829,TSLA  ,2023-02-22,2025-01-17,65.0,1639,1573,3212
1830,TSLA  ,2023-02-22,2025-01-17,70.0,2496,2233,4729
1831,TSLA  ,2023-02-22,2025-01-17,75.0,177,4295,4472
1832,TSLA  ,2023-02-22,2025-01-17,80.0,1303,1873,3176
1833,TSLA  ,2023-02-22,2025-01-17,85.0,1827,1608,3435
1834,TSLA  ,2023-02-22,2025-01-17,90.0,1065,5521,6586
1835,TSLA  ,2023-02-22,2025-01-17,95.0,141,504,645
1836,TSLA  ,2023-02-22,2025-01-17,100.0,5370,17922,23292
1837,TSLA  ,2023-02-22,2025-01-17,105.0,323,1669,1992
1838,TSLA  ,2023-02-22,2025-01-17,110.0,5448,7106,12554
1839,TSLA  ,2023-02-22,2025-01-17,115.0,3213,3250,6463
1840,TSLA  ,2023-02-22,2025-01-17,120.0,8406,6114,14520
1841,TSLA  ,2023-02-22,2025-01-17,125.0,2152,1166,3318
1842,TSLA  ,2023-02-22,2025-01-17,130.0,5623,7215,12838
1843,TSLA  ,2023-02-22,2025-01-17,135.0,5700,722,6422
1844,TSLA  ,2023-02-22,2025-01-17,140.0,8628,4664,13292
1845,TSLA  ,2023-02-22,2025-01-17,145.0,766,686,1452
1846,TSLA  ,2023-02-22,2025-01-17,150.0,11369,12415,23784
1847,TSLA  ,2023-02-22,2025-01-17,155.0,418,501,919
1848,TSLA  ,2023-02-22,2025-01-17,160.0,4576,5532,10108
1849,TSLA  ,2023-02-22,2025-01-17,165.0,262,949,1211
1850,TSLA  ,2023-02-22,2025-01-17,170.0,35369,10317,45686
1851,TSLA  ,2023-02-22,2025-01-17,175.0,33428,4520,37948
1852,TSLA  ,2023-02-22,2025-01-17,180.0,3667,8111,11778
1853,TSLA  ,2023-02-22,2025-01-17,185.0,7133,4534,11667
1854,TSLA  ,2023-02-22,2025-01-17,190.0,5657,4771,10428
1855,TSLA  ,2023-02-22,2025-01-17,195.0,3233,1739,4972
1856,TSLA  ,2023-02-22,2025-01-17,200.0,29385,13561,42946
1857,TSLA  ,2023-02-22,2025-01-17,210.0,5319,2747,8066
1858,TSLA  ,2023-02-22,2025-01-17,220.0,2991,4087,7078
1859,TSLA  ,2023-02-22,2025-01-17,230.0,4196,3305,7501
1860,TSLA  ,2023-02-22,2025-01-17,240.0,4746,4814,9560
1861,TSLA  ,2023-02-22,2025-01-17,250.0,11822,5225,17047
1862,TSLA  ,2023-02-22,2025-01-17,260.0,5617,1944,7561
1863,TSLA  ,2023-02-22,2025-01-17,270.0,3109,1337,4446
1864,TSLA  ,2023-02-22,2025-01-17,280.0,2230,3357,5587
1865,TSLA  ,2023-02-22,2025-01-17,290.0,3457,2807,6264
1866,TSLA  ,2023-02-22,2025-01-17,300.0,30480,3058,33538
1867,TSLA  ,2023-02-22,2025-01-17,310.0,4378,711,5089
1868,TSLA  ,2023-02-22,2025-01-17,320.0,2119,793,2912
1869,TSLA  ,2023-02-22,2025-01-17,330.0,2299,1018,3317
1870,TSLA  ,2023-02-22,2025-01-17,340.0,1405,464,1869
1871,TSLA  ,2023-02-22,2025-01-17,350.0,7162,875,8037
1872,TSLA  ,2023-02-22,2025-01-17,360.0,1941,294,2235
1873,TSLA  ,2023-02-22,2025-01-17,370.0,1829,325,2154
1874,TSLA  ,2023-02-22,2025-01-17,380.0,1376,212,1588
1875,TSLA  ,2023-02-22,2025-01-17,390.0,1721,96,1817
1876,TSLA  ,2023-02-22,2025-01-17,400.0,19710,406,20116
1877,TSLA  ,2023-02-22,2025-01-17,410.0,4447,70,4517
1878,TSLA  ,2023-02-22,2025-01-17,420.0,4177,34,4211
1879,TSLA  ,2023-02-22,2025-01-17,430.0,606,3,609
1880,TSLA  ,2023-02-22,2025-01-17,440.0,1603,10,1613
1881,TSLA  ,2023-02-22,2025-01-17,450.0,5177,8,5185
1882,TSLA  ,2023-02-22,2025-01-17,460.0,1010,14,1024
1883,TSLA  ,2023-02-22,2025-01-17,470.0,1553,67,1620
1884,TSLA  ,2023-02-22,2025-01-17,480.0,1256,1,1257
1885,TSLA  ,2023-02-22,2025-01-17,490.0,798,0,798
1886,TSLA  ,2023-02-22,2025-01-17,500.0,11586,20,11606
1887,TSLA  ,2023-02-22,2025-01-17,510.0,1627,256,1883
1888,TSLA  ,2023-02-22,2025-01-17,520.0,8349,1,8350
1889,TSLA  ,2023-02-22,2025-01-17,530.0,643,0,643
1890,TSLA  ,2023-02-22,2025-01-17,540.0,603,0,603
1891,TSLA  ,2023-02-22,2025-01-17,550.0,3092,1,3093
1892,TSLA  ,2023-02-22,2025-01-17,560.0,632,1,633
1893,TSLA  ,2023-02-22,2025-01-17,570.0,660,0,660
1894,TSLA  ,2023-02-22,2025-01-17,580.0,883,0,883
1895,TSLA  ,2023-02-22,2025-01-17,590.0,758,1,759
1896,TSLA  ,2023-02-22,2025-01-17,600.0,15720,0,15720
1897,TSLA  ,2023-02-22,2025-01-17,610.0,18023,0,18023
1898,TSLA  ,2023-02-22,2025-06-20,5.0,232,1678,1910
1899,TSLA  ,2023-02-22,2025-06-20,10.0,5,66,71
1900,TSLA  ,2023-02-22,2025-06-20,15.0,8,5857,5865
1901,TSLA  ,2023-02-22,2025-06-20,20.0,59,433,492
1902,TSLA  ,2023-02-22,2025-06-20,25.0,9,168,177
1903,TSLA  ,2023-02-22,2025-06-20,30.0,86,385,471
1904,TSLA  ,2023-02-22,2025-06-20,35.0,11,193,204
1905,TSLA  ,2023-02-22,2025-06-20,40.0,10,336,346
1906,TSLA  ,2023-02-22,2025-06-20,45.0,17,53,70
1907,TSLA  ,2023-02-22,2025-06-20,50.0,158,752,910
1908,TSLA  ,2023-02-22,2025-06-20,55.0,13,54,67
1909,TSLA  ,2023-02-22,2025-06-20,60.0,15,394,409
1910,TSLA  ,2023-02-22,2025-06-20,65.0,19,573,592
1911,TSLA  ,2023-02-22,2025-06-20,70.0,179,130,309
1912,TSLA  ,2023-02-22,2025-06-20,75.0,134,1299,1433
1913,TSLA  ,2023-02-22,2025-06-20,80.0,808,736,1544
1914,TSLA  ,2023-02-22,2025-06-20,85.0,351,234,585
1915,TSLA  ,2023-02-22,2025-06-20,90.0,10312,545,10857
1916,TSLA  ,2023-02-22,2025-06-20,95.0,46516,559,47075
1917,TSLA  ,2023-02-22,2025-06-20,100.0,1020,4756,5776
1918,TSLA  ,2023-02-22,2025-06-20,105.0,165,495,660
1919,TSLA  ,2023-02-22,2025-06-20,110.0,349,1606,1955
1920,TSLA  ,2023-02-22,2025-06-20,115.0,434,369,803
1921,TSLA  ,2023-02-22,2025-06-20,120.0,526,1050,1576
1922,TSLA  ,2023-02-22,2025-06-20,125.0,485,379,864
1923,TSLA  ,2023-02-22,2025-06-20,130.0,2601,1588,4189
1924,TSLA  ,2023-02-22,2025-06-20,135.0,4673,273,4946
1925,TSLA  ,2023-02-22,2025-06-20,140.0,972,1859,2831
1926,TSLA  ,2023-02-22,2025-06-20,145.0,406,490,896
1927,TSLA  ,2023-02-22,2025-06-20,150.0,1408,1435,2843
1928,TSLA  ,2023-02-22,2025-06-20,155.0,404,206,610
1929,TSLA  ,2023-02-22,2025-06-20,160.0,2174,850,3024
1930,TSLA  ,2023-02-22,2025-06-20,165.0,922,360,1282
1931,TSLA  ,2023-02-22,2025-06-20,170.0,2807,691,3498
1932,TSLA  ,2023-02-22,2025-06-20,175.0,790,1235,2025
1933,TSLA  ,2023-02-22,2025-06-20,180.0,670,461,1131
1934,TSLA  ,2023-02-22,2025-06-20,185.0,2554,201,2755
1935,TSLA  ,2023-02-22,2025-06-20,190.0,531,254,785
1936,TSLA  ,2023-02-22,2025-06-20,195.0,311,300,611
1937,TSLA  ,2023-02-22,2025-06-20,200.0,4572,3416,7988
1938,TSLA  ,2023-02-22,2025-06-20,205.0,315,233,548
1939,TSLA  ,2023-02-22,2025-06-20,210.0,504,212,716
1940,TSLA  ,2023-02-22,2025-06-20,215.0,266,93,359
1941,TSLA  ,2023-02-22,2025-06-20,220.0,740,130,870
1942,TSLA  ,2023-02-22,2025-06-20,225.0,649,190,839
1943,TSLA  ,2023-02-22,2025-06-20,230.0,485,94,579
1944,TSLA  ,2023-02-22,2025-06-20,235.0,391,265,656
1945,TSLA  ,2023-02-22,2025-06-20,240.0,4244,1406,5650
1946,TSLA  ,2023-02-22,2025-06-20,250.0,2462,546,3008
1947,TSLA  ,2023-02-22,2025-06-20,260.0,1053,1350,2403
1948,TSLA  ,2023-02-22,2025-06-20,270.0,653,104,757
1949,TSLA  ,2023-02-22,2025-06-20,280.0,252,249,501
1950,TSLA  ,2023-02-22,2025-06-20,290.0,269,399,668
1951,TSLA  ,2023-02-22,2025-06-20,300.0,2988,676,3664
1952,TSLA  ,2023-02-22,2025-06-20,310.0,326,210,536
1953,TSLA  ,2023-02-22,2025-06-20,320.0,944,193,1137
1954,TSLA  ,2023-02-22,2025-06-20,330.0,302,290,592
1955,TSLA  ,2023-02-22,2025-06-20,340.0,473,460,933
1956,TSLA  ,2023-02-22,2025-06-20,350.0,2677,326,3003
1957,TSLA  ,2023-02-22,2025-06-20,360.0,684,389,1073
1958,TSLA  ,2023-02-22,2025-06-20,370.0,170,433,603
1959,TSLA  ,2023-02-22,2025-06-20,380.0,118,82,200
1960,TSLA  ,2023-02-22,2025-06-20,390.0,2561,127,2688
1961,TSLA  ,2023-02-22,2025-06-20,400.0,26,53,79
1962,TSLA  ,2023-02-22,2025-06-20,410.0,146,104,250
