index,ProductSymbol,DateGen,ExpDate,Strike,Call,Put,TotalOI
0,TSLA  ,2023-02-17,2023-02-17,15.0,511,316,827
1,TSLA  ,2023-02-17,2023-02-17,20.0,91,46,137
2,TSLA  ,2023-02-17,2023-02-17,25.0,8,99,107
3,TSLA  ,2023-02-17,2023-02-17,30.0,6,2723,2729
4,TSLA  ,2023-02-17,2023-02-17,35.0,0,5414,5414
5,TSLA  ,2023-02-17,2023-02-17,40.0,86,10382,10468
6,TSLA  ,2023-02-17,2023-02-17,45.0,1,1739,1740
7,TSLA  ,2023-02-17,2023-02-17,50.0,844,17127,17971
8,TSLA  ,2023-02-17,2023-02-17,55.0,10,5311,5321
9,TSLA  ,2023-02-17,2023-02-17,60.0,314,9054,9368
10,TSLA  ,2023-02-17,2023-02-17,65.0,28,6534,6562
11,TSLA  ,2023-02-17,2023-02-17,70.0,18,54688,54706
12,TSLA  ,2023-02-17,2023-02-17,75.0,65,7658,7723
13,TSLA  ,2023-02-17,2023-02-17,80.0,69,52811,52880
14,TSLA  ,2023-02-17,2023-02-17,85.0,22,14034,14056
15,TSLA  ,2023-02-17,2023-02-17,90.0,148,17190,17338
16,TSLA  ,2023-02-17,2023-02-17,95.0,278,20270,20548
17,TSLA  ,2023-02-17,2023-02-17,100.0,3213,39616,42829
18,TSLA  ,2023-02-17,2023-02-17,105.0,20396,29903,50299
19,TSLA  ,2023-02-17,2023-02-17,110.0,2660,26836,29496
20,TSLA  ,2023-02-17,2023-02-17,115.0,13095,29259,42354
21,TSLA  ,2023-02-17,2023-02-17,118.0,281,2550,2831
22,TSLA  ,2023-02-17,2023-02-17,119.0,6,5305,5311
23,TSLA  ,2023-02-17,2023-02-17,120.0,22597,64682,87279
24,TSLA  ,2023-02-17,2023-02-17,121.0,63,2003,2066
25,TSLA  ,2023-02-17,2023-02-17,122.0,197,1734,1931
26,TSLA  ,2023-02-17,2023-02-17,123.0,64,2973,3037
27,TSLA  ,2023-02-17,2023-02-17,124.0,33,3636,3669
28,TSLA  ,2023-02-17,2023-02-17,125.0,11362,17960,29322
29,TSLA  ,2023-02-17,2023-02-17,126.0,40,1288,1328
30,TSLA  ,2023-02-17,2023-02-17,127.0,54,1631,1685
31,TSLA  ,2023-02-17,2023-02-17,128.0,29,9249,9278
32,TSLA  ,2023-02-17,2023-02-17,129.0,99,2358,2457
33,TSLA  ,2023-02-17,2023-02-17,130.0,12749,15989,28738
34,TSLA  ,2023-02-17,2023-02-17,131.0,142,1990,2132
35,TSLA  ,2023-02-17,2023-02-17,132.0,171,2532,2703
36,TSLA  ,2023-02-17,2023-02-17,133.0,55,2497,2552
37,TSLA  ,2023-02-17,2023-02-17,134.0,391,3752,4143
38,TSLA  ,2023-02-17,2023-02-17,135.0,7524,12873,20397
39,TSLA  ,2023-02-17,2023-02-17,136.0,1387,3999,5386
40,TSLA  ,2023-02-17,2023-02-17,137.0,863,2148,3011
41,TSLA  ,2023-02-17,2023-02-17,138.0,1231,7571,8802
42,TSLA  ,2023-02-17,2023-02-17,139.0,905,1715,2620
43,TSLA  ,2023-02-17,2023-02-17,140.0,7197,17014,24211
44,TSLA  ,2023-02-17,2023-02-17,141.0,667,3657,4324
45,TSLA  ,2023-02-17,2023-02-17,142.0,1006,2704,3710
46,TSLA  ,2023-02-17,2023-02-17,143.0,277,2062,2339
47,TSLA  ,2023-02-17,2023-02-17,144.0,262,2853,3115
48,TSLA  ,2023-02-17,2023-02-17,145.0,11218,23999,35217
49,TSLA  ,2023-02-17,2023-02-17,146.0,1800,3059,4859
50,TSLA  ,2023-02-17,2023-02-17,147.0,524,5854,6378
51,TSLA  ,2023-02-17,2023-02-17,148.0,226,3559,3785
52,TSLA  ,2023-02-17,2023-02-17,149.0,432,4655,5087
53,TSLA  ,2023-02-17,2023-02-17,150.0,14403,37372,51775
54,TSLA  ,2023-02-17,2023-02-17,152.5,971,4570,5541
55,TSLA  ,2023-02-17,2023-02-17,155.0,8583,15272,23855
56,TSLA  ,2023-02-17,2023-02-17,157.5,1368,6252,7620
57,TSLA  ,2023-02-17,2023-02-17,160.0,31847,41671,73518
58,TSLA  ,2023-02-17,2023-02-17,162.5,1171,7443,8614
59,TSLA  ,2023-02-17,2023-02-17,165.0,12233,18215,30448
60,TSLA  ,2023-02-17,2023-02-17,167.5,1016,7025,8041
61,TSLA  ,2023-02-17,2023-02-17,170.0,19075,36697,55772
62,TSLA  ,2023-02-17,2023-02-17,172.5,2184,10980,13164
63,TSLA  ,2023-02-17,2023-02-17,175.0,8329,16116,24445
64,TSLA  ,2023-02-17,2023-02-17,177.5,2523,10714,13237
65,TSLA  ,2023-02-17,2023-02-17,180.0,15222,31893,47115
66,TSLA  ,2023-02-17,2023-02-17,182.5,4674,5296,9970
67,TSLA  ,2023-02-17,2023-02-17,185.0,16315,24157,40472
68,TSLA  ,2023-02-17,2023-02-17,187.5,2676,10383,13059
69,TSLA  ,2023-02-17,2023-02-17,190.0,22413,45533,67946
70,TSLA  ,2023-02-17,2023-02-17,192.5,4685,12784,17469
71,TSLA  ,2023-02-17,2023-02-17,195.0,11288,21534,32822
72,TSLA  ,2023-02-17,2023-02-17,197.5,4849,11259,16108
73,TSLA  ,2023-02-17,2023-02-17,200.0,45123,39245,84368
74,TSLA  ,2023-02-17,2023-02-17,202.5,10214,11108,21322
75,TSLA  ,2023-02-17,2023-02-17,205.0,15334,15964,31298
76,TSLA  ,2023-02-17,2023-02-17,207.5,9525,7135,16660
77,TSLA  ,2023-02-17,2023-02-17,210.0,37302,23390,60692
78,TSLA  ,2023-02-17,2023-02-17,212.5,16468,6300,22768
79,TSLA  ,2023-02-17,2023-02-17,215.0,33997,10150,44147
80,TSLA  ,2023-02-17,2023-02-17,217.5,17744,2107,19851
81,TSLA  ,2023-02-17,2023-02-17,220.0,52866,5094,57960
82,TSLA  ,2023-02-17,2023-02-17,222.5,11707,1619,13326
83,TSLA  ,2023-02-17,2023-02-17,225.0,22589,2474,25063
84,TSLA  ,2023-02-17,2023-02-17,227.5,7903,258,8161
85,TSLA  ,2023-02-17,2023-02-17,230.0,29136,2445,31581
86,TSLA  ,2023-02-17,2023-02-17,232.5,8036,160,8196
87,TSLA  ,2023-02-17,2023-02-17,235.0,16255,635,16890
88,TSLA  ,2023-02-17,2023-02-17,237.5,4609,75,4684
89,TSLA  ,2023-02-17,2023-02-17,240.0,15912,230,16142
90,TSLA  ,2023-02-17,2023-02-17,242.5,6376,1,6377
91,TSLA  ,2023-02-17,2023-02-17,245.0,10756,8,10764
92,TSLA  ,2023-02-17,2023-02-17,247.5,3328,228,3556
93,TSLA  ,2023-02-17,2023-02-17,250.0,42326,195,42521
94,TSLA  ,2023-02-17,2023-02-17,252.5,2935,2,2937
95,TSLA  ,2023-02-17,2023-02-17,255.0,13959,33,13992
96,TSLA  ,2023-02-17,2023-02-17,257.5,3257,0,3257
97,TSLA  ,2023-02-17,2023-02-17,260.0,10608,88,10696
98,TSLA  ,2023-02-17,2023-02-17,262.5,3944,1,3945
99,TSLA  ,2023-02-17,2023-02-17,265.0,8770,50,8820
100,TSLA  ,2023-02-17,2023-02-17,267.5,2585,1,2586
101,TSLA  ,2023-02-17,2023-02-17,270.0,13192,56,13248
102,TSLA  ,2023-02-17,2023-02-17,272.5,3854,0,3854
103,TSLA  ,2023-02-17,2023-02-17,275.0,9954,0,9954
104,TSLA  ,2023-02-17,2023-02-17,277.5,1672,0,1672
105,TSLA  ,2023-02-17,2023-02-17,280.0,8209,20,8229
106,TSLA  ,2023-02-17,2023-02-17,285.0,11849,0,11849
107,TSLA  ,2023-02-17,2023-02-17,290.0,7533,0,7533
108,TSLA  ,2023-02-17,2023-02-17,295.0,4550,0,4550
109,TSLA  ,2023-02-17,2023-02-17,300.0,16435,2,16437
110,TSLA  ,2023-02-17,2023-02-17,305.0,4641,0,4641
111,TSLA  ,2023-02-17,2023-02-17,310.0,3519,0,3519
112,TSLA  ,2023-02-17,2023-02-17,315.0,3657,0,3657
113,TSLA  ,2023-02-17,2023-02-17,320.0,11790,0,11790
114,TSLA  ,2023-02-17,2023-02-17,325.0,2029,0,2029
115,TSLA  ,2023-02-17,2023-02-17,330.0,1852,0,1852
116,TSLA  ,2023-02-17,2023-02-17,335.0,4078,0,4078
117,TSLA  ,2023-02-17,2023-02-17,340.0,3191,0,3191
118,TSLA  ,2023-02-17,2023-02-17,345.0,2801,7,2808
119,TSLA  ,2023-02-17,2023-02-17,350.0,4073,0,4073
120,TSLA  ,2023-02-17,2023-02-17,355.0,1313,0,1313
121,TSLA  ,2023-02-17,2023-02-17,360.0,2052,5,2057
122,TSLA  ,2023-02-17,2023-02-17,365.0,2038,0,2038
123,TSLA  ,2023-02-17,2023-02-17,370.0,1373,2,1375
124,TSLA  ,2023-02-17,2023-02-17,375.0,4634,0,4634
125,TSLA  ,2023-02-17,2023-02-17,380.0,2162,1,2163
126,TSLA  ,2023-02-17,2023-02-17,385.0,963,0,963
127,TSLA  ,2023-02-17,2023-02-17,390.0,1493,0,1493
128,TSLA  ,2023-02-17,2023-02-17,395.0,2035,0,2035
129,TSLA  ,2023-02-17,2023-02-17,400.0,4208,0,4208
130,TSLA  ,2023-02-17,2023-02-17,405.0,560,0,560
131,TSLA  ,2023-02-17,2023-02-17,410.0,801,0,801
132,TSLA  ,2023-02-17,2023-02-17,415.0,755,0,755
133,TSLA  ,2023-02-17,2023-02-17,420.0,794,0,794
134,TSLA  ,2023-02-17,2023-02-17,425.0,674,0,674
135,TSLA  ,2023-02-17,2023-02-17,430.0,728,0,728
136,TSLA  ,2023-02-17,2023-02-17,435.0,358,0,358
137,TSLA  ,2023-02-17,2023-02-17,440.0,822,0,822
138,TSLA  ,2023-02-17,2023-02-17,445.0,235,0,235
139,TSLA  ,2023-02-17,2023-02-17,450.0,753,0,753
140,TSLA  ,2023-02-17,2023-02-17,455.0,1720,0,1720
141,TSLA  ,2023-02-17,2023-02-17,460.0,350,0,350
142,TSLA  ,2023-02-17,2023-02-17,465.0,1039,0,1039
143,TSLA  ,2023-02-17,2023-02-17,470.0,1347,0,1347
144,TSLA  ,2023-02-17,2023-02-17,475.0,589,0,589
145,TSLA  ,2023-02-17,2023-02-17,480.0,347,0,347
146,TSLA  ,2023-02-17,2023-02-17,485.0,689,0,689
147,TSLA  ,2023-02-17,2023-02-17,490.0,242,0,242
148,TSLA  ,2023-02-17,2023-02-17,495.0,400,0,400
149,TSLA  ,2023-02-17,2023-02-17,500.0,3739,0,3739
150,TSLA  ,2023-02-17,2023-02-17,505.0,357,0,357
151,TSLA  ,2023-02-17,2023-02-17,510.0,356,0,356
152,TSLA  ,2023-02-17,2023-02-17,515.0,58,0,58
153,TSLA  ,2023-02-17,2023-02-17,520.0,327,0,327
154,TSLA  ,2023-02-17,2023-02-17,525.0,150,0,150
155,TSLA  ,2023-02-17,2023-02-17,530.0,391,0,391
156,TSLA  ,2023-02-17,2023-02-17,535.0,171,0,171
157,TSLA  ,2023-02-17,2023-02-17,540.0,219,0,219
158,TSLA  ,2023-02-17,2023-02-17,545.0,110,0,110
159,TSLA  ,2023-02-17,2023-02-17,550.0,799,0,799
160,TSLA  ,2023-02-17,2023-02-17,555.0,837,0,837
161,TSLA  ,2023-02-17,2023-02-17,560.0,573,0,573
162,TSLA  ,2023-02-17,2023-02-17,565.0,661,0,661
163,TSLA  ,2023-02-17,2023-02-17,570.0,317,0,317
164,TSLA  ,2023-02-17,2023-02-17,575.0,278,0,278
165,TSLA  ,2023-02-17,2023-02-17,580.0,1203,0,1203
166,TSLA  ,2023-02-17,2023-02-17,585.0,956,0,956
167,TSLA  ,2023-02-17,2023-02-17,590.0,297,0,297
168,TSLA  ,2023-02-17,2023-02-17,595.0,2011,0,2011
169,TSLA  ,2023-02-17,2023-02-17,600.0,2980,7,2987
170,TSLA  ,2023-02-17,2023-02-24,15.0,24,9,33
171,TSLA  ,2023-02-17,2023-02-24,20.0,3,1,4
172,TSLA  ,2023-02-17,2023-02-24,25.0,3,3,6
173,TSLA  ,2023-02-17,2023-02-24,30.0,3,748,751
174,TSLA  ,2023-02-17,2023-02-24,35.0,0,20,20
175,TSLA  ,2023-02-17,2023-02-24,40.0,0,439,439
176,TSLA  ,2023-02-17,2023-02-24,45.0,0,2046,2046
177,TSLA  ,2023-02-17,2023-02-24,50.0,103,1898,2001
178,TSLA  ,2023-02-17,2023-02-24,55.0,3,806,809
179,TSLA  ,2023-02-17,2023-02-24,60.0,14,1451,1465
180,TSLA  ,2023-02-17,2023-02-24,65.0,6,701,707
181,TSLA  ,2023-02-17,2023-02-24,70.0,6,599,605
182,TSLA  ,2023-02-17,2023-02-24,75.0,1,851,852
183,TSLA  ,2023-02-17,2023-02-24,80.0,6,1121,1127
184,TSLA  ,2023-02-17,2023-02-24,85.0,38,638,676
185,TSLA  ,2023-02-17,2023-02-24,90.0,41,1417,1458
186,TSLA  ,2023-02-17,2023-02-24,95.0,18,1866,1884
187,TSLA  ,2023-02-17,2023-02-24,98.0,14,650,664
188,TSLA  ,2023-02-17,2023-02-24,99.0,17,626,643
189,TSLA  ,2023-02-17,2023-02-24,100.0,75,2565,2640
190,TSLA  ,2023-02-17,2023-02-24,101.0,19,340,359
191,TSLA  ,2023-02-17,2023-02-24,102.0,12,241,253
192,TSLA  ,2023-02-17,2023-02-24,103.0,8,255,263
193,TSLA  ,2023-02-17,2023-02-24,104.0,15,329,344
194,TSLA  ,2023-02-17,2023-02-24,105.0,108,2188,2296
195,TSLA  ,2023-02-17,2023-02-24,106.0,14,578,592
196,TSLA  ,2023-02-17,2023-02-24,107.0,12,1434,1446
197,TSLA  ,2023-02-17,2023-02-24,108.0,9,486,495
198,TSLA  ,2023-02-17,2023-02-24,109.0,23,651,674
199,TSLA  ,2023-02-17,2023-02-24,110.0,345,1597,1942
200,TSLA  ,2023-02-17,2023-02-24,111.0,61,518,579
201,TSLA  ,2023-02-17,2023-02-24,112.0,51,541,592
202,TSLA  ,2023-02-17,2023-02-24,113.0,46,1303,1349
203,TSLA  ,2023-02-17,2023-02-24,114.0,355,1045,1400
204,TSLA  ,2023-02-17,2023-02-24,115.0,367,1600,1967
205,TSLA  ,2023-02-17,2023-02-24,116.0,331,1438,1769
206,TSLA  ,2023-02-17,2023-02-24,117.0,270,728,998
207,TSLA  ,2023-02-17,2023-02-24,118.0,208,594,802
208,TSLA  ,2023-02-17,2023-02-24,119.0,220,657,877
209,TSLA  ,2023-02-17,2023-02-24,120.0,468,2694,3162
210,TSLA  ,2023-02-17,2023-02-24,121.0,314,734,1048
211,TSLA  ,2023-02-17,2023-02-24,122.0,289,2503,2792
212,TSLA  ,2023-02-17,2023-02-24,123.0,435,607,1042
213,TSLA  ,2023-02-17,2023-02-24,124.0,162,510,672
214,TSLA  ,2023-02-17,2023-02-24,125.0,674,2857,3531
215,TSLA  ,2023-02-17,2023-02-24,126.0,204,639,843
216,TSLA  ,2023-02-17,2023-02-24,127.0,127,1161,1288
217,TSLA  ,2023-02-17,2023-02-24,128.0,160,775,935
218,TSLA  ,2023-02-17,2023-02-24,129.0,232,1319,1551
219,TSLA  ,2023-02-17,2023-02-24,130.0,2714,2803,5517
220,TSLA  ,2023-02-17,2023-02-24,131.0,430,986,1416
221,TSLA  ,2023-02-17,2023-02-24,132.0,256,1226,1482
222,TSLA  ,2023-02-17,2023-02-24,133.0,147,686,833
223,TSLA  ,2023-02-17,2023-02-24,134.0,268,804,1072
224,TSLA  ,2023-02-17,2023-02-24,135.0,1923,1994,3917
225,TSLA  ,2023-02-17,2023-02-24,136.0,106,541,647
226,TSLA  ,2023-02-17,2023-02-24,137.0,138,731,869
227,TSLA  ,2023-02-17,2023-02-24,138.0,474,597,1071
228,TSLA  ,2023-02-17,2023-02-24,139.0,581,495,1076
229,TSLA  ,2023-02-17,2023-02-24,140.0,1941,5471,7412
230,TSLA  ,2023-02-17,2023-02-24,141.0,343,1474,1817
231,TSLA  ,2023-02-17,2023-02-24,142.0,436,939,1375
232,TSLA  ,2023-02-17,2023-02-24,143.0,88,474,562
233,TSLA  ,2023-02-17,2023-02-24,144.0,102,3447,3549
234,TSLA  ,2023-02-17,2023-02-24,145.0,1790,4640,6430
235,TSLA  ,2023-02-17,2023-02-24,146.0,73,1125,1198
236,TSLA  ,2023-02-17,2023-02-24,147.0,51,593,644
237,TSLA  ,2023-02-17,2023-02-24,148.0,136,2339,2475
238,TSLA  ,2023-02-17,2023-02-24,149.0,146,1263,1409
239,TSLA  ,2023-02-17,2023-02-24,150.0,3342,8414,11756
240,TSLA  ,2023-02-17,2023-02-24,152.5,106,1687,1793
241,TSLA  ,2023-02-17,2023-02-24,155.0,3284,7514,10798
242,TSLA  ,2023-02-17,2023-02-24,157.5,919,822,1741
243,TSLA  ,2023-02-17,2023-02-24,160.0,3206,7326,10532
244,TSLA  ,2023-02-17,2023-02-24,162.5,385,1744,2129
245,TSLA  ,2023-02-17,2023-02-24,165.0,2251,3010,5261
246,TSLA  ,2023-02-17,2023-02-24,167.5,1050,2042,3092
247,TSLA  ,2023-02-17,2023-02-24,170.0,6442,8502,14944
248,TSLA  ,2023-02-17,2023-02-24,172.5,724,2254,2978
249,TSLA  ,2023-02-17,2023-02-24,175.0,4012,4403,8415
250,TSLA  ,2023-02-17,2023-02-24,177.5,348,5105,5453
251,TSLA  ,2023-02-17,2023-02-24,180.0,5038,13780,18818
252,TSLA  ,2023-02-17,2023-02-24,182.5,456,3660,4116
253,TSLA  ,2023-02-17,2023-02-24,185.0,1929,10023,11952
254,TSLA  ,2023-02-17,2023-02-24,187.5,857,2969,3826
255,TSLA  ,2023-02-17,2023-02-24,190.0,14676,16533,31209
256,TSLA  ,2023-02-17,2023-02-24,192.5,1907,6386,8293
257,TSLA  ,2023-02-17,2023-02-24,195.0,5749,6567,12316
258,TSLA  ,2023-02-17,2023-02-24,197.5,1683,3273,4956
259,TSLA  ,2023-02-17,2023-02-24,200.0,18493,18761,37254
260,TSLA  ,2023-02-17,2023-02-24,202.5,3888,2529,6417
261,TSLA  ,2023-02-17,2023-02-24,205.0,4664,7874,12538
262,TSLA  ,2023-02-17,2023-02-24,207.5,3174,2469,5643
263,TSLA  ,2023-02-17,2023-02-24,210.0,28605,7570,36175
264,TSLA  ,2023-02-17,2023-02-24,212.5,5912,2928,8840
265,TSLA  ,2023-02-17,2023-02-24,215.0,10820,6390,17210
266,TSLA  ,2023-02-17,2023-02-24,217.5,3641,1203,4844
267,TSLA  ,2023-02-17,2023-02-24,220.0,26562,1725,28287
268,TSLA  ,2023-02-17,2023-02-24,222.5,4803,585,5388
269,TSLA  ,2023-02-17,2023-02-24,225.0,9813,721,10534
270,TSLA  ,2023-02-17,2023-02-24,227.5,3109,238,3347
271,TSLA  ,2023-02-17,2023-02-24,230.0,17301,1155,18456
272,TSLA  ,2023-02-17,2023-02-24,232.5,2405,358,2763
273,TSLA  ,2023-02-17,2023-02-24,235.0,3796,525,4321
274,TSLA  ,2023-02-17,2023-02-24,237.5,1459,530,1989
275,TSLA  ,2023-02-17,2023-02-24,240.0,10998,1794,12792
276,TSLA  ,2023-02-17,2023-02-24,242.5,1572,131,1703
277,TSLA  ,2023-02-17,2023-02-24,245.0,4415,201,4616
278,TSLA  ,2023-02-17,2023-02-24,247.5,1431,124,1555
279,TSLA  ,2023-02-17,2023-02-24,250.0,11271,547,11818
280,TSLA  ,2023-02-17,2023-02-24,252.5,674,17,691
281,TSLA  ,2023-02-17,2023-02-24,255.0,3357,32,3389
282,TSLA  ,2023-02-17,2023-02-24,257.5,1111,50,1161
283,TSLA  ,2023-02-17,2023-02-24,260.0,9161,9,9170
284,TSLA  ,2023-02-17,2023-02-24,262.5,1002,22,1024
285,TSLA  ,2023-02-17,2023-02-24,265.0,3300,14,3314
286,TSLA  ,2023-02-17,2023-02-24,270.0,5203,55,5258
287,TSLA  ,2023-02-17,2023-02-24,275.0,7693,7,7700
288,TSLA  ,2023-02-17,2023-02-24,280.0,3739,0,3739
289,TSLA  ,2023-02-17,2023-02-24,285.0,7767,0,7767
290,TSLA  ,2023-02-17,2023-02-24,290.0,3437,0,3437
291,TSLA  ,2023-02-17,2023-02-24,295.0,6261,0,6261
292,TSLA  ,2023-02-17,2023-02-24,300.0,3957,25,3982
293,TSLA  ,2023-02-17,2023-02-24,310.0,2036,3,2039
294,TSLA  ,2023-02-17,2023-02-24,320.0,1616,0,1616
295,TSLA  ,2023-02-17,2023-02-24,330.0,1145,0,1145
296,TSLA  ,2023-02-17,2023-02-24,340.0,1481,0,1481
297,TSLA  ,2023-02-17,2023-02-24,350.0,3018,0,3018
298,TSLA  ,2023-02-17,2023-02-24,360.0,9471,5,9476
299,TSLA  ,2023-02-17,2023-03-03,15.0,11,256,267
300,TSLA  ,2023-02-17,2023-03-03,20.0,1,0,1
301,TSLA  ,2023-02-17,2023-03-03,25.0,4,47,51
302,TSLA  ,2023-02-17,2023-03-03,30.0,3,340,343
303,TSLA  ,2023-02-17,2023-03-03,35.0,3,1,4
304,TSLA  ,2023-02-17,2023-03-03,40.0,0,10,10
305,TSLA  ,2023-02-17,2023-03-03,45.0,0,2457,2457
306,TSLA  ,2023-02-17,2023-03-03,50.0,1,886,887
307,TSLA  ,2023-02-17,2023-03-03,55.0,0,156,156
308,TSLA  ,2023-02-17,2023-03-03,60.0,2,1118,1120
309,TSLA  ,2023-02-17,2023-03-03,65.0,1,100,101
310,TSLA  ,2023-02-17,2023-03-03,70.0,2,823,825
311,TSLA  ,2023-02-17,2023-03-03,75.0,1,276,277
312,TSLA  ,2023-02-17,2023-03-03,80.0,112,2171,2283
313,TSLA  ,2023-02-17,2023-03-03,85.0,4,572,576
314,TSLA  ,2023-02-17,2023-03-03,90.0,7,1026,1033
315,TSLA  ,2023-02-17,2023-03-03,95.0,7,2020,2027
316,TSLA  ,2023-02-17,2023-03-03,100.0,111,2147,2258
317,TSLA  ,2023-02-17,2023-03-03,105.0,19,906,925
318,TSLA  ,2023-02-17,2023-03-03,108.0,51,686,737
319,TSLA  ,2023-02-17,2023-03-03,109.0,34,475,509
320,TSLA  ,2023-02-17,2023-03-03,110.0,110,3460,3570
321,TSLA  ,2023-02-17,2023-03-03,111.0,7,567,574
322,TSLA  ,2023-02-17,2023-03-03,112.0,43,621,664
323,TSLA  ,2023-02-17,2023-03-03,113.0,33,745,778
324,TSLA  ,2023-02-17,2023-03-03,114.0,154,499,653
325,TSLA  ,2023-02-17,2023-03-03,115.0,190,901,1091
326,TSLA  ,2023-02-17,2023-03-03,116.0,158,609,767
327,TSLA  ,2023-02-17,2023-03-03,117.0,474,751,1225
328,TSLA  ,2023-02-17,2023-03-03,118.0,309,436,745
329,TSLA  ,2023-02-17,2023-03-03,119.0,318,541,859
330,TSLA  ,2023-02-17,2023-03-03,120.0,935,3076,4011
331,TSLA  ,2023-02-17,2023-03-03,121.0,90,562,652
332,TSLA  ,2023-02-17,2023-03-03,122.0,123,1160,1283
333,TSLA  ,2023-02-17,2023-03-03,123.0,264,1668,1932
334,TSLA  ,2023-02-17,2023-03-03,124.0,447,851,1298
335,TSLA  ,2023-02-17,2023-03-03,125.0,257,1015,1272
336,TSLA  ,2023-02-17,2023-03-03,126.0,669,386,1055
337,TSLA  ,2023-02-17,2023-03-03,127.0,425,320,745
338,TSLA  ,2023-02-17,2023-03-03,128.0,456,759,1215
339,TSLA  ,2023-02-17,2023-03-03,129.0,646,1497,2143
340,TSLA  ,2023-02-17,2023-03-03,130.0,671,2057,2728
341,TSLA  ,2023-02-17,2023-03-03,131.0,308,766,1074
342,TSLA  ,2023-02-17,2023-03-03,132.0,803,889,1692
343,TSLA  ,2023-02-17,2023-03-03,133.0,557,1225,1782
344,TSLA  ,2023-02-17,2023-03-03,134.0,569,1207,1776
345,TSLA  ,2023-02-17,2023-03-03,135.0,889,1269,2158
346,TSLA  ,2023-02-17,2023-03-03,136.0,97,102,199
347,TSLA  ,2023-02-17,2023-03-03,137.0,75,149,224
348,TSLA  ,2023-02-17,2023-03-03,138.0,148,1456,1604
349,TSLA  ,2023-02-17,2023-03-03,139.0,109,330,439
350,TSLA  ,2023-02-17,2023-03-03,140.0,670,2321,2991
351,TSLA  ,2023-02-17,2023-03-03,141.0,79,639,718
352,TSLA  ,2023-02-17,2023-03-03,142.0,297,369,666
353,TSLA  ,2023-02-17,2023-03-03,143.0,71,165,236
354,TSLA  ,2023-02-17,2023-03-03,144.0,26,3163,3189
355,TSLA  ,2023-02-17,2023-03-03,145.0,613,2143,2756
356,TSLA  ,2023-02-17,2023-03-03,146.0,41,706,747
357,TSLA  ,2023-02-17,2023-03-03,147.0,34,270,304
358,TSLA  ,2023-02-17,2023-03-03,148.0,37,492,529
359,TSLA  ,2023-02-17,2023-03-03,149.0,297,1865,2162
360,TSLA  ,2023-02-17,2023-03-03,150.0,1107,10026,11133
361,TSLA  ,2023-02-17,2023-03-03,152.5,217,1383,1600
362,TSLA  ,2023-02-17,2023-03-03,155.0,1326,1251,2577
363,TSLA  ,2023-02-17,2023-03-03,157.5,166,1445,1611
364,TSLA  ,2023-02-17,2023-03-03,160.0,1240,11315,12555
365,TSLA  ,2023-02-17,2023-03-03,162.5,351,2788,3139
366,TSLA  ,2023-02-17,2023-03-03,165.0,1916,2225,4141
367,TSLA  ,2023-02-17,2023-03-03,167.5,255,1360,1615
368,TSLA  ,2023-02-17,2023-03-03,170.0,2708,5342,8050
369,TSLA  ,2023-02-17,2023-03-03,172.5,1191,824,2015
370,TSLA  ,2023-02-17,2023-03-03,175.0,1208,2670,3878
371,TSLA  ,2023-02-17,2023-03-03,177.5,563,474,1037
372,TSLA  ,2023-02-17,2023-03-03,180.0,2450,3569,6019
373,TSLA  ,2023-02-17,2023-03-03,182.5,379,1151,1530
374,TSLA  ,2023-02-17,2023-03-03,185.0,1679,3869,5548
375,TSLA  ,2023-02-17,2023-03-03,187.5,1527,855,2382
376,TSLA  ,2023-02-17,2023-03-03,190.0,2878,5928,8806
377,TSLA  ,2023-02-17,2023-03-03,192.5,1123,1066,2189
378,TSLA  ,2023-02-17,2023-03-03,195.0,2824,2487,5311
379,TSLA  ,2023-02-17,2023-03-03,197.5,2199,973,3172
380,TSLA  ,2023-02-17,2023-03-03,200.0,8096,4717,12813
381,TSLA  ,2023-02-17,2023-03-03,202.5,2435,1672,4107
382,TSLA  ,2023-02-17,2023-03-03,205.0,3968,1511,5479
383,TSLA  ,2023-02-17,2023-03-03,207.5,1407,1352,2759
384,TSLA  ,2023-02-17,2023-03-03,210.0,5121,5470,10591
385,TSLA  ,2023-02-17,2023-03-03,212.5,2331,929,3260
386,TSLA  ,2023-02-17,2023-03-03,215.0,4988,1126,6114
387,TSLA  ,2023-02-17,2023-03-03,217.5,1764,886,2650
388,TSLA  ,2023-02-17,2023-03-03,220.0,6679,1003,7682
389,TSLA  ,2023-02-17,2023-03-03,222.5,1456,126,1582
390,TSLA  ,2023-02-17,2023-03-03,225.0,3841,53,3894
391,TSLA  ,2023-02-17,2023-03-03,227.5,727,28,755
392,TSLA  ,2023-02-17,2023-03-03,230.0,11017,392,11409
393,TSLA  ,2023-02-17,2023-03-03,232.5,40,2,42
394,TSLA  ,2023-02-17,2023-03-03,235.0,4063,58,4121
395,TSLA  ,2023-02-17,2023-03-03,237.5,125,10,135
396,TSLA  ,2023-02-17,2023-03-03,240.0,5398,507,5905
397,TSLA  ,2023-02-17,2023-03-03,242.5,49,9,58
398,TSLA  ,2023-02-17,2023-03-03,245.0,3856,148,4004
399,TSLA  ,2023-02-17,2023-03-03,250.0,7954,113,8067
400,TSLA  ,2023-02-17,2023-03-03,255.0,3852,39,3891
401,TSLA  ,2023-02-17,2023-03-03,260.0,2416,32,2448
402,TSLA  ,2023-02-17,2023-03-03,265.0,3958,52,4010
403,TSLA  ,2023-02-17,2023-03-03,270.0,3903,69,3972
404,TSLA  ,2023-02-17,2023-03-03,275.0,3774,86,3860
405,TSLA  ,2023-02-17,2023-03-03,280.0,1673,33,1706
406,TSLA  ,2023-02-17,2023-03-03,285.0,1364,47,1411
407,TSLA  ,2023-02-17,2023-03-03,290.0,4204,18,4222
408,TSLA  ,2023-02-17,2023-03-03,295.0,696,21,717
409,TSLA  ,2023-02-17,2023-03-03,300.0,6895,50,6945
410,TSLA  ,2023-02-17,2023-03-03,310.0,1326,0,1326
411,TSLA  ,2023-02-17,2023-03-03,320.0,4418,5,4423
412,TSLA  ,2023-02-17,2023-03-03,330.0,2665,0,2665
413,TSLA  ,2023-02-17,2023-03-03,340.0,6744,0,6744
414,TSLA  ,2023-02-17,2023-03-03,350.0,944,2,946
415,TSLA  ,2023-02-17,2023-03-03,360.0,3069,0,3069
416,TSLA  ,2023-02-17,2023-03-10,15.0,3,100,103
417,TSLA  ,2023-02-17,2023-03-10,20.0,3,0,3
418,TSLA  ,2023-02-17,2023-03-10,25.0,0,0,0
419,TSLA  ,2023-02-17,2023-03-10,30.0,3,2,5
420,TSLA  ,2023-02-17,2023-03-10,35.0,0,0,0
421,TSLA  ,2023-02-17,2023-03-10,40.0,0,10,10
422,TSLA  ,2023-02-17,2023-03-10,45.0,0,0,0
423,TSLA  ,2023-02-17,2023-03-10,50.0,5,638,643
424,TSLA  ,2023-02-17,2023-03-10,55.0,0,1209,1209
425,TSLA  ,2023-02-17,2023-03-10,60.0,0,23,23
426,TSLA  ,2023-02-17,2023-03-10,65.0,50,14,64
427,TSLA  ,2023-02-17,2023-03-10,70.0,0,124,124
428,TSLA  ,2023-02-17,2023-03-10,75.0,0,447,447
429,TSLA  ,2023-02-17,2023-03-10,80.0,0,320,320
430,TSLA  ,2023-02-17,2023-03-10,85.0,0,77,77
431,TSLA  ,2023-02-17,2023-03-10,90.0,0,116,116
432,TSLA  ,2023-02-17,2023-03-10,95.0,11,360,371
433,TSLA  ,2023-02-17,2023-03-10,100.0,22,805,827
434,TSLA  ,2023-02-17,2023-03-10,105.0,5,424,429
435,TSLA  ,2023-02-17,2023-03-10,110.0,14,883,897
436,TSLA  ,2023-02-17,2023-03-10,115.0,24,678,702
437,TSLA  ,2023-02-17,2023-03-10,120.0,29,1417,1446
438,TSLA  ,2023-02-17,2023-03-10,125.0,19,755,774
439,TSLA  ,2023-02-17,2023-03-10,130.0,87,414,501
440,TSLA  ,2023-02-17,2023-03-10,134.0,15,162,177
441,TSLA  ,2023-02-17,2023-03-10,135.0,35,619,654
442,TSLA  ,2023-02-17,2023-03-10,136.0,55,183,238
443,TSLA  ,2023-02-17,2023-03-10,137.0,8,89,97
444,TSLA  ,2023-02-17,2023-03-10,138.0,15,104,119
445,TSLA  ,2023-02-17,2023-03-10,139.0,4,112,116
446,TSLA  ,2023-02-17,2023-03-10,140.0,71,1120,1191
447,TSLA  ,2023-02-17,2023-03-10,141.0,143,455,598
448,TSLA  ,2023-02-17,2023-03-10,142.0,24,241,265
449,TSLA  ,2023-02-17,2023-03-10,143.0,11,317,328
450,TSLA  ,2023-02-17,2023-03-10,144.0,11,52,63
451,TSLA  ,2023-02-17,2023-03-10,145.0,99,389,488
452,TSLA  ,2023-02-17,2023-03-10,146.0,39,75,114
453,TSLA  ,2023-02-17,2023-03-10,147.0,93,146,239
454,TSLA  ,2023-02-17,2023-03-10,148.0,97,787,884
455,TSLA  ,2023-02-17,2023-03-10,149.0,16,206,222
456,TSLA  ,2023-02-17,2023-03-10,150.0,249,1394,1643
457,TSLA  ,2023-02-17,2023-03-10,152.5,130,266,396
458,TSLA  ,2023-02-17,2023-03-10,155.0,308,708,1016
459,TSLA  ,2023-02-17,2023-03-10,157.5,97,380,477
460,TSLA  ,2023-02-17,2023-03-10,160.0,241,881,1122
461,TSLA  ,2023-02-17,2023-03-10,162.5,114,514,628
462,TSLA  ,2023-02-17,2023-03-10,165.0,265,1102,1367
463,TSLA  ,2023-02-17,2023-03-10,167.5,265,546,811
464,TSLA  ,2023-02-17,2023-03-10,170.0,414,1897,2311
465,TSLA  ,2023-02-17,2023-03-10,172.5,309,526,835
466,TSLA  ,2023-02-17,2023-03-10,175.0,398,1353,1751
467,TSLA  ,2023-02-17,2023-03-10,177.5,1890,652,2542
468,TSLA  ,2023-02-17,2023-03-10,180.0,659,2664,3323
469,TSLA  ,2023-02-17,2023-03-10,182.5,245,448,693
470,TSLA  ,2023-02-17,2023-03-10,185.0,355,919,1274
471,TSLA  ,2023-02-17,2023-03-10,187.5,1200,314,1514
472,TSLA  ,2023-02-17,2023-03-10,190.0,1424,1592,3016
473,TSLA  ,2023-02-17,2023-03-10,192.5,695,553,1248
474,TSLA  ,2023-02-17,2023-03-10,195.0,745,3908,4653
475,TSLA  ,2023-02-17,2023-03-10,197.5,510,994,1504
476,TSLA  ,2023-02-17,2023-03-10,200.0,1970,1574,3544
477,TSLA  ,2023-02-17,2023-03-10,202.5,1384,1074,2458
478,TSLA  ,2023-02-17,2023-03-10,205.0,1123,1231,2354
479,TSLA  ,2023-02-17,2023-03-10,207.5,542,562,1104
480,TSLA  ,2023-02-17,2023-03-10,210.0,2136,750,2886
481,TSLA  ,2023-02-17,2023-03-10,212.5,723,639,1362
482,TSLA  ,2023-02-17,2023-03-10,215.0,1488,2100,3588
483,TSLA  ,2023-02-17,2023-03-10,217.5,452,225,677
484,TSLA  ,2023-02-17,2023-03-10,220.0,2102,147,2249
485,TSLA  ,2023-02-17,2023-03-10,222.5,399,107,506
486,TSLA  ,2023-02-17,2023-03-10,225.0,952,145,1097
487,TSLA  ,2023-02-17,2023-03-10,230.0,1480,92,1572
488,TSLA  ,2023-02-17,2023-03-10,235.0,879,25,904
489,TSLA  ,2023-02-17,2023-03-10,240.0,1342,16,1358
490,TSLA  ,2023-02-17,2023-03-10,245.0,562,53,615
491,TSLA  ,2023-02-17,2023-03-10,250.0,2739,194,2933
492,TSLA  ,2023-02-17,2023-03-10,255.0,558,2,560
493,TSLA  ,2023-02-17,2023-03-10,260.0,1396,63,1459
494,TSLA  ,2023-02-17,2023-03-10,265.0,3377,2,3379
495,TSLA  ,2023-02-17,2023-03-10,270.0,578,4,582
496,TSLA  ,2023-02-17,2023-03-10,275.0,536,5,541
497,TSLA  ,2023-02-17,2023-03-10,280.0,1792,6,1798
498,TSLA  ,2023-02-17,2023-03-10,285.0,686,0,686
499,TSLA  ,2023-02-17,2023-03-10,290.0,481,3,484
500,TSLA  ,2023-02-17,2023-03-10,295.0,459,1,460
501,TSLA  ,2023-02-17,2023-03-10,300.0,2265,0,2265
502,TSLA  ,2023-02-17,2023-03-10,310.0,2708,11,2719
503,TSLA  ,2023-02-17,2023-03-10,320.0,527,1,528
504,TSLA  ,2023-02-17,2023-03-10,330.0,348,0,348
505,TSLA  ,2023-02-17,2023-03-10,340.0,440,0,440
506,TSLA  ,2023-02-17,2023-03-10,350.0,709,0,709
507,TSLA  ,2023-02-17,2023-03-10,360.0,919,0,919
508,TSLA  ,2023-02-17,2023-03-17,1.67,50,24711,24761
509,TSLA  ,2023-02-17,2023-03-17,3.33,29,6941,6970
510,TSLA  ,2023-02-17,2023-03-17,5.0,2,8008,8010
511,TSLA  ,2023-02-17,2023-03-17,6.67,51,4669,4720
512,TSLA  ,2023-02-17,2023-03-17,8.33,3,1379,1382
513,TSLA  ,2023-02-17,2023-03-17,10.0,838,4105,4943
514,TSLA  ,2023-02-17,2023-03-17,11.67,1692,5414,7106
515,TSLA  ,2023-02-17,2023-03-17,13.33,1657,2125,3782
516,TSLA  ,2023-02-17,2023-03-17,15.0,987,5169,6156
517,TSLA  ,2023-02-17,2023-03-17,16.67,863,15329,16192
518,TSLA  ,2023-02-17,2023-03-17,18.33,466,12018,12484
519,TSLA  ,2023-02-17,2023-03-17,33.33,454,33624,34078
520,TSLA  ,2023-02-17,2023-03-17,50.0,560,21538,22098
521,TSLA  ,2023-02-17,2023-03-17,55.0,34,4674,4708
522,TSLA  ,2023-02-17,2023-03-17,60.0,182,7283,7465
523,TSLA  ,2023-02-17,2023-03-17,65.0,25,3582,3607
524,TSLA  ,2023-02-17,2023-03-17,66.67,883,18532,19415
525,TSLA  ,2023-02-17,2023-03-17,70.0,49,8128,8177
526,TSLA  ,2023-02-17,2023-03-17,75.0,54,5324,5378
527,TSLA  ,2023-02-17,2023-03-17,80.0,208,11954,12162
528,TSLA  ,2023-02-17,2023-03-17,83.33,886,5156,6042
529,TSLA  ,2023-02-17,2023-03-17,85.0,87,3628,3715
530,TSLA  ,2023-02-17,2023-03-17,90.0,663,16059,16722
531,TSLA  ,2023-02-17,2023-03-17,95.0,337,3338,3675
532,TSLA  ,2023-02-17,2023-03-17,100.0,1762,38986,40748
533,TSLA  ,2023-02-17,2023-03-17,105.0,1403,4441,5844
534,TSLA  ,2023-02-17,2023-03-17,110.0,2709,13899,16608
535,TSLA  ,2023-02-17,2023-03-17,115.0,3392,9350,12742
536,TSLA  ,2023-02-17,2023-03-17,116.67,1372,10920,12292
537,TSLA  ,2023-02-17,2023-03-17,120.0,12437,25611,38048
538,TSLA  ,2023-02-17,2023-03-17,123.33,2744,6394,9138
539,TSLA  ,2023-02-17,2023-03-17,125.0,3576,11977,15553
540,TSLA  ,2023-02-17,2023-03-17,126.67,1681,6225,7906
541,TSLA  ,2023-02-17,2023-03-17,130.0,7388,11815,19203
542,TSLA  ,2023-02-17,2023-03-17,133.33,3431,9648,13079
543,TSLA  ,2023-02-17,2023-03-17,135.0,27635,33903,61538
544,TSLA  ,2023-02-17,2023-03-17,136.67,2862,3660,6522
545,TSLA  ,2023-02-17,2023-03-17,140.0,6972,29765,36737
546,TSLA  ,2023-02-17,2023-03-17,143.33,2435,4877,7312
547,TSLA  ,2023-02-17,2023-03-17,145.0,2846,8261,11107
548,TSLA  ,2023-02-17,2023-03-17,146.67,1861,4293,6154
549,TSLA  ,2023-02-17,2023-03-17,150.0,13437,26258,39695
550,TSLA  ,2023-02-17,2023-03-17,153.33,1661,2884,4545
551,TSLA  ,2023-02-17,2023-03-17,155.0,3632,5989,9621
552,TSLA  ,2023-02-17,2023-03-17,156.67,2237,3534,5771
553,TSLA  ,2023-02-17,2023-03-17,160.0,8054,24537,32591
554,TSLA  ,2023-02-17,2023-03-17,163.33,3018,5902,8920
555,TSLA  ,2023-02-17,2023-03-17,165.0,7061,8132,15193
556,TSLA  ,2023-02-17,2023-03-17,166.67,6303,11848,18151
557,TSLA  ,2023-02-17,2023-03-17,170.0,10554,23178,33732
558,TSLA  ,2023-02-17,2023-03-17,173.33,3136,12379,15515
559,TSLA  ,2023-02-17,2023-03-17,175.0,4942,10117,15059
560,TSLA  ,2023-02-17,2023-03-17,176.67,5216,3531,8747
561,TSLA  ,2023-02-17,2023-03-17,180.0,20231,24870,45101
562,TSLA  ,2023-02-17,2023-03-17,183.33,3402,8206,11608
563,TSLA  ,2023-02-17,2023-03-17,185.0,3341,5795,9136
564,TSLA  ,2023-02-17,2023-03-17,186.67,2694,4494,7188
565,TSLA  ,2023-02-17,2023-03-17,190.0,16839,22550,39389
566,TSLA  ,2023-02-17,2023-03-17,193.33,2148,2465,4613
567,TSLA  ,2023-02-17,2023-03-17,195.0,11387,11060,22447
568,TSLA  ,2023-02-17,2023-03-17,196.67,2718,1921,4639
569,TSLA  ,2023-02-17,2023-03-17,198.33,3834,2642,6476
570,TSLA  ,2023-02-17,2023-03-17,200.0,40284,38716,79000
571,TSLA  ,2023-02-17,2023-03-17,201.67,2057,1790,3847
572,TSLA  ,2023-02-17,2023-03-17,203.33,3003,2670,5673
573,TSLA  ,2023-02-17,2023-03-17,205.0,4444,3730,8174
574,TSLA  ,2023-02-17,2023-03-17,206.67,2710,2483,5193
575,TSLA  ,2023-02-17,2023-03-17,208.33,2647,1130,3777
576,TSLA  ,2023-02-17,2023-03-17,210.0,10697,6224,16921
577,TSLA  ,2023-02-17,2023-03-17,211.67,2189,922,3111
578,TSLA  ,2023-02-17,2023-03-17,213.33,2160,1090,3250
579,TSLA  ,2023-02-17,2023-03-17,215.0,14284,6485,20769
580,TSLA  ,2023-02-17,2023-03-17,216.67,5018,2895,7913
581,TSLA  ,2023-02-17,2023-03-17,218.33,1637,4897,6534
582,TSLA  ,2023-02-17,2023-03-17,220.0,14482,1670,16152
583,TSLA  ,2023-02-17,2023-03-17,221.67,1465,358,1823
584,TSLA  ,2023-02-17,2023-03-17,223.33,1261,394,1655
585,TSLA  ,2023-02-17,2023-03-17,225.0,5674,1640,7314
586,TSLA  ,2023-02-17,2023-03-17,226.67,2171,196,2367
587,TSLA  ,2023-02-17,2023-03-17,228.33,4925,93,5018
588,TSLA  ,2023-02-17,2023-03-17,230.0,9586,1852,11438
589,TSLA  ,2023-02-17,2023-03-17,231.67,1498,105,1603
590,TSLA  ,2023-02-17,2023-03-17,233.33,6966,439,7405
591,TSLA  ,2023-02-17,2023-03-17,235.0,9597,125,9722
592,TSLA  ,2023-02-17,2023-03-17,236.67,1298,88,1386
593,TSLA  ,2023-02-17,2023-03-17,238.33,1175,103,1278
594,TSLA  ,2023-02-17,2023-03-17,240.0,8497,374,8871
595,TSLA  ,2023-02-17,2023-03-17,241.67,1184,69,1253
596,TSLA  ,2023-02-17,2023-03-17,243.33,1312,407,1719
597,TSLA  ,2023-02-17,2023-03-17,245.0,2453,40,2493
598,TSLA  ,2023-02-17,2023-03-17,246.67,1198,32,1230
599,TSLA  ,2023-02-17,2023-03-17,248.33,1135,34,1169
600,TSLA  ,2023-02-17,2023-03-17,250.0,25319,891,26210
601,TSLA  ,2023-02-17,2023-03-17,251.67,1486,65,1551
602,TSLA  ,2023-02-17,2023-03-17,253.33,681,40,721
603,TSLA  ,2023-02-17,2023-03-17,255.0,4770,80,4850
604,TSLA  ,2023-02-17,2023-03-17,256.67,707,16,723
605,TSLA  ,2023-02-17,2023-03-17,258.33,1006,27,1033
606,TSLA  ,2023-02-17,2023-03-17,260.0,8930,55,8985
607,TSLA  ,2023-02-17,2023-03-17,261.67,1613,12,1625
608,TSLA  ,2023-02-17,2023-03-17,263.33,1081,71,1152
609,TSLA  ,2023-02-17,2023-03-17,265.0,2840,16,2856
610,TSLA  ,2023-02-17,2023-03-17,266.67,10961,379,11340
611,TSLA  ,2023-02-17,2023-03-17,270.0,5427,36,5463
612,TSLA  ,2023-02-17,2023-03-17,273.33,3854,80,3934
613,TSLA  ,2023-02-17,2023-03-17,275.0,820,14,834
614,TSLA  ,2023-02-17,2023-03-17,276.67,1548,41,1589
615,TSLA  ,2023-02-17,2023-03-17,280.0,3779,140,3919
616,TSLA  ,2023-02-17,2023-03-17,283.33,6939,54,6993
617,TSLA  ,2023-02-17,2023-03-17,285.0,1074,8,1082
618,TSLA  ,2023-02-17,2023-03-17,286.67,2036,23,2059
619,TSLA  ,2023-02-17,2023-03-17,290.0,3625,69,3694
620,TSLA  ,2023-02-17,2023-03-17,293.33,7308,354,7662
621,TSLA  ,2023-02-17,2023-03-17,295.0,2826,10,2836
622,TSLA  ,2023-02-17,2023-03-17,296.67,943,16,959
623,TSLA  ,2023-02-17,2023-03-17,298.33,1113,7,1120
624,TSLA  ,2023-02-17,2023-03-17,300.0,72669,460,73129
625,TSLA  ,2023-02-17,2023-03-17,301.67,1501,21,1522
626,TSLA  ,2023-02-17,2023-03-17,303.33,1464,4,1468
627,TSLA  ,2023-02-17,2023-03-17,305.0,2652,26,2678
628,TSLA  ,2023-02-17,2023-03-17,306.67,1994,9,2003
629,TSLA  ,2023-02-17,2023-03-17,308.33,3560,7,3567
630,TSLA  ,2023-02-17,2023-03-17,310.0,4391,36,4427
631,TSLA  ,2023-02-17,2023-03-17,311.67,2058,5,2063
632,TSLA  ,2023-02-17,2023-03-17,313.33,2560,3,2563
633,TSLA  ,2023-02-17,2023-03-17,316.67,29644,13,29657
634,TSLA  ,2023-02-17,2023-03-17,320.0,15572,208,15780
635,TSLA  ,2023-02-17,2023-03-17,323.33,471,3,474
636,TSLA  ,2023-02-17,2023-03-17,326.67,677,2,679
637,TSLA  ,2023-02-17,2023-03-17,330.0,3197,8,3205
638,TSLA  ,2023-02-17,2023-03-17,333.33,20475,36,20511
639,TSLA  ,2023-02-17,2023-03-17,336.67,830,1,831
640,TSLA  ,2023-02-17,2023-03-17,340.0,5691,8,5699
641,TSLA  ,2023-02-17,2023-03-17,343.33,1903,0,1903
642,TSLA  ,2023-02-17,2023-03-17,346.67,624,0,624
643,TSLA  ,2023-02-17,2023-03-17,350.0,11436,13,11449
644,TSLA  ,2023-02-17,2023-03-17,353.33,1315,0,1315
645,TSLA  ,2023-02-17,2023-03-17,356.67,719,0,719
646,TSLA  ,2023-02-17,2023-03-17,360.0,2235,0,2235
647,TSLA  ,2023-02-17,2023-03-17,363.33,558,0,558
648,TSLA  ,2023-02-17,2023-03-17,366.67,7748,0,7748
649,TSLA  ,2023-02-17,2023-03-17,370.0,1380,0,1380
650,TSLA  ,2023-02-17,2023-03-17,373.33,679,0,679
651,TSLA  ,2023-02-17,2023-03-17,383.33,12754,0,12754
652,TSLA  ,2023-02-17,2023-03-17,400.0,26665,0,26665
653,TSLA  ,2023-02-17,2023-03-17,416.67,13204,0,13204
654,TSLA  ,2023-02-17,2023-03-17,433.33,19401,0,19401
655,TSLA  ,2023-02-17,2023-03-17,441.67,2026,0,2026
656,TSLA  ,2023-02-17,2023-03-17,450.0,5564,0,5564
657,TSLA  ,2023-02-17,2023-03-17,458.33,2484,0,2484
658,TSLA  ,2023-02-17,2023-03-17,466.67,2885,19,2904
659,TSLA  ,2023-02-17,2023-03-17,475.0,3784,0,3784
660,TSLA  ,2023-02-17,2023-03-17,483.33,1988,0,1988
661,TSLA  ,2023-02-17,2023-03-17,491.67,2484,0,2484
662,TSLA  ,2023-02-17,2023-03-17,500.0,13910,41,13951
663,TSLA  ,2023-02-17,2023-03-17,508.33,3615,0,3615
664,TSLA  ,2023-02-17,2023-03-17,516.67,1128,0,1128
665,TSLA  ,2023-02-17,2023-03-17,525.0,4883,0,4883
666,TSLA  ,2023-02-17,2023-03-17,533.33,4717,0,4717
667,TSLA  ,2023-02-17,2023-03-17,541.67,1032,0,1032
668,TSLA  ,2023-02-17,2023-03-17,550.0,5038,0,5038
669,TSLA  ,2023-02-17,2023-03-17,558.33,3781,0,3781
670,TSLA  ,2023-02-17,2023-03-17,566.67,7710,0,7710
671,TSLA  ,2023-02-17,2023-03-17,575.0,11902,0,11902
672,TSLA  ,2023-02-17,2023-03-17,583.33,2663,0,2663
673,TSLA  ,2023-02-17,2023-03-17,591.67,1109,0,1109
674,TSLA  ,2023-02-17,2023-03-17,600.0,5609,0,5609
675,TSLA  ,2023-02-17,2023-03-17,608.33,542,0,542
676,TSLA  ,2023-02-17,2023-03-17,616.67,3997,0,3997
677,TSLA  ,2023-02-17,2023-03-17,625.0,1040,0,1040
678,TSLA  ,2023-02-17,2023-03-17,633.33,2375,0,2375
679,TSLA  ,2023-02-17,2023-03-17,641.67,1533,0,1533
680,TSLA  ,2023-02-17,2023-03-17,650.0,8752,0,8752
681,TSLA  ,2023-02-17,2023-03-17,666.67,70788,0,70788
682,TSLA  ,2023-02-17,2023-03-17,675.0,21633,0,21633
683,TSLA  ,2023-02-17,2023-03-17,683.33,4034,0,4034
684,TSLA  ,2023-02-17,2023-03-17,691.67,1388,0,1388
685,TSLA  ,2023-02-17,2023-03-17,700.0,4724,0,4724
686,TSLA  ,2023-02-17,2023-03-17,708.33,602,0,602
687,TSLA  ,2023-02-17,2023-03-17,716.67,783,0,783
688,TSLA  ,2023-02-17,2023-03-17,725.0,1042,0,1042
689,TSLA  ,2023-02-17,2023-03-17,733.33,1615,0,1615
690,TSLA  ,2023-02-17,2023-03-17,741.67,755,0,755
691,TSLA  ,2023-02-17,2023-03-17,750.0,754,0,754
692,TSLA  ,2023-02-17,2023-03-17,758.33,1235,0,1235
693,TSLA  ,2023-02-17,2023-03-17,766.67,1260,0,1260
694,TSLA  ,2023-02-17,2023-03-17,775.0,849,1,850
695,TSLA  ,2023-02-17,2023-03-17,783.33,1306,0,1306
696,TSLA  ,2023-02-17,2023-03-17,791.67,1448,0,1448
697,TSLA  ,2023-02-17,2023-03-17,800.0,5379,0,5379
698,TSLA  ,2023-02-17,2023-03-17,808.33,1842,0,1842
699,TSLA  ,2023-02-17,2023-03-17,816.67,2608,0,2608
700,TSLA  ,2023-02-17,2023-03-17,825.0,60223,0,60223
701,TSLA  ,2023-02-17,2023-03-24,20.0,6,122,128
702,TSLA  ,2023-02-17,2023-03-24,25.0,0,0,0
703,TSLA  ,2023-02-17,2023-03-24,30.0,0,0,0
704,TSLA  ,2023-02-17,2023-03-24,35.0,0,0,0
705,TSLA  ,2023-02-17,2023-03-24,40.0,0,0,0
706,TSLA  ,2023-02-17,2023-03-24,45.0,0,1,1
707,TSLA  ,2023-02-17,2023-03-24,50.0,21,1543,1564
708,TSLA  ,2023-02-17,2023-03-24,55.0,3,0,3
709,TSLA  ,2023-02-17,2023-03-24,60.0,0,27,27
710,TSLA  ,2023-02-17,2023-03-24,65.0,0,8,8
711,TSLA  ,2023-02-17,2023-03-24,70.0,0,22,22
712,TSLA  ,2023-02-17,2023-03-24,75.0,0,45,45
713,TSLA  ,2023-02-17,2023-03-24,80.0,0,70,70
714,TSLA  ,2023-02-17,2023-03-24,85.0,1,26,27
715,TSLA  ,2023-02-17,2023-03-24,90.0,0,32,32
716,TSLA  ,2023-02-17,2023-03-24,95.0,0,75,75
717,TSLA  ,2023-02-17,2023-03-24,100.0,12,324,336
718,TSLA  ,2023-02-17,2023-03-24,105.0,10,99,109
719,TSLA  ,2023-02-17,2023-03-24,110.0,6,103,109
720,TSLA  ,2023-02-17,2023-03-24,115.0,2,65,67
721,TSLA  ,2023-02-17,2023-03-24,120.0,2,522,524
722,TSLA  ,2023-02-17,2023-03-24,125.0,6,456,462
723,TSLA  ,2023-02-17,2023-03-24,130.0,172,358,530
724,TSLA  ,2023-02-17,2023-03-24,135.0,36,432,468
725,TSLA  ,2023-02-17,2023-03-24,140.0,26,459,485
726,TSLA  ,2023-02-17,2023-03-24,145.0,55,287,342
727,TSLA  ,2023-02-17,2023-03-24,146.0,10,50,60
728,TSLA  ,2023-02-17,2023-03-24,147.0,87,30,117
729,TSLA  ,2023-02-17,2023-03-24,148.0,76,93,169
730,TSLA  ,2023-02-17,2023-03-24,149.0,59,87,146
731,TSLA  ,2023-02-17,2023-03-24,150.0,71,764,835
732,TSLA  ,2023-02-17,2023-03-24,152.5,14,140,154
733,TSLA  ,2023-02-17,2023-03-24,155.0,478,683,1161
734,TSLA  ,2023-02-17,2023-03-24,157.5,69,435,504
735,TSLA  ,2023-02-17,2023-03-24,160.0,99,569,668
736,TSLA  ,2023-02-17,2023-03-24,162.5,47,150,197
737,TSLA  ,2023-02-17,2023-03-24,165.0,97,620,717
738,TSLA  ,2023-02-17,2023-03-24,167.5,16,504,520
739,TSLA  ,2023-02-17,2023-03-24,170.0,182,986,1168
740,TSLA  ,2023-02-17,2023-03-24,172.5,37,296,333
741,TSLA  ,2023-02-17,2023-03-24,175.0,151,577,728
742,TSLA  ,2023-02-17,2023-03-24,177.5,82,464,546
743,TSLA  ,2023-02-17,2023-03-24,180.0,298,1007,1305
744,TSLA  ,2023-02-17,2023-03-24,182.5,33,142,175
745,TSLA  ,2023-02-17,2023-03-24,185.0,104,413,517
746,TSLA  ,2023-02-17,2023-03-24,187.5,129,94,223
747,TSLA  ,2023-02-17,2023-03-24,190.0,414,840,1254
748,TSLA  ,2023-02-17,2023-03-24,192.5,84,198,282
749,TSLA  ,2023-02-17,2023-03-24,195.0,503,364,867
750,TSLA  ,2023-02-17,2023-03-24,197.5,1138,129,1267
751,TSLA  ,2023-02-17,2023-03-24,200.0,2553,1737,4290
752,TSLA  ,2023-02-17,2023-03-24,202.5,713,97,810
753,TSLA  ,2023-02-17,2023-03-24,205.0,1328,144,1472
754,TSLA  ,2023-02-17,2023-03-24,207.5,320,114,434
755,TSLA  ,2023-02-17,2023-03-24,210.0,2520,277,2797
756,TSLA  ,2023-02-17,2023-03-24,212.5,467,115,582
757,TSLA  ,2023-02-17,2023-03-24,215.0,1142,531,1673
758,TSLA  ,2023-02-17,2023-03-24,217.5,276,62,338
759,TSLA  ,2023-02-17,2023-03-24,220.0,3271,611,3882
760,TSLA  ,2023-02-17,2023-03-24,222.5,296,80,376
761,TSLA  ,2023-02-17,2023-03-24,225.0,471,111,582
762,TSLA  ,2023-02-17,2023-03-24,230.0,707,226,933
763,TSLA  ,2023-02-17,2023-03-24,235.0,636,84,720
764,TSLA  ,2023-02-17,2023-03-24,240.0,247,135,382
765,TSLA  ,2023-02-17,2023-03-24,245.0,581,21,602
766,TSLA  ,2023-02-17,2023-03-24,250.0,1407,38,1445
767,TSLA  ,2023-02-17,2023-03-24,255.0,324,21,345
768,TSLA  ,2023-02-17,2023-03-24,260.0,794,5,799
769,TSLA  ,2023-02-17,2023-03-24,265.0,313,1,314
770,TSLA  ,2023-02-17,2023-03-24,270.0,1627,4,1631
771,TSLA  ,2023-02-17,2023-03-24,275.0,231,3,234
772,TSLA  ,2023-02-17,2023-03-24,280.0,373,0,373
773,TSLA  ,2023-02-17,2023-03-24,285.0,300,0,300
774,TSLA  ,2023-02-17,2023-03-24,290.0,264,0,264
775,TSLA  ,2023-02-17,2023-03-24,295.0,87,0,87
776,TSLA  ,2023-02-17,2023-03-24,300.0,732,1,733
777,TSLA  ,2023-02-17,2023-03-24,310.0,246,0,246
778,TSLA  ,2023-02-17,2023-03-24,320.0,318,1,319
779,TSLA  ,2023-02-17,2023-03-24,330.0,140,0,140
780,TSLA  ,2023-02-17,2023-03-24,340.0,354,0,354
781,TSLA  ,2023-02-17,2023-03-24,350.0,278,0,278
782,TSLA  ,2023-02-17,2023-03-24,360.0,788,0,788
783,TSLA  ,2023-02-17,2023-03-31,25.0,0,0,0
784,TSLA  ,2023-02-17,2023-03-31,30.0,0,0,0
785,TSLA  ,2023-02-17,2023-03-31,35.0,0,1,1
786,TSLA  ,2023-02-17,2023-03-31,40.0,0,0,0
787,TSLA  ,2023-02-17,2023-03-31,45.0,0,2,2
788,TSLA  ,2023-02-17,2023-03-31,50.0,0,3,3
789,TSLA  ,2023-02-17,2023-03-31,55.0,0,0,0
790,TSLA  ,2023-02-17,2023-03-31,60.0,0,12,12
791,TSLA  ,2023-02-17,2023-03-31,65.0,0,8,8
792,TSLA  ,2023-02-17,2023-03-31,70.0,0,19,19
793,TSLA  ,2023-02-17,2023-03-31,75.0,0,58,58
794,TSLA  ,2023-02-17,2023-03-31,80.0,4,48,52
795,TSLA  ,2023-02-17,2023-03-31,85.0,0,7,7
796,TSLA  ,2023-02-17,2023-03-31,90.0,0,44,44
797,TSLA  ,2023-02-17,2023-03-31,95.0,0,131,131
798,TSLA  ,2023-02-17,2023-03-31,100.0,2,82,84
799,TSLA  ,2023-02-17,2023-03-31,105.0,0,163,163
800,TSLA  ,2023-02-17,2023-03-31,110.0,0,68,68
801,TSLA  ,2023-02-17,2023-03-31,115.0,1,130,131
802,TSLA  ,2023-02-17,2023-03-31,120.0,6,164,170
803,TSLA  ,2023-02-17,2023-03-31,125.0,41,67,108
804,TSLA  ,2023-02-17,2023-03-31,130.0,11,150,161
805,TSLA  ,2023-02-17,2023-03-31,135.0,7,220,227
806,TSLA  ,2023-02-17,2023-03-31,140.0,34,230,264
807,TSLA  ,2023-02-17,2023-03-31,145.0,33,283,316
808,TSLA  ,2023-02-17,2023-03-31,150.0,139,507,646
809,TSLA  ,2023-02-17,2023-03-31,155.0,308,120,428
810,TSLA  ,2023-02-17,2023-03-31,160.0,69,378,447
811,TSLA  ,2023-02-17,2023-03-31,165.0,49,295,344
812,TSLA  ,2023-02-17,2023-03-31,170.0,11,935,946
813,TSLA  ,2023-02-17,2023-03-31,172.5,6,151,157
814,TSLA  ,2023-02-17,2023-03-31,175.0,38,441,479
815,TSLA  ,2023-02-17,2023-03-31,177.5,4,77,81
816,TSLA  ,2023-02-17,2023-03-31,180.0,248,764,1012
817,TSLA  ,2023-02-17,2023-03-31,182.5,9,91,100
818,TSLA  ,2023-02-17,2023-03-31,185.0,41,118,159
819,TSLA  ,2023-02-17,2023-03-31,187.5,29,108,137
820,TSLA  ,2023-02-17,2023-03-31,190.0,81,290,371
821,TSLA  ,2023-02-17,2023-03-31,192.5,28,67,95
822,TSLA  ,2023-02-17,2023-03-31,195.0,86,5099,5185
823,TSLA  ,2023-02-17,2023-03-31,197.5,116,102,218
824,TSLA  ,2023-02-17,2023-03-31,200.0,287,362,649
825,TSLA  ,2023-02-17,2023-03-31,202.5,112,75,187
826,TSLA  ,2023-02-17,2023-03-31,205.0,348,295,643
827,TSLA  ,2023-02-17,2023-03-31,207.5,229,106,335
828,TSLA  ,2023-02-17,2023-03-31,210.0,931,177,1108
829,TSLA  ,2023-02-17,2023-03-31,212.5,397,110,507
830,TSLA  ,2023-02-17,2023-03-31,215.0,516,115,631
831,TSLA  ,2023-02-17,2023-03-31,217.5,237,67,304
832,TSLA  ,2023-02-17,2023-03-31,220.0,1119,77,1196
833,TSLA  ,2023-02-17,2023-03-31,222.5,99,14,113
834,TSLA  ,2023-02-17,2023-03-31,225.0,247,4,251
835,TSLA  ,2023-02-17,2023-03-31,230.0,587,31,618
836,TSLA  ,2023-02-17,2023-03-31,235.0,338,23,361
837,TSLA  ,2023-02-17,2023-03-31,240.0,420,6,426
838,TSLA  ,2023-02-17,2023-03-31,245.0,327,31,358
839,TSLA  ,2023-02-17,2023-03-31,250.0,1005,3,1008
840,TSLA  ,2023-02-17,2023-03-31,255.0,306,2,308
841,TSLA  ,2023-02-17,2023-03-31,260.0,372,5,377
842,TSLA  ,2023-02-17,2023-03-31,265.0,151,0,151
843,TSLA  ,2023-02-17,2023-03-31,270.0,304,13,317
844,TSLA  ,2023-02-17,2023-03-31,275.0,358,3,361
845,TSLA  ,2023-02-17,2023-03-31,280.0,498,2,500
846,TSLA  ,2023-02-17,2023-03-31,285.0,249,0,249
847,TSLA  ,2023-02-17,2023-03-31,290.0,201,0,201
848,TSLA  ,2023-02-17,2023-03-31,295.0,122,31,153
849,TSLA  ,2023-02-17,2023-03-31,300.0,459,25,484
850,TSLA  ,2023-02-17,2023-03-31,310.0,296,1,297
851,TSLA  ,2023-02-17,2023-03-31,320.0,34,4,38
852,TSLA  ,2023-02-17,2023-03-31,330.0,135,0,135
853,TSLA  ,2023-02-17,2023-03-31,340.0,94,0,94
854,TSLA  ,2023-02-17,2023-03-31,350.0,116,1,117
855,TSLA  ,2023-02-17,2023-03-31,360.0,127,0,127
856,TSLA  ,2023-02-17,2023-04-21,5.0,14,101,115
857,TSLA  ,2023-02-17,2023-04-21,10.0,0,8,8
858,TSLA  ,2023-02-17,2023-04-21,15.0,0,41,41
859,TSLA  ,2023-02-17,2023-04-21,20.0,4,320,324
860,TSLA  ,2023-02-17,2023-04-21,25.0,8,2491,2499
861,TSLA  ,2023-02-17,2023-04-21,30.0,0,3037,3037
862,TSLA  ,2023-02-17,2023-04-21,35.0,5,445,450
863,TSLA  ,2023-02-17,2023-04-21,40.0,7,527,534
864,TSLA  ,2023-02-17,2023-04-21,45.0,2,800,802
865,TSLA  ,2023-02-17,2023-04-21,50.0,127,5112,5239
866,TSLA  ,2023-02-17,2023-04-21,55.0,15,2772,2787
867,TSLA  ,2023-02-17,2023-04-21,60.0,18,1992,2010
868,TSLA  ,2023-02-17,2023-04-21,65.0,65,5211,5276
869,TSLA  ,2023-02-17,2023-04-21,70.0,65,4457,4522
870,TSLA  ,2023-02-17,2023-04-21,75.0,123,13208,13331
871,TSLA  ,2023-02-17,2023-04-21,80.0,25226,4541,29767
872,TSLA  ,2023-02-17,2023-04-21,85.0,89,3316,3405
873,TSLA  ,2023-02-17,2023-04-21,90.0,271,2351,2622
874,TSLA  ,2023-02-17,2023-04-21,95.0,152,6112,6264
875,TSLA  ,2023-02-17,2023-04-21,100.0,1558,28234,29792
876,TSLA  ,2023-02-17,2023-04-21,105.0,362,2983,3345
877,TSLA  ,2023-02-17,2023-04-21,108.33,898,5143,6041
878,TSLA  ,2023-02-17,2023-04-21,110.0,1078,7419,8497
879,TSLA  ,2023-02-17,2023-04-21,115.0,1429,3498,4927
880,TSLA  ,2023-02-17,2023-04-21,116.67,2542,9430,11972
881,TSLA  ,2023-02-17,2023-04-21,120.0,7422,10345,17767
882,TSLA  ,2023-02-17,2023-04-21,125.0,11074,12290,23364
883,TSLA  ,2023-02-17,2023-04-21,130.0,1799,7495,9294
884,TSLA  ,2023-02-17,2023-04-21,133.33,4581,3694,8275
885,TSLA  ,2023-02-17,2023-04-21,135.0,1861,2362,4223
886,TSLA  ,2023-02-17,2023-04-21,140.0,2976,7420,10396
887,TSLA  ,2023-02-17,2023-04-21,141.67,6297,3524,9821
888,TSLA  ,2023-02-17,2023-04-21,145.0,1964,2498,4462
889,TSLA  ,2023-02-17,2023-04-21,150.0,7871,18556,26427
890,TSLA  ,2023-02-17,2023-04-21,155.0,1373,2115,3488
891,TSLA  ,2023-02-17,2023-04-21,158.33,2998,4111,7109
892,TSLA  ,2023-02-17,2023-04-21,160.0,2954,5821,8775
893,TSLA  ,2023-02-17,2023-04-21,165.0,1548,1500,3048
894,TSLA  ,2023-02-17,2023-04-21,166.67,2669,5411,8080
895,TSLA  ,2023-02-17,2023-04-21,170.0,1995,3795,5790
896,TSLA  ,2023-02-17,2023-04-21,175.0,10738,7927,18665
897,TSLA  ,2023-02-17,2023-04-21,180.0,2982,5246,8228
898,TSLA  ,2023-02-17,2023-04-21,183.33,2729,3992,6721
899,TSLA  ,2023-02-17,2023-04-21,185.0,2339,3685,6024
900,TSLA  ,2023-02-17,2023-04-21,190.0,2557,7695,10252
901,TSLA  ,2023-02-17,2023-04-21,191.67,3128,14303,17431
902,TSLA  ,2023-02-17,2023-04-21,195.0,3166,2534,5700
903,TSLA  ,2023-02-17,2023-04-21,200.0,13091,9745,22836
904,TSLA  ,2023-02-17,2023-04-21,205.0,3902,2625,6527
905,TSLA  ,2023-02-17,2023-04-21,208.33,5886,2908,8794
906,TSLA  ,2023-02-17,2023-04-21,210.0,5775,3421,9196
907,TSLA  ,2023-02-17,2023-04-21,215.0,2956,1552,4508
908,TSLA  ,2023-02-17,2023-04-21,216.67,2097,3602,5699
909,TSLA  ,2023-02-17,2023-04-21,220.0,7119,1075,8194
910,TSLA  ,2023-02-17,2023-04-21,225.0,8684,2228,10912
911,TSLA  ,2023-02-17,2023-04-21,230.0,1908,669,2577
912,TSLA  ,2023-02-17,2023-04-21,233.33,1692,820,2512
913,TSLA  ,2023-02-17,2023-04-21,235.0,1448,367,1815
914,TSLA  ,2023-02-17,2023-04-21,240.0,13802,549,14351
915,TSLA  ,2023-02-17,2023-04-21,241.67,1141,101,1242
916,TSLA  ,2023-02-17,2023-04-21,243.33,1335,49,1384
917,TSLA  ,2023-02-17,2023-04-21,245.0,1427,176,1603
918,TSLA  ,2023-02-17,2023-04-21,246.67,1418,84,1502
919,TSLA  ,2023-02-17,2023-04-21,248.33,949,330,1279
920,TSLA  ,2023-02-17,2023-04-21,250.0,9466,879,10345
921,TSLA  ,2023-02-17,2023-04-21,251.67,1644,82,1726
922,TSLA  ,2023-02-17,2023-04-21,253.33,435,44,479
923,TSLA  ,2023-02-17,2023-04-21,255.0,1679,48,1727
924,TSLA  ,2023-02-17,2023-04-21,258.33,1188,895,2083
925,TSLA  ,2023-02-17,2023-04-21,260.0,2270,6,2276
926,TSLA  ,2023-02-17,2023-04-21,265.0,1247,3,1250
927,TSLA  ,2023-02-17,2023-04-21,266.67,1688,197,1885
928,TSLA  ,2023-02-17,2023-04-21,270.0,971,2,973
929,TSLA  ,2023-02-17,2023-04-21,275.0,2179,100,2279
930,TSLA  ,2023-02-17,2023-04-21,280.0,2155,206,2361
931,TSLA  ,2023-02-17,2023-04-21,283.33,1314,215,1529
932,TSLA  ,2023-02-17,2023-04-21,285.0,284,15,299
933,TSLA  ,2023-02-17,2023-04-21,290.0,395,0,395
934,TSLA  ,2023-02-17,2023-04-21,291.67,3081,30,3111
935,TSLA  ,2023-02-17,2023-04-21,295.0,74,0,74
936,TSLA  ,2023-02-17,2023-04-21,300.0,9471,41,9512
937,TSLA  ,2023-02-17,2023-04-21,305.0,207,0,207
938,TSLA  ,2023-02-17,2023-04-21,308.33,4138,26,4164
939,TSLA  ,2023-02-17,2023-04-21,310.0,973,0,973
940,TSLA  ,2023-02-17,2023-04-21,316.67,22069,2,22071
941,TSLA  ,2023-02-17,2023-04-21,325.0,2703,11,2714
942,TSLA  ,2023-02-17,2023-04-21,333.33,4412,0,4412
943,TSLA  ,2023-02-17,2023-04-21,341.67,805,8,813
944,TSLA  ,2023-02-17,2023-04-21,350.0,3368,0,3368
945,TSLA  ,2023-02-17,2023-04-21,358.33,950,0,950
946,TSLA  ,2023-02-17,2023-04-21,366.67,1191,4,1195
947,TSLA  ,2023-02-17,2023-04-21,375.0,1547,16,1563
948,TSLA  ,2023-02-17,2023-04-21,383.33,673,0,673
949,TSLA  ,2023-02-17,2023-04-21,391.67,393,0,393
950,TSLA  ,2023-02-17,2023-04-21,400.0,3351,0,3351
951,TSLA  ,2023-02-17,2023-04-21,408.33,415,0,415
952,TSLA  ,2023-02-17,2023-04-21,416.67,1128,0,1128
953,TSLA  ,2023-02-17,2023-04-21,425.0,4946,0,4946
954,TSLA  ,2023-02-17,2023-04-21,433.33,12432,0,12432
955,TSLA  ,2023-02-17,2023-04-21,441.67,758,0,758
956,TSLA  ,2023-02-17,2023-04-21,450.0,1322,0,1322
957,TSLA  ,2023-02-17,2023-04-21,458.33,3252,0,3252
958,TSLA  ,2023-02-17,2023-04-21,466.67,424,0,424
959,TSLA  ,2023-02-17,2023-04-21,475.0,939,0,939
960,TSLA  ,2023-02-17,2023-04-21,483.33,823,0,823
961,TSLA  ,2023-02-17,2023-04-21,491.67,189,0,189
962,TSLA  ,2023-02-17,2023-04-21,500.0,3594,0,3594
963,TSLA  ,2023-02-17,2023-04-21,508.33,902,0,902
964,TSLA  ,2023-02-17,2023-04-21,516.67,507,0,507
965,TSLA  ,2023-02-17,2023-04-21,525.0,481,0,481
966,TSLA  ,2023-02-17,2023-04-21,533.33,495,0,495
967,TSLA  ,2023-02-17,2023-04-21,541.67,553,0,553
968,TSLA  ,2023-02-17,2023-04-21,550.0,11285,0,11285
969,TSLA  ,2023-02-17,2023-04-21,558.33,268,0,268
970,TSLA  ,2023-02-17,2023-04-21,566.67,570,0,570
971,TSLA  ,2023-02-17,2023-04-21,575.0,1608,0,1608
972,TSLA  ,2023-02-17,2023-04-21,583.33,1096,0,1096
973,TSLA  ,2023-02-17,2023-04-21,600.0,21032,0,21032
974,TSLA  ,2023-02-17,2023-05-19,50.0,62,2906,2968
975,TSLA  ,2023-02-17,2023-05-19,55.0,51,601,652
976,TSLA  ,2023-02-17,2023-05-19,60.0,159,949,1108
977,TSLA  ,2023-02-17,2023-05-19,65.0,64,451,515
978,TSLA  ,2023-02-17,2023-05-19,70.0,178,1452,1630
979,TSLA  ,2023-02-17,2023-05-19,75.0,135,1646,1781
980,TSLA  ,2023-02-17,2023-05-19,80.0,84,1575,1659
981,TSLA  ,2023-02-17,2023-05-19,85.0,62,1759,1821
982,TSLA  ,2023-02-17,2023-05-19,90.0,243,2776,3019
983,TSLA  ,2023-02-17,2023-05-19,95.0,134,1780,1914
984,TSLA  ,2023-02-17,2023-05-19,100.0,1089,19626,20715
985,TSLA  ,2023-02-17,2023-05-19,105.0,285,6135,6420
986,TSLA  ,2023-02-17,2023-05-19,110.0,1017,7238,8255
987,TSLA  ,2023-02-17,2023-05-19,115.0,1365,1933,3298
988,TSLA  ,2023-02-17,2023-05-19,120.0,2147,7970,10117
989,TSLA  ,2023-02-17,2023-05-19,125.0,3725,2544,6269
990,TSLA  ,2023-02-17,2023-05-19,130.0,2697,5014,7711
991,TSLA  ,2023-02-17,2023-05-19,135.0,2007,2144,4151
992,TSLA  ,2023-02-17,2023-05-19,140.0,1892,11483,13375
993,TSLA  ,2023-02-17,2023-05-19,145.0,2377,2066,4443
994,TSLA  ,2023-02-17,2023-05-19,150.0,3922,4798,8720
995,TSLA  ,2023-02-17,2023-05-19,155.0,1386,1660,3046
996,TSLA  ,2023-02-17,2023-05-19,160.0,3176,4775,7951
997,TSLA  ,2023-02-17,2023-05-19,165.0,1389,1519,2908
998,TSLA  ,2023-02-17,2023-05-19,170.0,2789,4976,7765
999,TSLA  ,2023-02-17,2023-05-19,175.0,2062,1925,3987
1000,TSLA  ,2023-02-17,2023-05-19,180.0,7981,4081,12062
1001,TSLA  ,2023-02-17,2023-05-19,185.0,1831,1492,3323
1002,TSLA  ,2023-02-17,2023-05-19,190.0,2847,3462,6309
1003,TSLA  ,2023-02-17,2023-05-19,195.0,3180,2298,5478
1004,TSLA  ,2023-02-17,2023-05-19,200.0,8097,3000,11097
1005,TSLA  ,2023-02-17,2023-05-19,205.0,3850,4639,8489
1006,TSLA  ,2023-02-17,2023-05-19,210.0,10593,2733,13326
1007,TSLA  ,2023-02-17,2023-05-19,215.0,26035,1530,27565
1008,TSLA  ,2023-02-17,2023-05-19,220.0,7433,1430,8863
1009,TSLA  ,2023-02-17,2023-05-19,225.0,2569,893,3462
1010,TSLA  ,2023-02-17,2023-05-19,230.0,2373,510,2883
1011,TSLA  ,2023-02-17,2023-05-19,235.0,1754,295,2049
1012,TSLA  ,2023-02-17,2023-05-19,240.0,2931,103,3034
1013,TSLA  ,2023-02-17,2023-05-19,245.0,1074,149,1223
1014,TSLA  ,2023-02-17,2023-05-19,250.0,3031,77,3108
1015,TSLA  ,2023-02-17,2023-05-19,260.0,1327,135,1462
1016,TSLA  ,2023-02-17,2023-05-19,270.0,3250,130,3380
1017,TSLA  ,2023-02-17,2023-05-19,280.0,746,29,775
1018,TSLA  ,2023-02-17,2023-05-19,290.0,420,367,787
1019,TSLA  ,2023-02-17,2023-05-19,300.0,1880,543,2423
1020,TSLA  ,2023-02-17,2023-05-19,310.0,537,5251,5788
1021,TSLA  ,2023-02-17,2023-05-19,320.0,849,1168,2017
1022,TSLA  ,2023-02-17,2023-05-19,330.0,593,26,619
1023,TSLA  ,2023-02-17,2023-05-19,340.0,419,3,422
1024,TSLA  ,2023-02-17,2023-05-19,350.0,320,5,325
1025,TSLA  ,2023-02-17,2023-05-19,360.0,807,1,808
1026,TSLA  ,2023-02-17,2023-05-19,370.0,181,0,181
1027,TSLA  ,2023-02-17,2023-05-19,380.0,217,0,217
1028,TSLA  ,2023-02-17,2023-05-19,390.0,905,1,906
1029,TSLA  ,2023-02-17,2023-06-16,1.67,103,41937,42040
1030,TSLA  ,2023-02-17,2023-06-16,3.33,399,5010,5409
1031,TSLA  ,2023-02-17,2023-06-16,5.0,108,1684,1792
1032,TSLA  ,2023-02-17,2023-06-16,6.67,75,1309,1384
1033,TSLA  ,2023-02-17,2023-06-16,8.33,425,2371,2796
1034,TSLA  ,2023-02-17,2023-06-16,10.0,3233,3746,6979
1035,TSLA  ,2023-02-17,2023-06-16,11.67,155,8573,8728
1036,TSLA  ,2023-02-17,2023-06-16,13.33,1234,5645,6879
1037,TSLA  ,2023-02-17,2023-06-16,15.0,168,4103,4271
1038,TSLA  ,2023-02-17,2023-06-16,16.67,489,9827,10316
1039,TSLA  ,2023-02-17,2023-06-16,18.33,93,4992,5085
1040,TSLA  ,2023-02-17,2023-06-16,33.33,862,16826,17688
1041,TSLA  ,2023-02-17,2023-06-16,50.0,1110,17530,18640
1042,TSLA  ,2023-02-17,2023-06-16,55.0,31,7347,7378
1043,TSLA  ,2023-02-17,2023-06-16,60.0,15,2253,2268
1044,TSLA  ,2023-02-17,2023-06-16,65.0,4,626,630
1045,TSLA  ,2023-02-17,2023-06-16,66.67,1011,14259,15270
1046,TSLA  ,2023-02-17,2023-06-16,70.0,49,4072,4121
1047,TSLA  ,2023-02-17,2023-06-16,75.0,84,6632,6716
1048,TSLA  ,2023-02-17,2023-06-16,80.0,184,3843,4027
1049,TSLA  ,2023-02-17,2023-06-16,83.33,708,5086,5794
1050,TSLA  ,2023-02-17,2023-06-16,85.0,86,4284,4370
1051,TSLA  ,2023-02-17,2023-06-16,90.0,206,3971,4177
1052,TSLA  ,2023-02-17,2023-06-16,95.0,123,1585,1708
1053,TSLA  ,2023-02-17,2023-06-16,100.0,3480,29365,32845
1054,TSLA  ,2023-02-17,2023-06-16,105.0,362,5367,5729
1055,TSLA  ,2023-02-17,2023-06-16,110.0,1177,5633,6810
1056,TSLA  ,2023-02-17,2023-06-16,115.0,595,2940,3535
1057,TSLA  ,2023-02-17,2023-06-16,116.67,1786,5265,7051
1058,TSLA  ,2023-02-17,2023-06-16,120.0,3426,9965,13391
1059,TSLA  ,2023-02-17,2023-06-16,123.33,456,1131,1587
1060,TSLA  ,2023-02-17,2023-06-16,125.0,4148,8431,12579
1061,TSLA  ,2023-02-17,2023-06-16,126.67,916,1348,2264
1062,TSLA  ,2023-02-17,2023-06-16,130.0,3677,9349,13026
1063,TSLA  ,2023-02-17,2023-06-16,133.33,2531,8768,11299
1064,TSLA  ,2023-02-17,2023-06-16,135.0,2737,2657,5394
1065,TSLA  ,2023-02-17,2023-06-16,136.67,1081,2572,3653
1066,TSLA  ,2023-02-17,2023-06-16,140.0,7633,6707,14340
1067,TSLA  ,2023-02-17,2023-06-16,143.33,1231,3245,4476
1068,TSLA  ,2023-02-17,2023-06-16,145.0,2151,3526,5677
1069,TSLA  ,2023-02-17,2023-06-16,146.67,1581,1961,3542
1070,TSLA  ,2023-02-17,2023-06-16,150.0,12552,13483,26035
1071,TSLA  ,2023-02-17,2023-06-16,153.33,2433,3218,5651
1072,TSLA  ,2023-02-17,2023-06-16,155.0,1218,3072,4290
1073,TSLA  ,2023-02-17,2023-06-16,156.67,1639,744,2383
1074,TSLA  ,2023-02-17,2023-06-16,160.0,6556,7099,13655
1075,TSLA  ,2023-02-17,2023-06-16,163.33,972,1217,2189
1076,TSLA  ,2023-02-17,2023-06-16,165.0,1808,2899,4707
1077,TSLA  ,2023-02-17,2023-06-16,166.67,3625,13075,16700
1078,TSLA  ,2023-02-17,2023-06-16,170.0,2696,4692,7388
1079,TSLA  ,2023-02-17,2023-06-16,173.33,1453,6330,7783
1080,TSLA  ,2023-02-17,2023-06-16,175.0,2647,5564,8211
1081,TSLA  ,2023-02-17,2023-06-16,180.0,8305,8814,17119
1082,TSLA  ,2023-02-17,2023-06-16,183.33,9800,10300,20100
1083,TSLA  ,2023-02-17,2023-06-16,185.0,7940,7045,14985
1084,TSLA  ,2023-02-17,2023-06-16,186.67,964,1983,2947
1085,TSLA  ,2023-02-17,2023-06-16,190.0,5725,4887,10612
1086,TSLA  ,2023-02-17,2023-06-16,193.33,1850,7779,9629
1087,TSLA  ,2023-02-17,2023-06-16,195.0,2709,2766,5475
1088,TSLA  ,2023-02-17,2023-06-16,200.0,25684,24854,50538
1089,TSLA  ,2023-02-17,2023-06-16,205.0,2739,1226,3965
1090,TSLA  ,2023-02-17,2023-06-16,206.67,2456,2909,5365
1091,TSLA  ,2023-02-17,2023-06-16,210.0,5046,4026,9072
1092,TSLA  ,2023-02-17,2023-06-16,213.33,2321,2616,4937
1093,TSLA  ,2023-02-17,2023-06-16,215.0,3741,1220,4961
1094,TSLA  ,2023-02-17,2023-06-16,216.67,6801,6169,12970
1095,TSLA  ,2023-02-17,2023-06-16,220.0,8186,7053,15239
1096,TSLA  ,2023-02-17,2023-06-16,225.0,2326,1352,3678
1097,TSLA  ,2023-02-17,2023-06-16,226.67,2752,2188,4940
1098,TSLA  ,2023-02-17,2023-06-16,230.0,7157,3054,10211
1099,TSLA  ,2023-02-17,2023-06-16,233.33,11495,7980,19475
1100,TSLA  ,2023-02-17,2023-06-16,235.0,3753,873,4626
1101,TSLA  ,2023-02-17,2023-06-16,240.0,7996,3115,11111
1102,TSLA  ,2023-02-17,2023-06-16,243.33,1312,1697,3009
1103,TSLA  ,2023-02-17,2023-06-16,245.0,1884,75,1959
1104,TSLA  ,2023-02-17,2023-06-16,246.67,3067,94,3161
1105,TSLA  ,2023-02-17,2023-06-16,250.0,15585,3441,19026
1106,TSLA  ,2023-02-17,2023-06-16,253.33,1399,195,1594
1107,TSLA  ,2023-02-17,2023-06-16,255.0,1226,73,1299
1108,TSLA  ,2023-02-17,2023-06-16,260.0,5230,81,5311
1109,TSLA  ,2023-02-17,2023-06-16,265.0,2455,84,2539
1110,TSLA  ,2023-02-17,2023-06-16,266.67,7291,408,7699
1111,TSLA  ,2023-02-17,2023-06-16,270.0,1392,6,1398
1112,TSLA  ,2023-02-17,2023-06-16,273.33,1405,1051,2456
1113,TSLA  ,2023-02-17,2023-06-16,275.0,1826,9,1835
1114,TSLA  ,2023-02-17,2023-06-16,280.0,4207,69,4276
1115,TSLA  ,2023-02-17,2023-06-16,283.33,4657,51,4708
1116,TSLA  ,2023-02-17,2023-06-16,285.0,1019,2,1021
1117,TSLA  ,2023-02-17,2023-06-16,286.67,749,50,799
1118,TSLA  ,2023-02-17,2023-06-16,290.0,1502,826,2328
1119,TSLA  ,2023-02-17,2023-06-16,293.33,1623,62,1685
1120,TSLA  ,2023-02-17,2023-06-16,295.0,279,258,537
1121,TSLA  ,2023-02-17,2023-06-16,300.0,18415,170,18585
1122,TSLA  ,2023-02-17,2023-06-16,305.0,939,5,944
1123,TSLA  ,2023-02-17,2023-06-16,306.67,1439,30,1469
1124,TSLA  ,2023-02-17,2023-06-16,310.0,1684,45,1729
1125,TSLA  ,2023-02-17,2023-06-16,313.33,542,33,575
1126,TSLA  ,2023-02-17,2023-06-16,315.0,339,82,421
1127,TSLA  ,2023-02-17,2023-06-16,316.67,7181,241,7422
1128,TSLA  ,2023-02-17,2023-06-16,320.0,2458,3,2461
1129,TSLA  ,2023-02-17,2023-06-16,326.67,9729,6,9735
1130,TSLA  ,2023-02-17,2023-06-16,330.0,1960,51,2011
1131,TSLA  ,2023-02-17,2023-06-16,333.33,33843,231,34074
1132,TSLA  ,2023-02-17,2023-06-16,340.0,1675,3,1678
1133,TSLA  ,2023-02-17,2023-06-16,346.67,1323,0,1323
1134,TSLA  ,2023-02-17,2023-06-16,350.0,8488,334,8822
1135,TSLA  ,2023-02-17,2023-06-16,353.33,970,0,970
1136,TSLA  ,2023-02-17,2023-06-16,360.0,1851,3,1854
1137,TSLA  ,2023-02-17,2023-06-16,366.67,10952,450,11402
1138,TSLA  ,2023-02-17,2023-06-16,370.0,961,0,961
1139,TSLA  ,2023-02-17,2023-06-16,383.33,10923,0,10923
1140,TSLA  ,2023-02-17,2023-06-16,400.0,18068,919,18987
1141,TSLA  ,2023-02-17,2023-06-16,416.67,3618,20,3638
1142,TSLA  ,2023-02-17,2023-06-16,433.33,9695,0,9695
1143,TSLA  ,2023-02-17,2023-06-16,450.0,8265,0,8265
1144,TSLA  ,2023-02-17,2023-06-16,466.67,20900,0,20900
1145,TSLA  ,2023-02-17,2023-06-16,483.33,8290,0,8290
1146,TSLA  ,2023-02-17,2023-06-16,500.0,21911,0,21911
1147,TSLA  ,2023-02-17,2023-06-16,516.67,2665,0,2665
1148,TSLA  ,2023-02-17,2023-06-16,533.33,4870,0,4870
1149,TSLA  ,2023-02-17,2023-06-16,550.0,6178,0,6178
1150,TSLA  ,2023-02-17,2023-06-16,558.33,1594,0,1594
1151,TSLA  ,2023-02-17,2023-06-16,566.67,1270,0,1270
1152,TSLA  ,2023-02-17,2023-06-16,575.0,710,0,710
1153,TSLA  ,2023-02-17,2023-06-16,583.33,1204,0,1204
1154,TSLA  ,2023-02-17,2023-06-16,591.67,397,0,397
1155,TSLA  ,2023-02-17,2023-06-16,600.0,6522,0,6522
1156,TSLA  ,2023-02-17,2023-06-16,608.33,1109,0,1109
1157,TSLA  ,2023-02-17,2023-06-16,616.67,548,0,548
1158,TSLA  ,2023-02-17,2023-06-16,625.0,2144,0,2144
1159,TSLA  ,2023-02-17,2023-06-16,633.33,5398,0,5398
1160,TSLA  ,2023-02-17,2023-06-16,641.67,448,0,448
1161,TSLA  ,2023-02-17,2023-06-16,650.0,580,0,580
1162,TSLA  ,2023-02-17,2023-06-16,666.67,17913,0,17913
1163,TSLA  ,2023-02-17,2023-06-16,675.0,905,0,905
1164,TSLA  ,2023-02-17,2023-06-16,683.33,605,0,605
1165,TSLA  ,2023-02-17,2023-06-16,691.67,904,0,904
1166,TSLA  ,2023-02-17,2023-06-16,700.0,2741,0,2741
1167,TSLA  ,2023-02-17,2023-06-16,708.33,547,0,547
1168,TSLA  ,2023-02-17,2023-06-16,716.67,696,0,696
1169,TSLA  ,2023-02-17,2023-06-16,725.0,1175,0,1175
1170,TSLA  ,2023-02-17,2023-06-16,733.33,2256,0,2256
1171,TSLA  ,2023-02-17,2023-06-16,741.67,767,0,767
1172,TSLA  ,2023-02-17,2023-06-16,750.0,11709,0,11709
1173,TSLA  ,2023-02-17,2023-06-16,758.33,1298,0,1298
1174,TSLA  ,2023-02-17,2023-06-16,766.67,1263,0,1263
1175,TSLA  ,2023-02-17,2023-06-16,775.0,1168,0,1168
1176,TSLA  ,2023-02-17,2023-06-16,783.33,2218,0,2218
1177,TSLA  ,2023-02-17,2023-06-16,791.67,1870,0,1870
1178,TSLA  ,2023-02-17,2023-06-16,800.0,10045,0,10045
1179,TSLA  ,2023-02-17,2023-06-16,808.33,1243,0,1243
1180,TSLA  ,2023-02-17,2023-06-16,816.67,1812,0,1812
1181,TSLA  ,2023-02-17,2023-06-16,825.0,42716,0,42716
1182,TSLA  ,2023-02-17,2023-07-21,5.0,32,723,755
1183,TSLA  ,2023-02-17,2023-07-21,10.0,5,906,911
1184,TSLA  ,2023-02-17,2023-07-21,15.0,4,386,390
1185,TSLA  ,2023-02-17,2023-07-21,20.0,12,1205,1217
1186,TSLA  ,2023-02-17,2023-07-21,25.0,25,1092,1117
1187,TSLA  ,2023-02-17,2023-07-21,30.0,111,1435,1546
1188,TSLA  ,2023-02-17,2023-07-21,35.0,42,839,881
1189,TSLA  ,2023-02-17,2023-07-21,40.0,21,1188,1209
1190,TSLA  ,2023-02-17,2023-07-21,45.0,38,630,668
1191,TSLA  ,2023-02-17,2023-07-21,50.0,70,5060,5130
1192,TSLA  ,2023-02-17,2023-07-21,55.0,86,1857,1943
1193,TSLA  ,2023-02-17,2023-07-21,60.0,94,3676,3770
1194,TSLA  ,2023-02-17,2023-07-21,65.0,89,400,489
1195,TSLA  ,2023-02-17,2023-07-21,70.0,25,2402,2427
1196,TSLA  ,2023-02-17,2023-07-21,75.0,63,4232,4295
1197,TSLA  ,2023-02-17,2023-07-21,80.0,79,3658,3737
1198,TSLA  ,2023-02-17,2023-07-21,85.0,54,1388,1442
1199,TSLA  ,2023-02-17,2023-07-21,90.0,121,3421,3542
1200,TSLA  ,2023-02-17,2023-07-21,95.0,68,1615,1683
1201,TSLA  ,2023-02-17,2023-07-21,100.0,325,5841,6166
1202,TSLA  ,2023-02-17,2023-07-21,105.0,373,2496,2869
1203,TSLA  ,2023-02-17,2023-07-21,110.0,1124,3758,4882
1204,TSLA  ,2023-02-17,2023-07-21,115.0,455,1027,1482
1205,TSLA  ,2023-02-17,2023-07-21,120.0,1251,4575,5826
1206,TSLA  ,2023-02-17,2023-07-21,125.0,1409,2198,3607
1207,TSLA  ,2023-02-17,2023-07-21,130.0,1500,1853,3353
1208,TSLA  ,2023-02-17,2023-07-21,135.0,1137,2804,3941
1209,TSLA  ,2023-02-17,2023-07-21,140.0,1466,4188,5654
1210,TSLA  ,2023-02-17,2023-07-21,145.0,1059,2338,3397
1211,TSLA  ,2023-02-17,2023-07-21,150.0,3200,3867,7067
1212,TSLA  ,2023-02-17,2023-07-21,155.0,1686,2876,4562
1213,TSLA  ,2023-02-17,2023-07-21,160.0,1773,1658,3431
1214,TSLA  ,2023-02-17,2023-07-21,165.0,664,1456,2120
1215,TSLA  ,2023-02-17,2023-07-21,170.0,1806,2799,4605
1216,TSLA  ,2023-02-17,2023-07-21,175.0,1640,1488,3128
1217,TSLA  ,2023-02-17,2023-07-21,180.0,2114,1915,4029
1218,TSLA  ,2023-02-17,2023-07-21,185.0,3943,13360,17303
1219,TSLA  ,2023-02-17,2023-07-21,190.0,2657,2323,4980
1220,TSLA  ,2023-02-17,2023-07-21,195.0,2000,1915,3915
1221,TSLA  ,2023-02-17,2023-07-21,200.0,8232,3659,11891
1222,TSLA  ,2023-02-17,2023-07-21,205.0,4742,2132,6874
1223,TSLA  ,2023-02-17,2023-07-21,210.0,4608,1695,6303
1224,TSLA  ,2023-02-17,2023-07-21,215.0,3522,1505,5027
1225,TSLA  ,2023-02-17,2023-07-21,220.0,2971,1716,4687
1226,TSLA  ,2023-02-17,2023-07-21,225.0,5172,2160,7332
1227,TSLA  ,2023-02-17,2023-07-21,230.0,1948,1272,3220
1228,TSLA  ,2023-02-17,2023-07-21,235.0,1544,686,2230
1229,TSLA  ,2023-02-17,2023-07-21,240.0,2500,1756,4256
1230,TSLA  ,2023-02-17,2023-07-21,245.0,2472,724,3196
1231,TSLA  ,2023-02-17,2023-07-21,250.0,24448,1569,26017
1232,TSLA  ,2023-02-17,2023-07-21,255.0,918,681,1599
1233,TSLA  ,2023-02-17,2023-07-21,260.0,1508,83,1591
1234,TSLA  ,2023-02-17,2023-07-21,265.0,666,9,675
1235,TSLA  ,2023-02-17,2023-07-21,270.0,746,126,872
1236,TSLA  ,2023-02-17,2023-07-21,275.0,434,82,516
1237,TSLA  ,2023-02-17,2023-07-21,280.0,1210,147,1357
1238,TSLA  ,2023-02-17,2023-07-21,285.0,1065,150,1215
1239,TSLA  ,2023-02-17,2023-07-21,290.0,422,35,457
1240,TSLA  ,2023-02-17,2023-07-21,295.0,410,11,421
1241,TSLA  ,2023-02-17,2023-07-21,300.0,2520,40,2560
1242,TSLA  ,2023-02-17,2023-07-21,305.0,237,6,243
1243,TSLA  ,2023-02-17,2023-07-21,310.0,1380,6,1386
1244,TSLA  ,2023-02-17,2023-07-21,315.0,400,1,401
1245,TSLA  ,2023-02-17,2023-07-21,320.0,971,2,973
1246,TSLA  ,2023-02-17,2023-07-21,325.0,666,2,668
1247,TSLA  ,2023-02-17,2023-07-21,330.0,439,25,464
1248,TSLA  ,2023-02-17,2023-07-21,335.0,166,7,173
1249,TSLA  ,2023-02-17,2023-07-21,340.0,440,16,456
1250,TSLA  ,2023-02-17,2023-07-21,345.0,212,0,212
1251,TSLA  ,2023-02-17,2023-07-21,350.0,789,1,790
1252,TSLA  ,2023-02-17,2023-07-21,355.0,277,1,278
1253,TSLA  ,2023-02-17,2023-07-21,360.0,559,3,562
1254,TSLA  ,2023-02-17,2023-07-21,365.0,876,0,876
1255,TSLA  ,2023-02-17,2023-07-21,370.0,1050,0,1050
1256,TSLA  ,2023-02-17,2023-07-21,375.0,3136,0,3136
1257,TSLA  ,2023-02-17,2023-07-21,380.0,187,0,187
1258,TSLA  ,2023-02-17,2023-07-21,390.0,642,0,642
1259,TSLA  ,2023-02-17,2023-09-15,1.67,861,20044,20905
1260,TSLA  ,2023-02-17,2023-09-15,3.33,1085,2849,3934
1261,TSLA  ,2023-02-17,2023-09-15,5.0,34,942,976
1262,TSLA  ,2023-02-17,2023-09-15,6.67,29,3368,3397
1263,TSLA  ,2023-02-17,2023-09-15,8.33,32,1180,1212
1264,TSLA  ,2023-02-17,2023-09-15,10.0,26,2499,2525
1265,TSLA  ,2023-02-17,2023-09-15,11.67,49,618,667
1266,TSLA  ,2023-02-17,2023-09-15,13.33,83,230,313
1267,TSLA  ,2023-02-17,2023-09-15,15.0,0,116,116
1268,TSLA  ,2023-02-17,2023-09-15,16.67,143,4199,4342
1269,TSLA  ,2023-02-17,2023-09-15,30.0,0,75,75
1270,TSLA  ,2023-02-17,2023-09-15,33.33,3118,11360,14478
1271,TSLA  ,2023-02-17,2023-09-15,35.0,5,35,40
1272,TSLA  ,2023-02-17,2023-09-15,40.0,9,272,281
1273,TSLA  ,2023-02-17,2023-09-15,45.0,9,49,58
1274,TSLA  ,2023-02-17,2023-09-15,50.0,418,7650,8068
1275,TSLA  ,2023-02-17,2023-09-15,55.0,23,2373,2396
1276,TSLA  ,2023-02-17,2023-09-15,60.0,30,4722,4752
1277,TSLA  ,2023-02-17,2023-09-15,65.0,4,2186,2190
1278,TSLA  ,2023-02-17,2023-09-15,66.67,434,5688,6122
1279,TSLA  ,2023-02-17,2023-09-15,70.0,86,618,704
1280,TSLA  ,2023-02-17,2023-09-15,75.0,26,636,662
1281,TSLA  ,2023-02-17,2023-09-15,80.0,260,858,1118
1282,TSLA  ,2023-02-17,2023-09-15,83.33,407,4463,4870
1283,TSLA  ,2023-02-17,2023-09-15,85.0,52,321,373
1284,TSLA  ,2023-02-17,2023-09-15,90.0,485,2798,3283
1285,TSLA  ,2023-02-17,2023-09-15,95.0,70,2430,2500
1286,TSLA  ,2023-02-17,2023-09-15,100.0,2491,12164,14655
1287,TSLA  ,2023-02-17,2023-09-15,105.0,88,2157,2245
1288,TSLA  ,2023-02-17,2023-09-15,108.33,397,2143,2540
1289,TSLA  ,2023-02-17,2023-09-15,110.0,1238,1508,2746
1290,TSLA  ,2023-02-17,2023-09-15,115.0,267,2821,3088
1291,TSLA  ,2023-02-17,2023-09-15,116.67,569,12228,12797
1292,TSLA  ,2023-02-17,2023-09-15,120.0,854,2027,2881
1293,TSLA  ,2023-02-17,2023-09-15,123.33,523,1351,1874
1294,TSLA  ,2023-02-17,2023-09-15,125.0,1732,7986,9718
1295,TSLA  ,2023-02-17,2023-09-15,126.67,130,1071,1201
1296,TSLA  ,2023-02-17,2023-09-15,130.0,1391,4905,6296
1297,TSLA  ,2023-02-17,2023-09-15,133.33,215,2368,2583
1298,TSLA  ,2023-02-17,2023-09-15,135.0,232,1224,1456
1299,TSLA  ,2023-02-17,2023-09-15,136.67,285,953,1238
1300,TSLA  ,2023-02-17,2023-09-15,140.0,1764,2615,4379
1301,TSLA  ,2023-02-17,2023-09-15,141.67,763,1679,2442
1302,TSLA  ,2023-02-17,2023-09-15,143.33,283,1538,1821
1303,TSLA  ,2023-02-17,2023-09-15,145.0,347,2621,2968
1304,TSLA  ,2023-02-17,2023-09-15,146.67,1372,1093,2465
1305,TSLA  ,2023-02-17,2023-09-15,150.0,33689,8876,42565
1306,TSLA  ,2023-02-17,2023-09-15,153.33,30476,1815,32291
1307,TSLA  ,2023-02-17,2023-09-15,155.0,419,386,805
1308,TSLA  ,2023-02-17,2023-09-15,156.67,394,729,1123
1309,TSLA  ,2023-02-17,2023-09-15,158.33,314,564,878
1310,TSLA  ,2023-02-17,2023-09-15,160.0,3714,7082,10796
1311,TSLA  ,2023-02-17,2023-09-15,163.33,397,1504,1901
1312,TSLA  ,2023-02-17,2023-09-15,165.0,1248,858,2106
1313,TSLA  ,2023-02-17,2023-09-15,166.67,1391,3241,4632
1314,TSLA  ,2023-02-17,2023-09-15,170.0,634,736,1370
1315,TSLA  ,2023-02-17,2023-09-15,173.33,10316,3049,13365
1316,TSLA  ,2023-02-17,2023-09-15,175.0,10906,7937,18843
1317,TSLA  ,2023-02-17,2023-09-15,180.0,33698,6985,40683
1318,TSLA  ,2023-02-17,2023-09-15,183.33,32272,4808,37080
1319,TSLA  ,2023-02-17,2023-09-15,185.0,333,826,1159
1320,TSLA  ,2023-02-17,2023-09-15,186.67,515,3472,3987
1321,TSLA  ,2023-02-17,2023-09-15,190.0,710,3342,4052
1322,TSLA  ,2023-02-17,2023-09-15,191.67,484,1172,1656
1323,TSLA  ,2023-02-17,2023-09-15,193.33,897,2956,3853
1324,TSLA  ,2023-02-17,2023-09-15,195.0,441,815,1256
1325,TSLA  ,2023-02-17,2023-09-15,200.0,11736,17085,28821
1326,TSLA  ,2023-02-17,2023-09-15,205.0,512,426,938
1327,TSLA  ,2023-02-17,2023-09-15,206.67,1124,666,1790
1328,TSLA  ,2023-02-17,2023-09-15,208.33,583,1990,2573
1329,TSLA  ,2023-02-17,2023-09-15,210.0,2368,452,2820
1330,TSLA  ,2023-02-17,2023-09-15,213.33,903,1285,2188
1331,TSLA  ,2023-02-17,2023-09-15,215.0,1015,231,1246
1332,TSLA  ,2023-02-17,2023-09-15,216.67,2007,4095,6102
1333,TSLA  ,2023-02-17,2023-09-15,220.0,8835,4190,13025
1334,TSLA  ,2023-02-17,2023-09-15,225.0,2782,3337,6119
1335,TSLA  ,2023-02-17,2023-09-15,226.67,2273,1500,3773
1336,TSLA  ,2023-02-17,2023-09-15,230.0,3462,918,4380
1337,TSLA  ,2023-02-17,2023-09-15,233.33,2793,3468,6261
1338,TSLA  ,2023-02-17,2023-09-15,235.0,782,754,1536
1339,TSLA  ,2023-02-17,2023-09-15,240.0,1407,1698,3105
1340,TSLA  ,2023-02-17,2023-09-15,241.67,1365,844,2209
1341,TSLA  ,2023-02-17,2023-09-15,245.0,220,345,565
1342,TSLA  ,2023-02-17,2023-09-15,246.67,518,906,1424
1343,TSLA  ,2023-02-17,2023-09-15,250.0,10823,5803,16626
1344,TSLA  ,2023-02-17,2023-09-15,253.33,801,705,1506
1345,TSLA  ,2023-02-17,2023-09-15,255.0,317,156,473
1346,TSLA  ,2023-02-17,2023-09-15,258.33,945,2412,3357
1347,TSLA  ,2023-02-17,2023-09-15,260.0,11835,1420,13255
1348,TSLA  ,2023-02-17,2023-09-15,265.0,328,151,479
1349,TSLA  ,2023-02-17,2023-09-15,266.67,2377,320,2697
1350,TSLA  ,2023-02-17,2023-09-15,270.0,384,162,546
1351,TSLA  ,2023-02-17,2023-09-15,273.33,684,383,1067
1352,TSLA  ,2023-02-17,2023-09-15,275.0,2875,3223,6098
1353,TSLA  ,2023-02-17,2023-09-15,280.0,2434,576,3010
1354,TSLA  ,2023-02-17,2023-09-15,283.33,1260,315,1575
1355,TSLA  ,2023-02-17,2023-09-15,286.67,604,97,701
1356,TSLA  ,2023-02-17,2023-09-15,290.0,1416,65,1481
1357,TSLA  ,2023-02-17,2023-09-15,291.67,989,386,1375
1358,TSLA  ,2023-02-17,2023-09-15,293.33,1346,460,1806
1359,TSLA  ,2023-02-17,2023-09-15,300.0,7977,967,8944
1360,TSLA  ,2023-02-17,2023-09-15,306.67,2721,327,3048
1361,TSLA  ,2023-02-17,2023-09-15,308.33,868,335,1203
1362,TSLA  ,2023-02-17,2023-09-15,310.0,108,0,108
1363,TSLA  ,2023-02-17,2023-09-15,313.33,804,287,1091
1364,TSLA  ,2023-02-17,2023-09-15,316.67,1624,162,1786
1365,TSLA  ,2023-02-17,2023-09-15,320.0,1803,169,1972
1366,TSLA  ,2023-02-17,2023-09-15,325.0,2808,75,2883
1367,TSLA  ,2023-02-17,2023-09-15,326.67,1064,5,1069
1368,TSLA  ,2023-02-17,2023-09-15,333.33,6443,83,6526
1369,TSLA  ,2023-02-17,2023-09-15,340.0,23365,147,23512
1370,TSLA  ,2023-02-17,2023-09-15,341.67,179,187,366
1371,TSLA  ,2023-02-17,2023-09-15,346.67,549,137,686
1372,TSLA  ,2023-02-17,2023-09-15,350.0,20704,328,21032
1373,TSLA  ,2023-02-17,2023-09-15,353.33,22637,149,22786
1374,TSLA  ,2023-02-17,2023-09-15,358.33,470,287,757
1375,TSLA  ,2023-02-17,2023-09-15,360.0,3397,306,3703
1376,TSLA  ,2023-02-17,2023-09-15,366.67,2803,561,3364
1377,TSLA  ,2023-02-17,2023-09-15,375.0,3264,160,3424
1378,TSLA  ,2023-02-17,2023-09-15,383.33,4643,47,4690
1379,TSLA  ,2023-02-17,2023-09-15,391.67,841,14,855
1380,TSLA  ,2023-02-17,2023-09-15,400.0,5698,69,5767
1381,TSLA  ,2023-02-17,2023-09-15,408.33,1573,1,1574
1382,TSLA  ,2023-02-17,2023-09-15,416.67,962,0,962
1383,TSLA  ,2023-02-17,2023-09-15,425.0,3226,0,3226
1384,TSLA  ,2023-02-17,2023-09-15,433.33,4936,8,4944
1385,TSLA  ,2023-02-17,2023-09-15,441.67,1059,0,1059
1386,TSLA  ,2023-02-17,2023-09-15,450.0,2452,0,2452
1387,TSLA  ,2023-02-17,2023-09-15,458.33,402,0,402
1388,TSLA  ,2023-02-17,2023-09-15,466.67,2694,0,2694
1389,TSLA  ,2023-02-17,2023-09-15,475.0,333,0,333
1390,TSLA  ,2023-02-17,2023-09-15,483.33,669,0,669
1391,TSLA  ,2023-02-17,2023-09-15,491.67,1097,0,1097
1392,TSLA  ,2023-02-17,2023-09-15,500.0,5618,0,5618
1393,TSLA  ,2023-02-17,2023-09-15,508.33,811,0,811
1394,TSLA  ,2023-02-17,2023-09-15,516.67,1270,0,1270
1395,TSLA  ,2023-02-17,2023-09-15,525.0,1190,0,1190
1396,TSLA  ,2023-02-17,2023-09-15,533.33,1597,0,1597
1397,TSLA  ,2023-02-17,2023-09-15,541.67,1167,0,1167
1398,TSLA  ,2023-02-17,2023-09-15,550.0,11719,0,11719
1399,TSLA  ,2023-02-17,2023-09-15,558.33,188,0,188
1400,TSLA  ,2023-02-17,2023-09-15,566.67,4045,0,4045
1401,TSLA  ,2023-02-17,2023-09-15,575.0,412,0,412
1402,TSLA  ,2023-02-17,2023-09-15,583.33,514,0,514
1403,TSLA  ,2023-02-17,2023-09-15,591.67,2112,0,2112
1404,TSLA  ,2023-02-17,2023-09-15,600.0,8634,0,8634
1405,TSLA  ,2023-02-17,2023-09-15,608.33,671,0,671
1406,TSLA  ,2023-02-17,2023-09-15,616.67,1020,0,1020
1407,TSLA  ,2023-02-17,2023-09-15,625.0,1064,0,1064
1408,TSLA  ,2023-02-17,2023-09-15,633.33,701,0,701
1409,TSLA  ,2023-02-17,2023-09-15,641.67,425,0,425
1410,TSLA  ,2023-02-17,2023-09-15,650.0,27715,0,27715
1411,TSLA  ,2023-02-17,2023-09-15,658.33,1207,0,1207
1412,TSLA  ,2023-02-17,2023-09-15,666.67,1352,0,1352
1413,TSLA  ,2023-02-17,2023-09-15,675.0,466,0,466
1414,TSLA  ,2023-02-17,2023-09-15,683.33,458,0,458
1415,TSLA  ,2023-02-17,2023-09-15,700.0,1525,0,1525
1416,TSLA  ,2023-02-17,2023-09-15,716.67,1149,0,1149
1417,TSLA  ,2023-02-17,2023-09-15,733.33,2323,0,2323
1418,TSLA  ,2023-02-17,2023-09-15,750.0,8186,0,8186
1419,TSLA  ,2023-02-17,2023-09-15,758.33,71867,0,71867
1420,TSLA  ,2023-02-17,2023-12-15,50.0,1398,13996,15394
1421,TSLA  ,2023-02-17,2023-12-15,55.0,222,1187,1409
1422,TSLA  ,2023-02-17,2023-12-15,60.0,40,1337,1377
1423,TSLA  ,2023-02-17,2023-12-15,65.0,4,381,385
1424,TSLA  ,2023-02-17,2023-12-15,70.0,27,3864,3891
1425,TSLA  ,2023-02-17,2023-12-15,75.0,19,4137,4156
1426,TSLA  ,2023-02-17,2023-12-15,80.0,156,954,1110
1427,TSLA  ,2023-02-17,2023-12-15,85.0,2574,2370,4944
1428,TSLA  ,2023-02-17,2023-12-15,90.0,1648,6030,7678
1429,TSLA  ,2023-02-17,2023-12-15,95.0,831,498,1329
1430,TSLA  ,2023-02-17,2023-12-15,100.0,3084,6437,9521
1431,TSLA  ,2023-02-17,2023-12-15,105.0,321,2273,2594
1432,TSLA  ,2023-02-17,2023-12-15,110.0,679,2169,2848
1433,TSLA  ,2023-02-17,2023-12-15,115.0,1710,966,2676
1434,TSLA  ,2023-02-17,2023-12-15,120.0,1023,1358,2381
1435,TSLA  ,2023-02-17,2023-12-15,125.0,526,1577,2103
1436,TSLA  ,2023-02-17,2023-12-15,130.0,769,11312,12081
1437,TSLA  ,2023-02-17,2023-12-15,135.0,789,6084,6873
1438,TSLA  ,2023-02-17,2023-12-15,140.0,935,1850,2785
1439,TSLA  ,2023-02-17,2023-12-15,145.0,632,958,1590
1440,TSLA  ,2023-02-17,2023-12-15,150.0,1490,12414,13904
1441,TSLA  ,2023-02-17,2023-12-15,155.0,393,1046,1439
1442,TSLA  ,2023-02-17,2023-12-15,160.0,2833,10997,13830
1443,TSLA  ,2023-02-17,2023-12-15,165.0,1449,509,1958
1444,TSLA  ,2023-02-17,2023-12-15,170.0,744,4289,5033
1445,TSLA  ,2023-02-17,2023-12-15,175.0,2084,445,2529
1446,TSLA  ,2023-02-17,2023-12-15,180.0,1604,1208,2812
1447,TSLA  ,2023-02-17,2023-12-15,185.0,563,660,1223
1448,TSLA  ,2023-02-17,2023-12-15,190.0,1118,563,1681
1449,TSLA  ,2023-02-17,2023-12-15,195.0,757,970,1727
1450,TSLA  ,2023-02-17,2023-12-15,200.0,8254,1585,9839
1451,TSLA  ,2023-02-17,2023-12-15,205.0,6452,765,7217
1452,TSLA  ,2023-02-17,2023-12-15,210.0,2929,752,3681
1453,TSLA  ,2023-02-17,2023-12-15,215.0,1282,655,1937
1454,TSLA  ,2023-02-17,2023-12-15,220.0,1751,1194,2945
1455,TSLA  ,2023-02-17,2023-12-15,225.0,1908,302,2210
1456,TSLA  ,2023-02-17,2023-12-15,230.0,2291,734,3025
1457,TSLA  ,2023-02-17,2023-12-15,235.0,511,448,959
1458,TSLA  ,2023-02-17,2023-12-15,240.0,5776,712,6488
1459,TSLA  ,2023-02-17,2023-12-15,245.0,2355,514,2869
1460,TSLA  ,2023-02-17,2023-12-15,250.0,16320,3656,19976
1461,TSLA  ,2023-02-17,2023-12-15,260.0,10207,1779,11986
1462,TSLA  ,2023-02-17,2023-12-15,270.0,4005,520,4525
1463,TSLA  ,2023-02-17,2023-12-15,280.0,1441,679,2120
1464,TSLA  ,2023-02-17,2023-12-15,290.0,528,493,1021
1465,TSLA  ,2023-02-17,2023-12-15,300.0,1750,1039,2789
1466,TSLA  ,2023-02-17,2023-12-15,310.0,758,621,1379
1467,TSLA  ,2023-02-17,2023-12-15,320.0,1184,537,1721
1468,TSLA  ,2023-02-17,2023-12-15,330.0,404,232,636
1469,TSLA  ,2023-02-17,2023-12-15,340.0,347,120,467
1470,TSLA  ,2023-02-17,2023-12-15,350.0,1098,183,1281
1471,TSLA  ,2023-02-17,2023-12-15,360.0,616,117,733
1472,TSLA  ,2023-02-17,2023-12-15,370.0,109,243,352
1473,TSLA  ,2023-02-17,2023-12-15,380.0,473,321,794
1474,TSLA  ,2023-02-17,2023-12-15,390.0,1494,147,1641
1475,TSLA  ,2023-02-17,2024-01-19,1.67,2501,29762,32263
1476,TSLA  ,2023-02-17,2024-01-19,3.33,967,6101,7068
1477,TSLA  ,2023-02-17,2024-01-19,5.0,256,10602,10858
1478,TSLA  ,2023-02-17,2024-01-19,6.67,76,3334,3410
1479,TSLA  ,2023-02-17,2024-01-19,8.33,3902,2862,6764
1480,TSLA  ,2023-02-17,2024-01-19,10.0,294,4656,4950
1481,TSLA  ,2023-02-17,2024-01-19,11.67,253,3701,3954
1482,TSLA  ,2023-02-17,2024-01-19,13.33,819,507,1326
1483,TSLA  ,2023-02-17,2024-01-19,15.0,279,2063,2342
1484,TSLA  ,2023-02-17,2024-01-19,16.67,486,4672,5158
1485,TSLA  ,2023-02-17,2024-01-19,18.33,393,6118,6511
1486,TSLA  ,2023-02-17,2024-01-19,20.0,258,7607,7865
1487,TSLA  ,2023-02-17,2024-01-19,21.67,118,806,924
1488,TSLA  ,2023-02-17,2024-01-19,23.33,382,3870,4252
1489,TSLA  ,2023-02-17,2024-01-19,25.0,369,3106,3475
1490,TSLA  ,2023-02-17,2024-01-19,26.67,833,1135,1968
1491,TSLA  ,2023-02-17,2024-01-19,28.33,341,747,1088
1492,TSLA  ,2023-02-17,2024-01-19,30.0,228,8879,9107
1493,TSLA  ,2023-02-17,2024-01-19,31.67,1326,1354,2680
1494,TSLA  ,2023-02-17,2024-01-19,33.33,4315,32836,37151
1495,TSLA  ,2023-02-17,2024-01-19,50.0,2166,30847,33013
1496,TSLA  ,2023-02-17,2024-01-19,55.0,80,1480,1560
1497,TSLA  ,2023-02-17,2024-01-19,60.0,249,2616,2865
1498,TSLA  ,2023-02-17,2024-01-19,65.0,266,743,1009
1499,TSLA  ,2023-02-17,2024-01-19,66.67,4703,14827,19530
1500,TSLA  ,2023-02-17,2024-01-19,70.0,153,810,963
1501,TSLA  ,2023-02-17,2024-01-19,75.0,91,1171,1262
1502,TSLA  ,2023-02-17,2024-01-19,80.0,405,1981,2386
1503,TSLA  ,2023-02-17,2024-01-19,83.33,1064,8096,9160
1504,TSLA  ,2023-02-17,2024-01-19,85.0,511,427,938
1505,TSLA  ,2023-02-17,2024-01-19,90.0,3546,1330,4876
1506,TSLA  ,2023-02-17,2024-01-19,95.0,2979,1513,4492
1507,TSLA  ,2023-02-17,2024-01-19,100.0,13980,40430,54410
1508,TSLA  ,2023-02-17,2024-01-19,105.0,1289,2110,3399
1509,TSLA  ,2023-02-17,2024-01-19,110.0,4798,7090,11888
1510,TSLA  ,2023-02-17,2024-01-19,115.0,4689,5600,10289
1511,TSLA  ,2023-02-17,2024-01-19,116.67,1928,8371,10299
1512,TSLA  ,2023-02-17,2024-01-19,120.0,3456,6338,9794
1513,TSLA  ,2023-02-17,2024-01-19,123.33,1962,2224,4186
1514,TSLA  ,2023-02-17,2024-01-19,125.0,2402,13719,16121
1515,TSLA  ,2023-02-17,2024-01-19,126.67,1744,6620,8364
1516,TSLA  ,2023-02-17,2024-01-19,130.0,5090,11782,16872
1517,TSLA  ,2023-02-17,2024-01-19,133.33,2436,11039,13475
1518,TSLA  ,2023-02-17,2024-01-19,135.0,1326,1299,2625
1519,TSLA  ,2023-02-17,2024-01-19,136.67,2432,2315,4747
1520,TSLA  ,2023-02-17,2024-01-19,140.0,5103,4304,9407
1521,TSLA  ,2023-02-17,2024-01-19,143.33,1673,2303,3976
1522,TSLA  ,2023-02-17,2024-01-19,145.0,781,853,1634
1523,TSLA  ,2023-02-17,2024-01-19,146.67,1043,979,2022
1524,TSLA  ,2023-02-17,2024-01-19,150.0,17849,22392,40241
1525,TSLA  ,2023-02-17,2024-01-19,153.33,10511,1067,11578
1526,TSLA  ,2023-02-17,2024-01-19,155.0,550,1429,1979
1527,TSLA  ,2023-02-17,2024-01-19,156.67,1725,845,2570
1528,TSLA  ,2023-02-17,2024-01-19,160.0,3111,12319,15430
1529,TSLA  ,2023-02-17,2024-01-19,163.33,476,7431,7907
1530,TSLA  ,2023-02-17,2024-01-19,165.0,693,574,1267
1531,TSLA  ,2023-02-17,2024-01-19,166.67,6756,6865,13621
1532,TSLA  ,2023-02-17,2024-01-19,170.0,2795,6335,9130
1533,TSLA  ,2023-02-17,2024-01-19,173.33,855,2569,3424
1534,TSLA  ,2023-02-17,2024-01-19,175.0,1738,3241,4979
1535,TSLA  ,2023-02-17,2024-01-19,176.67,1020,1276,2296
1536,TSLA  ,2023-02-17,2024-01-19,180.0,39015,11168,50183
1537,TSLA  ,2023-02-17,2024-01-19,183.33,34448,7429,41877
1538,TSLA  ,2023-02-17,2024-01-19,185.0,1344,756,2100
1539,TSLA  ,2023-02-17,2024-01-19,186.67,1266,2282,3548
1540,TSLA  ,2023-02-17,2024-01-19,190.0,1658,783,2441
1541,TSLA  ,2023-02-17,2024-01-19,193.33,2294,9827,12121
1542,TSLA  ,2023-02-17,2024-01-19,195.0,709,1945,2654
1543,TSLA  ,2023-02-17,2024-01-19,200.0,33286,24243,57529
1544,TSLA  ,2023-02-17,2024-01-19,203.33,6305,2364,8669
1545,TSLA  ,2023-02-17,2024-01-19,206.67,1661,1235,2896
1546,TSLA  ,2023-02-17,2024-01-19,210.0,11277,6859,18136
1547,TSLA  ,2023-02-17,2024-01-19,213.33,1627,2688,4315
1548,TSLA  ,2023-02-17,2024-01-19,216.67,8902,6736,15638
1549,TSLA  ,2023-02-17,2024-01-19,220.0,6990,7185,14175
1550,TSLA  ,2023-02-17,2024-01-19,223.33,6076,1605,7681
1551,TSLA  ,2023-02-17,2024-01-19,226.67,20006,2986,22992
1552,TSLA  ,2023-02-17,2024-01-19,230.0,15389,18653,34042
1553,TSLA  ,2023-02-17,2024-01-19,233.33,36927,13471,50398
1554,TSLA  ,2023-02-17,2024-01-19,236.67,2001,1700,3701
1555,TSLA  ,2023-02-17,2024-01-19,240.0,4540,3762,8302
1556,TSLA  ,2023-02-17,2024-01-19,243.33,1268,2021,3289
1557,TSLA  ,2023-02-17,2024-01-19,246.67,1165,2110,3275
1558,TSLA  ,2023-02-17,2024-01-19,250.0,22065,5362,27427
1559,TSLA  ,2023-02-17,2024-01-19,253.33,2853,2090,4943
1560,TSLA  ,2023-02-17,2024-01-19,256.67,2825,1640,4465
1561,TSLA  ,2023-02-17,2024-01-19,260.0,7531,3239,10770
1562,TSLA  ,2023-02-17,2024-01-19,263.33,7757,2158,9915
1563,TSLA  ,2023-02-17,2024-01-19,266.67,10207,8798,19005
1564,TSLA  ,2023-02-17,2024-01-19,270.0,4598,5205,9803
1565,TSLA  ,2023-02-17,2024-01-19,273.33,3398,3092,6490
1566,TSLA  ,2023-02-17,2024-01-19,276.67,1956,1764,3720
1567,TSLA  ,2023-02-17,2024-01-19,280.0,9249,6503,15752
1568,TSLA  ,2023-02-17,2024-01-19,283.33,3144,3089,6233
1569,TSLA  ,2023-02-17,2024-01-19,286.67,2475,1509,3984
1570,TSLA  ,2023-02-17,2024-01-19,290.0,9087,576,9663
1571,TSLA  ,2023-02-17,2024-01-19,293.33,2904,1990,4894
1572,TSLA  ,2023-02-17,2024-01-19,296.67,2177,1688,3865
1573,TSLA  ,2023-02-17,2024-01-19,300.0,26325,6204,32529
1574,TSLA  ,2023-02-17,2024-01-19,303.33,3446,290,3736
1575,TSLA  ,2023-02-17,2024-01-19,306.67,6579,133,6712
1576,TSLA  ,2023-02-17,2024-01-19,310.0,3706,1021,4727
1577,TSLA  ,2023-02-17,2024-01-19,313.33,1201,27,1228
1578,TSLA  ,2023-02-17,2024-01-19,316.67,4149,306,4455
1579,TSLA  ,2023-02-17,2024-01-19,320.0,6204,321,6525
1580,TSLA  ,2023-02-17,2024-01-19,323.33,452,268,720
1581,TSLA  ,2023-02-17,2024-01-19,325.0,10244,135,10379
1582,TSLA  ,2023-02-17,2024-01-19,326.67,1373,630,2003
1583,TSLA  ,2023-02-17,2024-01-19,330.0,7487,11,7498
1584,TSLA  ,2023-02-17,2024-01-19,333.33,30410,1851,32261
1585,TSLA  ,2023-02-17,2024-01-19,336.67,1469,7,1476
1586,TSLA  ,2023-02-17,2024-01-19,340.0,3794,5,3799
1587,TSLA  ,2023-02-17,2024-01-19,341.67,905,10,915
1588,TSLA  ,2023-02-17,2024-01-19,343.33,552,0,552
1589,TSLA  ,2023-02-17,2024-01-19,346.67,2398,3,2401
1590,TSLA  ,2023-02-17,2024-01-19,350.0,15699,761,16460
1591,TSLA  ,2023-02-17,2024-01-19,353.33,1162,0,1162
1592,TSLA  ,2023-02-17,2024-01-19,356.67,902,0,902
1593,TSLA  ,2023-02-17,2024-01-19,358.33,1240,3,1243
1594,TSLA  ,2023-02-17,2024-01-19,360.0,9201,600,9801
1595,TSLA  ,2023-02-17,2024-01-19,363.33,516,7,523
1596,TSLA  ,2023-02-17,2024-01-19,366.67,38806,2807,41613
1597,TSLA  ,2023-02-17,2024-01-19,370.0,5997,4,6001
1598,TSLA  ,2023-02-17,2024-01-19,373.33,1058,12,1070
1599,TSLA  ,2023-02-17,2024-01-19,375.0,11416,8,11424
1600,TSLA  ,2023-02-17,2024-01-19,376.67,573,106,679
1601,TSLA  ,2023-02-17,2024-01-19,380.0,1095,2,1097
1602,TSLA  ,2023-02-17,2024-01-19,383.33,3090,2,3092
1603,TSLA  ,2023-02-17,2024-01-19,386.67,409,203,612
1604,TSLA  ,2023-02-17,2024-01-19,390.0,944,1,945
1605,TSLA  ,2023-02-17,2024-01-19,391.67,2333,1,2334
1606,TSLA  ,2023-02-17,2024-01-19,393.33,519,4,523
1607,TSLA  ,2023-02-17,2024-01-19,396.67,2707,0,2707
1608,TSLA  ,2023-02-17,2024-01-19,400.0,40895,1002,41897
1609,TSLA  ,2023-02-17,2024-01-19,408.33,5169,21,5190
1610,TSLA  ,2023-02-17,2024-01-19,416.67,4048,2172,6220
1611,TSLA  ,2023-02-17,2024-01-19,425.0,4501,18,4519
1612,TSLA  ,2023-02-17,2024-01-19,433.33,5780,3,5783
1613,TSLA  ,2023-02-17,2024-01-19,441.67,1298,0,1298
1614,TSLA  ,2023-02-17,2024-01-19,450.0,8034,2427,10461
1615,TSLA  ,2023-02-17,2024-01-19,458.33,2000,0,2000
1616,TSLA  ,2023-02-17,2024-01-19,466.67,27800,0,27800
1617,TSLA  ,2023-02-17,2024-01-19,475.0,5172,195,5367
1618,TSLA  ,2023-02-17,2024-01-19,483.33,1583,20,1603
1619,TSLA  ,2023-02-17,2024-01-19,491.67,2152,0,2152
1620,TSLA  ,2023-02-17,2024-01-19,500.0,36520,170,36690
1621,TSLA  ,2023-02-17,2024-01-19,516.67,4831,215,5046
1622,TSLA  ,2023-02-17,2024-01-19,533.33,22300,0,22300
1623,TSLA  ,2023-02-17,2024-01-19,550.0,16368,0,16368
1624,TSLA  ,2023-02-17,2024-01-19,558.33,1185,0,1185
1625,TSLA  ,2023-02-17,2024-01-19,566.67,12906,0,12906
1626,TSLA  ,2023-02-17,2024-01-19,575.0,13851,0,13851
1627,TSLA  ,2023-02-17,2024-01-19,583.33,13821,0,13821
1628,TSLA  ,2023-02-17,2024-01-19,591.67,2277,0,2277
1629,TSLA  ,2023-02-17,2024-01-19,600.0,18593,0,18593
1630,TSLA  ,2023-02-17,2024-01-19,608.33,2279,0,2279
1631,TSLA  ,2023-02-17,2024-01-19,616.67,11852,0,11852
1632,TSLA  ,2023-02-17,2024-01-19,625.0,2414,0,2414
1633,TSLA  ,2023-02-17,2024-01-19,633.33,5738,0,5738
1634,TSLA  ,2023-02-17,2024-01-19,641.67,929,0,929
1635,TSLA  ,2023-02-17,2024-01-19,650.0,3207,0,3207
1636,TSLA  ,2023-02-17,2024-01-19,666.67,40734,0,40734
1637,TSLA  ,2023-02-17,2024-01-19,675.0,4355,0,4355
1638,TSLA  ,2023-02-17,2024-01-19,683.33,7131,0,7131
1639,TSLA  ,2023-02-17,2024-01-19,691.67,1565,0,1565
1640,TSLA  ,2023-02-17,2024-01-19,700.0,5368,0,5368
1641,TSLA  ,2023-02-17,2024-01-19,708.33,761,0,761
1642,TSLA  ,2023-02-17,2024-01-19,716.67,6075,0,6075
1643,TSLA  ,2023-02-17,2024-01-19,725.0,2693,3,2696
1644,TSLA  ,2023-02-17,2024-01-19,733.33,3399,0,3399
1645,TSLA  ,2023-02-17,2024-01-19,741.67,805,0,805
1646,TSLA  ,2023-02-17,2024-01-19,750.0,2366,0,2366
1647,TSLA  ,2023-02-17,2024-01-19,758.33,932,0,932
1648,TSLA  ,2023-02-17,2024-01-19,766.67,2114,0,2114
1649,TSLA  ,2023-02-17,2024-01-19,775.0,2809,0,2809
1650,TSLA  ,2023-02-17,2024-01-19,783.33,693,0,693
1651,TSLA  ,2023-02-17,2024-01-19,791.67,3181,0,3181
1652,TSLA  ,2023-02-17,2024-01-19,800.0,13801,0,13801
1653,TSLA  ,2023-02-17,2024-01-19,808.33,3927,0,3927
1654,TSLA  ,2023-02-17,2024-01-19,816.67,5811,0,5811
1655,TSLA  ,2023-02-17,2024-01-19,825.0,75923,0,75923
1656,TSLA  ,2023-02-17,2024-03-15,1.67,107,1894,2001
1657,TSLA  ,2023-02-17,2024-03-15,3.33,22,769,791
1658,TSLA  ,2023-02-17,2024-03-15,5.0,64,895,959
1659,TSLA  ,2023-02-17,2024-03-15,6.67,6,93,99
1660,TSLA  ,2023-02-17,2024-03-15,8.33,16,42,58
1661,TSLA  ,2023-02-17,2024-03-15,10.0,6,313,319
1662,TSLA  ,2023-02-17,2024-03-15,11.67,11,419,430
1663,TSLA  ,2023-02-17,2024-03-15,13.33,18,55,73
1664,TSLA  ,2023-02-17,2024-03-15,15.0,24,380,404
1665,TSLA  ,2023-02-17,2024-03-15,16.67,124,230,354
1666,TSLA  ,2023-02-17,2024-03-15,33.33,809,2000,2809
1667,TSLA  ,2023-02-17,2024-03-15,50.0,449,5787,6236
1668,TSLA  ,2023-02-17,2024-03-15,55.0,30,301,331
1669,TSLA  ,2023-02-17,2024-03-15,60.0,45,857,902
1670,TSLA  ,2023-02-17,2024-03-15,65.0,31,828,859
1671,TSLA  ,2023-02-17,2024-03-15,66.67,2035,1011,3046
1672,TSLA  ,2023-02-17,2024-03-15,70.0,50,238,288
1673,TSLA  ,2023-02-17,2024-03-15,75.0,20,401,421
1674,TSLA  ,2023-02-17,2024-03-15,80.0,191,553,744
1675,TSLA  ,2023-02-17,2024-03-15,83.33,998,4511,5509
1676,TSLA  ,2023-02-17,2024-03-15,85.0,291,214,505
1677,TSLA  ,2023-02-17,2024-03-15,90.0,744,771,1515
1678,TSLA  ,2023-02-17,2024-03-15,95.0,1561,411,1972
1679,TSLA  ,2023-02-17,2024-03-15,100.0,3355,3191,6546
1680,TSLA  ,2023-02-17,2024-03-15,105.0,819,724,1543
1681,TSLA  ,2023-02-17,2024-03-15,110.0,912,2520,3432
1682,TSLA  ,2023-02-17,2024-03-15,115.0,2046,197,2243
1683,TSLA  ,2023-02-17,2024-03-15,116.67,609,1031,1640
1684,TSLA  ,2023-02-17,2024-03-15,120.0,327,623,950
1685,TSLA  ,2023-02-17,2024-03-15,125.0,793,741,1534
1686,TSLA  ,2023-02-17,2024-03-15,130.0,1555,539,2094
1687,TSLA  ,2023-02-17,2024-03-15,133.33,590,5693,6283
1688,TSLA  ,2023-02-17,2024-03-15,135.0,206,232,438
1689,TSLA  ,2023-02-17,2024-03-15,140.0,221,270,491
1690,TSLA  ,2023-02-17,2024-03-15,141.67,562,325,887
1691,TSLA  ,2023-02-17,2024-03-15,145.0,299,382,681
1692,TSLA  ,2023-02-17,2024-03-15,150.0,1302,4448,5750
1693,TSLA  ,2023-02-17,2024-03-15,155.0,88,207,295
1694,TSLA  ,2023-02-17,2024-03-15,158.33,173,583,756
1695,TSLA  ,2023-02-17,2024-03-15,160.0,237,4380,4617
1696,TSLA  ,2023-02-17,2024-03-15,165.0,151,3903,4054
1697,TSLA  ,2023-02-17,2024-03-15,166.67,587,1181,1768
1698,TSLA  ,2023-02-17,2024-03-15,170.0,285,8894,9179
1699,TSLA  ,2023-02-17,2024-03-15,175.0,726,1943,2669
1700,TSLA  ,2023-02-17,2024-03-15,180.0,283,645,928
1701,TSLA  ,2023-02-17,2024-03-15,183.33,514,1146,1660
1702,TSLA  ,2023-02-17,2024-03-15,185.0,252,150,402
1703,TSLA  ,2023-02-17,2024-03-15,190.0,207,272,479
1704,TSLA  ,2023-02-17,2024-03-15,191.67,677,1383,2060
1705,TSLA  ,2023-02-17,2024-03-15,195.0,552,133,685
1706,TSLA  ,2023-02-17,2024-03-15,200.0,5253,4725,9978
1707,TSLA  ,2023-02-17,2024-03-15,208.33,1200,731,1931
1708,TSLA  ,2023-02-17,2024-03-15,210.0,505,194,699
1709,TSLA  ,2023-02-17,2024-03-15,216.67,1485,839,2324
1710,TSLA  ,2023-02-17,2024-03-15,220.0,526,64,590
1711,TSLA  ,2023-02-17,2024-03-15,225.0,2330,2421,4751
1712,TSLA  ,2023-02-17,2024-03-15,230.0,280,84,364
1713,TSLA  ,2023-02-17,2024-03-15,233.33,1623,996,2619
1714,TSLA  ,2023-02-17,2024-03-15,240.0,189,50,239
1715,TSLA  ,2023-02-17,2024-03-15,241.67,1107,955,2062
1716,TSLA  ,2023-02-17,2024-03-15,250.0,2157,1406,3563
1717,TSLA  ,2023-02-17,2024-03-15,258.33,4133,1036,5169
1718,TSLA  ,2023-02-17,2024-03-15,260.0,575,97,672
1719,TSLA  ,2023-02-17,2024-03-15,266.67,4463,810,5273
1720,TSLA  ,2023-02-17,2024-03-15,270.0,309,3,312
1721,TSLA  ,2023-02-17,2024-03-15,275.0,8967,1011,9978
1722,TSLA  ,2023-02-17,2024-03-15,280.0,115,85,200
1723,TSLA  ,2023-02-17,2024-03-15,283.33,1145,709,1854
1724,TSLA  ,2023-02-17,2024-03-15,290.0,14,4,18
1725,TSLA  ,2023-02-17,2024-03-15,291.67,1288,129,1417
1726,TSLA  ,2023-02-17,2024-03-15,300.0,4875,704,5579
1727,TSLA  ,2023-02-17,2024-03-15,308.33,406,40,446
1728,TSLA  ,2023-02-17,2024-03-15,310.0,17,0,17
1729,TSLA  ,2023-02-17,2024-03-15,316.67,934,390,1324
1730,TSLA  ,2023-02-17,2024-03-15,325.0,1576,16,1592
1731,TSLA  ,2023-02-17,2024-03-15,333.33,1043,24,1067
1732,TSLA  ,2023-02-17,2024-03-15,341.67,294,45,339
1733,TSLA  ,2023-02-17,2024-03-15,350.0,872,82,954
1734,TSLA  ,2023-02-17,2024-03-15,358.33,462,69,531
1735,TSLA  ,2023-02-17,2024-03-15,366.67,535,250,785
1736,TSLA  ,2023-02-17,2024-03-15,375.0,782,2,784
1737,TSLA  ,2023-02-17,2024-03-15,383.33,194,1338,1532
1738,TSLA  ,2023-02-17,2024-03-15,391.67,319,8,327
1739,TSLA  ,2023-02-17,2024-03-15,400.0,1247,221,1468
1740,TSLA  ,2023-02-17,2024-03-15,408.33,616,53,669
1741,TSLA  ,2023-02-17,2024-03-15,416.67,367,366,733
1742,TSLA  ,2023-02-17,2024-03-15,425.0,891,48,939
1743,TSLA  ,2023-02-17,2024-03-15,433.33,566,0,566
1744,TSLA  ,2023-02-17,2024-03-15,441.67,170,0,170
1745,TSLA  ,2023-02-17,2024-03-15,450.0,1467,0,1467
1746,TSLA  ,2023-02-17,2024-03-15,458.33,243,2,245
1747,TSLA  ,2023-02-17,2024-03-15,466.67,821,0,821
1748,TSLA  ,2023-02-17,2024-03-15,475.0,423,0,423
1749,TSLA  ,2023-02-17,2024-03-15,483.33,487,0,487
1750,TSLA  ,2023-02-17,2024-03-15,491.67,319,0,319
1751,TSLA  ,2023-02-17,2024-03-15,500.0,2942,0,2942
1752,TSLA  ,2023-02-17,2024-03-15,508.33,227,0,227
1753,TSLA  ,2023-02-17,2024-03-15,516.67,690,0,690
1754,TSLA  ,2023-02-17,2024-03-15,525.0,118,0,118
1755,TSLA  ,2023-02-17,2024-03-15,533.33,221,0,221
1756,TSLA  ,2023-02-17,2024-03-15,541.67,165,0,165
1757,TSLA  ,2023-02-17,2024-03-15,550.0,539,0,539
1758,TSLA  ,2023-02-17,2024-03-15,558.33,264,0,264
1759,TSLA  ,2023-02-17,2024-03-15,566.67,385,0,385
1760,TSLA  ,2023-02-17,2024-03-15,575.0,668,0,668
1761,TSLA  ,2023-02-17,2024-03-15,583.33,490,0,490
1762,TSLA  ,2023-02-17,2024-03-15,600.0,3913,1,3914
1763,TSLA  ,2023-02-17,2024-06-21,1.67,629,16452,17081
1764,TSLA  ,2023-02-17,2024-06-21,3.33,149,3279,3428
1765,TSLA  ,2023-02-17,2024-06-21,5.0,20,1518,1538
1766,TSLA  ,2023-02-17,2024-06-21,6.67,219,1218,1437
1767,TSLA  ,2023-02-17,2024-06-21,8.33,121,368,489
1768,TSLA  ,2023-02-17,2024-06-21,10.0,275,1827,2102
1769,TSLA  ,2023-02-17,2024-06-21,11.67,540,336,876
1770,TSLA  ,2023-02-17,2024-06-21,13.33,39,217,256
1771,TSLA  ,2023-02-17,2024-06-21,16.67,1407,3533,4940
1772,TSLA  ,2023-02-17,2024-06-21,33.33,7801,5342,13143
1773,TSLA  ,2023-02-17,2024-06-21,50.0,1916,3815,5731
1774,TSLA  ,2023-02-17,2024-06-21,55.0,6,383,389
1775,TSLA  ,2023-02-17,2024-06-21,60.0,57,491,548
1776,TSLA  ,2023-02-17,2024-06-21,65.0,111,2124,2235
1777,TSLA  ,2023-02-17,2024-06-21,66.67,1877,4359,6236
1778,TSLA  ,2023-02-17,2024-06-21,70.0,48,250,298
1779,TSLA  ,2023-02-17,2024-06-21,75.0,74,196,270
1780,TSLA  ,2023-02-17,2024-06-21,80.0,113,1455,1568
1781,TSLA  ,2023-02-17,2024-06-21,83.33,30601,4178,34779
1782,TSLA  ,2023-02-17,2024-06-21,85.0,60,862,922
1783,TSLA  ,2023-02-17,2024-06-21,90.0,532,1172,1704
1784,TSLA  ,2023-02-17,2024-06-21,95.0,363,428,791
1785,TSLA  ,2023-02-17,2024-06-21,100.0,5363,9888,15251
1786,TSLA  ,2023-02-17,2024-06-21,105.0,798,907,1705
1787,TSLA  ,2023-02-17,2024-06-21,110.0,495,2225,2720
1788,TSLA  ,2023-02-17,2024-06-21,115.0,414,254,668
1789,TSLA  ,2023-02-17,2024-06-21,116.67,2477,1020,3497
1790,TSLA  ,2023-02-17,2024-06-21,120.0,559,1204,1763
1791,TSLA  ,2023-02-17,2024-06-21,123.33,643,3524,4167
1792,TSLA  ,2023-02-17,2024-06-21,125.0,162,2240,2402
1793,TSLA  ,2023-02-17,2024-06-21,126.67,668,1272,1940
1794,TSLA  ,2023-02-17,2024-06-21,130.0,839,1810,2649
1795,TSLA  ,2023-02-17,2024-06-21,133.33,1922,2858,4780
1796,TSLA  ,2023-02-17,2024-06-21,135.0,63,365,428
1797,TSLA  ,2023-02-17,2024-06-21,136.67,425,1838,2263
1798,TSLA  ,2023-02-17,2024-06-21,140.0,1500,2592,4092
1799,TSLA  ,2023-02-17,2024-06-21,143.33,1405,1686,3091
1800,TSLA  ,2023-02-17,2024-06-21,145.0,602,217,819
1801,TSLA  ,2023-02-17,2024-06-21,146.67,1642,563,2205
1802,TSLA  ,2023-02-17,2024-06-21,150.0,4377,9844,14221
1803,TSLA  ,2023-02-17,2024-06-21,153.33,289,831,1120
1804,TSLA  ,2023-02-17,2024-06-21,155.0,84,438,522
1805,TSLA  ,2023-02-17,2024-06-21,156.67,383,222,605
1806,TSLA  ,2023-02-17,2024-06-21,160.0,882,2736,3618
1807,TSLA  ,2023-02-17,2024-06-21,163.33,185,1412,1597
1808,TSLA  ,2023-02-17,2024-06-21,165.0,351,896,1247
1809,TSLA  ,2023-02-17,2024-06-21,166.67,1730,5525,7255
1810,TSLA  ,2023-02-17,2024-06-21,170.0,301,877,1178
1811,TSLA  ,2023-02-17,2024-06-21,173.33,595,5868,6463
1812,TSLA  ,2023-02-17,2024-06-21,175.0,942,395,1337
1813,TSLA  ,2023-02-17,2024-06-21,180.0,1357,6722,8079
1814,TSLA  ,2023-02-17,2024-06-21,183.33,931,3709,4640
1815,TSLA  ,2023-02-17,2024-06-21,185.0,292,237,529
1816,TSLA  ,2023-02-17,2024-06-21,186.67,1322,1656,2978
1817,TSLA  ,2023-02-17,2024-06-21,190.0,339,116,455
1818,TSLA  ,2023-02-17,2024-06-21,193.33,1020,4297,5317
1819,TSLA  ,2023-02-17,2024-06-21,195.0,273,913,1186
1820,TSLA  ,2023-02-17,2024-06-21,200.0,4734,9883,14617
1821,TSLA  ,2023-02-17,2024-06-21,206.67,1071,2902,3973
1822,TSLA  ,2023-02-17,2024-06-21,210.0,428,136,564
1823,TSLA  ,2023-02-17,2024-06-21,213.33,826,1202,2028
1824,TSLA  ,2023-02-17,2024-06-21,216.67,1642,5370,7012
1825,TSLA  ,2023-02-17,2024-06-21,220.0,2479,2408,4887
1826,TSLA  ,2023-02-17,2024-06-21,226.67,2598,3506,6104
1827,TSLA  ,2023-02-17,2024-06-21,230.0,519,134,653
1828,TSLA  ,2023-02-17,2024-06-21,233.33,6663,7246,13909
1829,TSLA  ,2023-02-17,2024-06-21,240.0,2134,4867,7001
1830,TSLA  ,2023-02-17,2024-06-21,246.67,2259,1234,3493
1831,TSLA  ,2023-02-17,2024-06-21,250.0,5457,3586,9043
1832,TSLA  ,2023-02-17,2024-06-21,253.33,1310,851,2161
1833,TSLA  ,2023-02-17,2024-06-21,260.0,2077,952,3029
1834,TSLA  ,2023-02-17,2024-06-21,266.67,10105,3339,13444
1835,TSLA  ,2023-02-17,2024-06-21,270.0,1452,1885,3337
1836,TSLA  ,2023-02-17,2024-06-21,273.33,1255,792,2047
1837,TSLA  ,2023-02-17,2024-06-21,276.67,1022,810,1832
1838,TSLA  ,2023-02-17,2024-06-21,280.0,1242,1601,2843
1839,TSLA  ,2023-02-17,2024-06-21,283.33,3609,1362,4971
1840,TSLA  ,2023-02-17,2024-06-21,286.67,994,768,1762
1841,TSLA  ,2023-02-17,2024-06-21,290.0,2331,1161,3492
1842,TSLA  ,2023-02-17,2024-06-21,293.33,1112,967,2079
1843,TSLA  ,2023-02-17,2024-06-21,296.67,1020,360,1380
1844,TSLA  ,2023-02-17,2024-06-21,300.0,9314,839,10153
1845,TSLA  ,2023-02-17,2024-06-21,303.33,1418,687,2105
1846,TSLA  ,2023-02-17,2024-06-21,306.67,1489,247,1736
1847,TSLA  ,2023-02-17,2024-06-21,310.0,1822,519,2341
1848,TSLA  ,2023-02-17,2024-06-21,313.33,1246,720,1966
1849,TSLA  ,2023-02-17,2024-06-21,316.67,2375,28,2403
1850,TSLA  ,2023-02-17,2024-06-21,320.0,696,651,1347
1851,TSLA  ,2023-02-17,2024-06-21,323.33,457,309,766
1852,TSLA  ,2023-02-17,2024-06-21,326.67,573,274,847
1853,TSLA  ,2023-02-17,2024-06-21,330.0,2725,126,2851
1854,TSLA  ,2023-02-17,2024-06-21,333.33,7543,1108,8651
1855,TSLA  ,2023-02-17,2024-06-21,336.67,2308,238,2546
1856,TSLA  ,2023-02-17,2024-06-21,340.0,781,80,861
1857,TSLA  ,2023-02-17,2024-06-21,343.33,1220,90,1310
1858,TSLA  ,2023-02-17,2024-06-21,346.67,399,71,470
1859,TSLA  ,2023-02-17,2024-06-21,350.0,3416,7,3423
1860,TSLA  ,2023-02-17,2024-06-21,353.33,199,70,269
1861,TSLA  ,2023-02-17,2024-06-21,356.67,479,50,529
1862,TSLA  ,2023-02-17,2024-06-21,360.0,2634,12,2646
1863,TSLA  ,2023-02-17,2024-06-21,363.33,360,0,360
1864,TSLA  ,2023-02-17,2024-06-21,366.67,4714,0,4714
1865,TSLA  ,2023-02-17,2024-06-21,370.0,3066,9,3075
1866,TSLA  ,2023-02-17,2024-06-21,373.33,561,1,562
1867,TSLA  ,2023-02-17,2024-06-21,376.67,804,0,804
1868,TSLA  ,2023-02-17,2024-06-21,380.0,1048,1,1049
1869,TSLA  ,2023-02-17,2024-06-21,383.33,1014,12,1026
1870,TSLA  ,2023-02-17,2024-06-21,386.67,297,7,304
1871,TSLA  ,2023-02-17,2024-06-21,390.0,436,3,439
1872,TSLA  ,2023-02-17,2024-06-21,393.33,865,2,867
1873,TSLA  ,2023-02-17,2024-06-21,396.67,777,2,779
1874,TSLA  ,2023-02-17,2024-06-21,400.0,38683,35,38718
1875,TSLA  ,2023-02-17,2024-06-21,416.67,3184,1,3185
1876,TSLA  ,2023-02-17,2024-06-21,433.33,3272,0,3272
1877,TSLA  ,2023-02-17,2024-06-21,450.0,3045,0,3045
1878,TSLA  ,2023-02-17,2024-06-21,466.67,5444,0,5444
1879,TSLA  ,2023-02-17,2024-06-21,483.33,1178,0,1178
1880,TSLA  ,2023-02-17,2024-06-21,500.0,11114,0,11114
1881,TSLA  ,2023-02-17,2024-06-21,516.67,2090,0,2090
1882,TSLA  ,2023-02-17,2024-06-21,533.33,3104,0,3104
1883,TSLA  ,2023-02-17,2024-06-21,550.0,2627,0,2627
1884,TSLA  ,2023-02-17,2024-06-21,566.67,1007,0,1007
1885,TSLA  ,2023-02-17,2024-06-21,583.33,1038,0,1038
1886,TSLA  ,2023-02-17,2024-06-21,600.0,17203,0,17203
1887,TSLA  ,2023-02-17,2024-06-21,616.67,14010,0,14010
1888,TSLA  ,2023-02-17,2024-06-21,633.33,4532,0,4532
1889,TSLA  ,2023-02-17,2024-06-21,650.0,623,0,623
1890,TSLA  ,2023-02-17,2024-06-21,666.67,6553,0,6553
1891,TSLA  ,2023-02-17,2024-06-21,683.33,1687,0,1687
1892,TSLA  ,2023-02-17,2024-06-21,700.0,3969,0,3969
1893,TSLA  ,2023-02-17,2024-06-21,716.67,903,0,903
1894,TSLA  ,2023-02-17,2024-06-21,733.33,2125,0,2125
1895,TSLA  ,2023-02-17,2024-06-21,750.0,5776,1,5777
1896,TSLA  ,2023-02-17,2024-06-21,758.33,14311,0,14311
1897,TSLA  ,2023-02-17,2024-09-20,50.0,45,942,987
1898,TSLA  ,2023-02-17,2024-09-20,55.0,29,177,206
1899,TSLA  ,2023-02-17,2024-09-20,60.0,10,146,156
1900,TSLA  ,2023-02-17,2024-09-20,65.0,39,79,118
1901,TSLA  ,2023-02-17,2024-09-20,70.0,11,136,147
1902,TSLA  ,2023-02-17,2024-09-20,75.0,10,2323,2333
1903,TSLA  ,2023-02-17,2024-09-20,80.0,66,139,205
1904,TSLA  ,2023-02-17,2024-09-20,85.0,987,454,1441
1905,TSLA  ,2023-02-17,2024-09-20,90.0,47,186,233
1906,TSLA  ,2023-02-17,2024-09-20,95.0,22,441,463
1907,TSLA  ,2023-02-17,2024-09-20,100.0,384,2226,2610
1908,TSLA  ,2023-02-17,2024-09-20,105.0,188,724,912
1909,TSLA  ,2023-02-17,2024-09-20,110.0,163,1097,1260
1910,TSLA  ,2023-02-17,2024-09-20,115.0,563,603,1166
1911,TSLA  ,2023-02-17,2024-09-20,120.0,718,551,1269
1912,TSLA  ,2023-02-17,2024-09-20,125.0,321,1201,1522
1913,TSLA  ,2023-02-17,2024-09-20,130.0,636,840,1476
1914,TSLA  ,2023-02-17,2024-09-20,135.0,580,271,851
1915,TSLA  ,2023-02-17,2024-09-20,140.0,1094,343,1437
1916,TSLA  ,2023-02-17,2024-09-20,145.0,1292,355,1647
1917,TSLA  ,2023-02-17,2024-09-20,150.0,1439,2723,4162
1918,TSLA  ,2023-02-17,2024-09-20,155.0,529,296,825
1919,TSLA  ,2023-02-17,2024-09-20,160.0,429,821,1250
1920,TSLA  ,2023-02-17,2024-09-20,165.0,279,110,389
1921,TSLA  ,2023-02-17,2024-09-20,170.0,205,277,482
1922,TSLA  ,2023-02-17,2024-09-20,175.0,235,126,361
1923,TSLA  ,2023-02-17,2024-09-20,180.0,729,85,814
1924,TSLA  ,2023-02-17,2024-09-20,185.0,829,917,1746
1925,TSLA  ,2023-02-17,2024-09-20,190.0,1495,125,1620
1926,TSLA  ,2023-02-17,2024-09-20,195.0,1418,118,1536
1927,TSLA  ,2023-02-17,2024-09-20,200.0,1760,1492,3252
1928,TSLA  ,2023-02-17,2024-09-20,210.0,776,269,1045
1929,TSLA  ,2023-02-17,2024-09-20,220.0,1405,423,1828
1930,TSLA  ,2023-02-17,2024-09-20,230.0,706,120,826
1931,TSLA  ,2023-02-17,2024-09-20,240.0,455,306,761
1932,TSLA  ,2023-02-17,2024-09-20,250.0,869,366,1235
1933,TSLA  ,2023-02-17,2024-09-20,260.0,904,70,974
1934,TSLA  ,2023-02-17,2024-09-20,270.0,622,534,1156
1935,TSLA  ,2023-02-17,2024-09-20,280.0,326,578,904
1936,TSLA  ,2023-02-17,2024-09-20,290.0,467,2810,3277
1937,TSLA  ,2023-02-17,2024-09-20,300.0,1077,1166,2243
1938,TSLA  ,2023-02-17,2024-09-20,310.0,179,786,965
1939,TSLA  ,2023-02-17,2024-09-20,320.0,112,259,371
1940,TSLA  ,2023-02-17,2024-09-20,330.0,109,117,226
1941,TSLA  ,2023-02-17,2024-09-20,340.0,704,110,814
1942,TSLA  ,2023-02-17,2024-09-20,350.0,1443,110,1553
1943,TSLA  ,2023-02-17,2024-09-20,360.0,56,63,119
1944,TSLA  ,2023-02-17,2024-09-20,370.0,80,3,83
1945,TSLA  ,2023-02-17,2024-09-20,380.0,94,1,95
1946,TSLA  ,2023-02-17,2024-09-20,390.0,245,17,262
1947,TSLA  ,2023-02-17,2025-01-17,5.0,659,11531,12190
1948,TSLA  ,2023-02-17,2025-01-17,10.0,139,874,1013
1949,TSLA  ,2023-02-17,2025-01-17,15.0,29,862,891
1950,TSLA  ,2023-02-17,2025-01-17,20.0,385,5806,6191
1951,TSLA  ,2023-02-17,2025-01-17,25.0,103,2532,2635
1952,TSLA  ,2023-02-17,2025-01-17,30.0,13822,16560,30382
1953,TSLA  ,2023-02-17,2025-01-17,35.0,265,1151,1416
1954,TSLA  ,2023-02-17,2025-01-17,40.0,14708,15783,30491
1955,TSLA  ,2023-02-17,2025-01-17,45.0,2979,3196,6175
1956,TSLA  ,2023-02-17,2025-01-17,50.0,2725,8549,11274
1957,TSLA  ,2023-02-17,2025-01-17,55.0,2004,4257,6261
1958,TSLA  ,2023-02-17,2025-01-17,60.0,592,1961,2553
1959,TSLA  ,2023-02-17,2025-01-17,65.0,1640,1573,3213
1960,TSLA  ,2023-02-17,2025-01-17,70.0,2496,2201,4697
1961,TSLA  ,2023-02-17,2025-01-17,75.0,177,4310,4487
1962,TSLA  ,2023-02-17,2025-01-17,80.0,1306,1858,3164
1963,TSLA  ,2023-02-17,2025-01-17,85.0,1827,1608,3435
1964,TSLA  ,2023-02-17,2025-01-17,90.0,1125,5530,6655
1965,TSLA  ,2023-02-17,2025-01-17,95.0,139,504,643
1966,TSLA  ,2023-02-17,2025-01-17,100.0,5430,17709,23139
1967,TSLA  ,2023-02-17,2025-01-17,105.0,320,1667,1987
1968,TSLA  ,2023-02-17,2025-01-17,110.0,5450,7130,12580
1969,TSLA  ,2023-02-17,2025-01-17,115.0,3622,3632,7254
1970,TSLA  ,2023-02-17,2025-01-17,120.0,8396,6128,14524
1971,TSLA  ,2023-02-17,2025-01-17,125.0,2159,1167,3326
1972,TSLA  ,2023-02-17,2025-01-17,130.0,5625,7181,12806
1973,TSLA  ,2023-02-17,2025-01-17,135.0,5700,694,6394
1974,TSLA  ,2023-02-17,2025-01-17,140.0,8630,4670,13300
1975,TSLA  ,2023-02-17,2025-01-17,145.0,766,688,1454
1976,TSLA  ,2023-02-17,2025-01-17,150.0,11963,12135,24098
1977,TSLA  ,2023-02-17,2025-01-17,155.0,428,500,928
1978,TSLA  ,2023-02-17,2025-01-17,160.0,4623,5533,10156
1979,TSLA  ,2023-02-17,2025-01-17,165.0,260,954,1214
1980,TSLA  ,2023-02-17,2025-01-17,170.0,35390,10287,45677
1981,TSLA  ,2023-02-17,2025-01-17,175.0,33440,4516,37956
1982,TSLA  ,2023-02-17,2025-01-17,180.0,4033,8066,12099
1983,TSLA  ,2023-02-17,2025-01-17,185.0,7133,4530,11663
1984,TSLA  ,2023-02-17,2025-01-17,190.0,5683,4780,10463
1985,TSLA  ,2023-02-17,2025-01-17,195.0,3230,1727,4957
1986,TSLA  ,2023-02-17,2025-01-17,200.0,29287,12589,41876
1987,TSLA  ,2023-02-17,2025-01-17,210.0,5374,2745,8119
1988,TSLA  ,2023-02-17,2025-01-17,220.0,3152,4088,7240
1989,TSLA  ,2023-02-17,2025-01-17,230.0,4240,3299,7539
1990,TSLA  ,2023-02-17,2025-01-17,240.0,4706,4749,9455
1991,TSLA  ,2023-02-17,2025-01-17,250.0,11812,5227,17039
1992,TSLA  ,2023-02-17,2025-01-17,260.0,5613,1821,7434
1993,TSLA  ,2023-02-17,2025-01-17,270.0,3104,1319,4423
1994,TSLA  ,2023-02-17,2025-01-17,280.0,2243,3339,5582
1995,TSLA  ,2023-02-17,2025-01-17,290.0,3456,2807,6263
1996,TSLA  ,2023-02-17,2025-01-17,300.0,30470,3053,33523
1997,TSLA  ,2023-02-17,2025-01-17,310.0,4383,711,5094
1998,TSLA  ,2023-02-17,2025-01-17,320.0,2112,850,2962
1999,TSLA  ,2023-02-17,2025-01-17,330.0,2309,1020,3329
2000,TSLA  ,2023-02-17,2025-01-17,340.0,1400,463,1863
2001,TSLA  ,2023-02-17,2025-01-17,350.0,7130,867,7997
2002,TSLA  ,2023-02-17,2025-01-17,360.0,1939,243,2182
2003,TSLA  ,2023-02-17,2025-01-17,370.0,1894,316,2210
2004,TSLA  ,2023-02-17,2025-01-17,380.0,1374,212,1586
2005,TSLA  ,2023-02-17,2025-01-17,390.0,1718,95,1813
2006,TSLA  ,2023-02-17,2025-01-17,400.0,19572,134,19706
2007,TSLA  ,2023-02-17,2025-01-17,410.0,4462,70,4532
2008,TSLA  ,2023-02-17,2025-01-17,420.0,4121,13,4134
2009,TSLA  ,2023-02-17,2025-01-17,430.0,590,2,592
2010,TSLA  ,2023-02-17,2025-01-17,440.0,1587,9,1596
2011,TSLA  ,2023-02-17,2025-01-17,450.0,5160,4,5164
2012,TSLA  ,2023-02-17,2025-01-17,460.0,1010,14,1024
2013,TSLA  ,2023-02-17,2025-01-17,470.0,1552,67,1619
2014,TSLA  ,2023-02-17,2025-01-17,480.0,1235,1,1236
2015,TSLA  ,2023-02-17,2025-01-17,490.0,806,0,806
2016,TSLA  ,2023-02-17,2025-01-17,500.0,11391,20,11411
2017,TSLA  ,2023-02-17,2025-01-17,510.0,1601,274,1875
2018,TSLA  ,2023-02-17,2025-01-17,520.0,8349,1,8350
2019,TSLA  ,2023-02-17,2025-01-17,530.0,642,0,642
2020,TSLA  ,2023-02-17,2025-01-17,540.0,603,0,603
2021,TSLA  ,2023-02-17,2025-01-17,550.0,3093,0,3093
2022,TSLA  ,2023-02-17,2025-01-17,560.0,631,1,632
2023,TSLA  ,2023-02-17,2025-01-17,570.0,660,0,660
2024,TSLA  ,2023-02-17,2025-01-17,580.0,883,0,883
2025,TSLA  ,2023-02-17,2025-01-17,590.0,755,1,756
2026,TSLA  ,2023-02-17,2025-01-17,600.0,15390,104,15494
2027,TSLA  ,2023-02-17,2025-01-17,610.0,17895,210,18105
2028,TSLA  ,2023-02-17,2025-06-20,5.0,232,1182,1414
2029,TSLA  ,2023-02-17,2025-06-20,10.0,5,66,71
2030,TSLA  ,2023-02-17,2025-06-20,15.0,8,5847,5855
2031,TSLA  ,2023-02-17,2025-06-20,20.0,59,427,486
2032,TSLA  ,2023-02-17,2025-06-20,25.0,9,152,161
2033,TSLA  ,2023-02-17,2025-06-20,30.0,86,312,398
2034,TSLA  ,2023-02-17,2025-06-20,35.0,11,193,204
2035,TSLA  ,2023-02-17,2025-06-20,40.0,10,334,344
2036,TSLA  ,2023-02-17,2025-06-20,45.0,17,53,70
2037,TSLA  ,2023-02-17,2025-06-20,50.0,153,752,905
2038,TSLA  ,2023-02-17,2025-06-20,55.0,13,54,67
2039,TSLA  ,2023-02-17,2025-06-20,60.0,15,383,398
2040,TSLA  ,2023-02-17,2025-06-20,65.0,19,573,592
2041,TSLA  ,2023-02-17,2025-06-20,70.0,164,127,291
2042,TSLA  ,2023-02-17,2025-06-20,75.0,134,1296,1430
2043,TSLA  ,2023-02-17,2025-06-20,80.0,807,732,1539
2044,TSLA  ,2023-02-17,2025-06-20,85.0,351,232,583
2045,TSLA  ,2023-02-17,2025-06-20,90.0,10311,440,10751
2046,TSLA  ,2023-02-17,2025-06-20,95.0,46450,547,46997
2047,TSLA  ,2023-02-17,2025-06-20,100.0,1006,4873,5879
2048,TSLA  ,2023-02-17,2025-06-20,105.0,160,440,600
2049,TSLA  ,2023-02-17,2025-06-20,110.0,353,1608,1961
2050,TSLA  ,2023-02-17,2025-06-20,115.0,434,257,691
2051,TSLA  ,2023-02-17,2025-06-20,120.0,530,996,1526
2052,TSLA  ,2023-02-17,2025-06-20,125.0,508,371,879
2053,TSLA  ,2023-02-17,2025-06-20,130.0,2601,1557,4158
2054,TSLA  ,2023-02-17,2025-06-20,135.0,4673,273,4946
2055,TSLA  ,2023-02-17,2025-06-20,140.0,991,1871,2862
2056,TSLA  ,2023-02-17,2025-06-20,145.0,407,480,887
2057,TSLA  ,2023-02-17,2025-06-20,150.0,1384,1418,2802
2058,TSLA  ,2023-02-17,2025-06-20,155.0,401,126,527
2059,TSLA  ,2023-02-17,2025-06-20,160.0,2172,843,3015
2060,TSLA  ,2023-02-17,2025-06-20,165.0,939,359,1298
2061,TSLA  ,2023-02-17,2025-06-20,170.0,2806,991,3797
2062,TSLA  ,2023-02-17,2025-06-20,175.0,756,1227,1983
2063,TSLA  ,2023-02-17,2025-06-20,180.0,666,540,1206
2064,TSLA  ,2023-02-17,2025-06-20,185.0,2554,199,2753
2065,TSLA  ,2023-02-17,2025-06-20,190.0,513,254,767
2066,TSLA  ,2023-02-17,2025-06-20,195.0,325,319,644
2067,TSLA  ,2023-02-17,2025-06-20,200.0,4438,3242,7680
2068,TSLA  ,2023-02-17,2025-06-20,205.0,301,230,531
2069,TSLA  ,2023-02-17,2025-06-20,210.0,471,175,646
2070,TSLA  ,2023-02-17,2025-06-20,215.0,221,91,312
2071,TSLA  ,2023-02-17,2025-06-20,220.0,725,126,851
2072,TSLA  ,2023-02-17,2025-06-20,225.0,565,191,756
2073,TSLA  ,2023-02-17,2025-06-20,230.0,512,82,594
2074,TSLA  ,2023-02-17,2025-06-20,235.0,341,264,605
2075,TSLA  ,2023-02-17,2025-06-20,240.0,4224,1406,5630
2076,TSLA  ,2023-02-17,2025-06-20,250.0,2291,541,2832
2077,TSLA  ,2023-02-17,2025-06-20,260.0,565,1342,1907
2078,TSLA  ,2023-02-17,2025-06-20,270.0,567,100,667
2079,TSLA  ,2023-02-17,2025-06-20,280.0,266,249,515
2080,TSLA  ,2023-02-17,2025-06-20,290.0,246,398,644
2081,TSLA  ,2023-02-17,2025-06-20,300.0,2862,675,3537
2082,TSLA  ,2023-02-17,2025-06-20,310.0,308,180,488
2083,TSLA  ,2023-02-17,2025-06-20,320.0,844,195,1039
2084,TSLA  ,2023-02-17,2025-06-20,330.0,208,287,495
2085,TSLA  ,2023-02-17,2025-06-20,340.0,465,412,877
2086,TSLA  ,2023-02-17,2025-06-20,350.0,2704,315,3019
2087,TSLA  ,2023-02-17,2025-06-20,360.0,695,237,932
2088,TSLA  ,2023-02-17,2025-06-20,370.0,171,181,352
2089,TSLA  ,2023-02-17,2025-06-20,380.0,94,55,149
2090,TSLA  ,2023-02-17,2025-06-20,390.0,2465,122,2587
